nosey nose nose)	fresh milk).
Ungakwazi ubhalisele the Dota 2 Beta Reborn manje ngokukhokha evakashele main web site noma bamane uthole okwengeziwe mayelana izici brand-new ukuthi Valve ababulawa singene ethandwa free-to-play MOBA.	You can sign-up for the Dota 2 Reborn beta right now by paying a visit to the official website or just learn more about the new features that Valve implemented into the popular free-to-play MOBA.
Siyethemba ukuthi le ndatshana ikuchazele ngokuningiliziwe okufanele ukwenze uma imilenze yakho ilimala ngesifo sikashukela.	We hope this article will help you understand how important taking care of your feet is when you have diabetes.
Ngangifuna ukwabelana inqubo yami nawe.	I wanted to share my system.
Levanto La Spezia - phezulu 5 kakhulu romantic isitimela amade Europe	Italian Luxury boutique: the top 5 of the most important in Italy
"""Lethabo,"" kusho uMama, ""kusasa usuku lwakho lokuzalwa."	"She sweetly said, ""Mommy, tomorrow is your birthday."
Umbuzo womugqa wephethiloli we-PTFE ukuthi hlobo luni futhi yini ...	Big question is what is PBN and how...
It izici iculo enkulu yezwe bokuthi niyoshabalala nithanda!	His songs are the kind of music you blast out if you want to have fun.
Ngabe anginazo ngempela izeluleko ezisebenzayo kulokho ongakwenza.	I can't give you any specific answers of what you can do.
Kubalulekile ukuthi uqonde ukuthi ungubani umkhiqizo wakho, nokuthi kufanele ngabe uqala kanjani ubudlelwane naye	It's critical you understand your brand and how you should start a relationship with your customers.
Wonke umuntu oqhubeka ephila ngendlela yalo.	Everyone keeps on keepin' on in their own way.
Futhi angithandi ukuncoma lezo zinkampani kumakhasimende ami.	I don't consider companies my clients.
Kwenzeka kanjani ukuba ningawuphenduli lo mbuzo?	Why did you not answer this question?
kanjani ukwenza rose gummy amabhere	How to make Gummy Bear edibles
Usebenzisa i-motherboard yakho yakudala eneRyzen 5 ngeke ikwenze uma kungekho ukusethwa kwe-bios kufakiwe.	I might try this on my Nexus 5 if it wasn't going to void the warranty.
Abantu abaningi bakithi bathola ukusizakala kakhulu ngalo luhlelo lwamatoho emisebenzi kahulumeni.	A lot of people are getting benefits from this government scheme.
"Omunye wemiBhalo eyamsiza iHubo 68:6 elithi: ""UNkulunkulu ubangela abahlala ngabodwa ukuba bahlale endlini."""	"To that, I would direct you both to Psalm 68:6, which states ""God sets the lonely in families."""
Zisizakala evenini ezimweni ezinjalo kunzima.	An autoinjector would be very useful in such situations.
Sibuze abafundi ukuthi bakholwa wukuthi kubalulekile yini ukwazi imuva lomuntu othandana naye, baphendule kanje:	Ask students to identify the meaning of the family members' names and respond to the questions:
Ngokuvamile, uhlelo kungenziwa ihlukaniswe ezimbili izinhlobo.	In general, the programs can be divided into two types.
Idi Vishwanne Bali Chesthunda, Tholichesthundha	The Silent But Deadly Betrayal
Kusuka ngaphakathi kuye ngaphandle, yilezi: ungqimba lomjuluko-ungqimba lokushisa-ungqimba ongangeni umoya.	From the outside through to the interior; it is a cornucopia of visual delights.
"Zihlomiseni ngeqiniso, nize phambi Kwami ukuze nginivule amehlo omoya khona niyobona zonke izimfihlakalo ezingaphakathi kumoya...."""	and walk in righteousness before Me, I will open their eyes that they may see the danger approach.
Kanye nokuhlanganiswa kwemibhalo ebucayi kaGriesbach, Schloz, Lachmann, noTischendorf, esetshenziswa ngokujwayelekile.	Together with A Collation of the Critical Texts of Griesbach, Scholz, Lachmann, and Tischendorf, with that in Common Use (1856)
Ngifuna ukukhuluma nale Cassie.	I want to talk to Cassie.
bekulokhu kuvuke umbhejazane emhlabeni futhi kuvimbe intando kanye nemizamo kaNkulunkulu, kwenza izinto zaba nzima.	Hard working, down to earth, and worshipers of God.
Sixoxe lesiphathamandla se Tajamuka Sesijikile, uMnu.	we've been told by the leadership on our side, Mr. Chairman,
Uzobona inqubo iqhubeke kancane phansi.	You will see it move down the trough.
Sika nge sikelo izingxenye akukwazi kunoma isiphi isimo.	There are a few matches that you cannot miss under any circumstances.
NoSuku Lothisha kuyeza?	Teacher's Day is coming.
Ukukujezisa kuthatha izwi nje.	Punishment is just a word.
Ukuthanda akusho ukuthi ngiyisi phukuphuku	Loving you doesn't mean I am a fool
Kodwa Voznyi akayikhohliwe injongo yakhe futhi kuziwa woo.	But he would never forget his mission and purpose.
Buza abalandeli ukuthi yini enye abangathanda ukuyazi ngalesi sihloko.	Ask students what they would like to learn about the topic.
Umndeni wakwaMesiya ungowesigaba sokusebenza.	The Messiah's identity is constituted in the mission of his disciples.
Funda ngezinselele zokuhumusha amagama ezingoma ngezilimi eziningi.	Learn the meanings of the verses through translations of the meanings of the Noble Quran in several languages.
yomphakathi nakwezomnotho waseNingizimu Afrika	Social and Economic Development of South Africa
Ngokwesiko, isidlo sasemini siqala ngesaladi yokukhanya yemifino.	Dinner traditionally begins with a tossed salad.
Agnes Asimawe Ithungu	Athena has a driver's license.
Vele amakhilomitha ambalwa ukusuka maphakathi nalesi sigodi elalihlala isikhungo ukuzijabulisa.	A few metres walking from the hotel there is a nice shopping centre.
Lokhu kungumphumela omkhulu kakhulu wokuwa kweNhlangano Yezizwe Ezihlangene kanye nezicelo ze-United States.	This is the first aggravation of their fn and misery.
"Imibuzo yokuqala eBay nabathengisi kufanele bazibuze kukhona: ""Yini engingayenza ukuthengisa?"" futhi ""Ngingalutholaphi ukuthenga?"""	"The first questions that people will ask is ""what can I do?"" and ""how can I help?."""
Baba thuma mina	My Father sent me
Kodwa ukuzinikela kwenu kanye nalokho enikwenzayo, akukho nokuncane.	Your work and efforts are truly unmatched.
Angizange ngishintshe ngenxa yezizathu eziningana:	I didn't vote for a number of reasons.
Kubizwa esiNgisini nge- astronomy .	This is called Astronomy.
Wayefuna izicathulo ezintsha?	Don't think you need new shoes?
3 njalo ngoba	3 For some reason...
Amazinga entsha entula imisebenzi makhulu kakhulu kunokujwayelekile.	Youth unemployment is a lot higher than it used to be.
Iwusizo kakhulu uma usebenzisa i-console kakhulu	It's especially helpful with congestion.
Abadlali kungaba ukudlala kuphi nge ikhompyutha ne-Inthanethi.	With our children, maybe it will be computer games and the Internet.
Indaba ka-Orsay ifana neHaydarpaÅŸa Isitimela sesitimela: I-1939 yisiteshi esilahlekelwe umlingisi wayo wesiteshi futhi ayisebenzi ngoba asifanele izitimela ezinde.	Orsay's story resembles HaydarpaÅŸa Train Station: 1939 is a useless building that has lost its station character because it is not suitable for long trains.
Ngaphezu kwalokho, njalo ekuseni, bahlangane bakhuleke ndawonye phambi amakilasi.	Though, he will continue to lead the students in prayer each morning.
Ngizofika ukuba dancing kuso okwesikhathi zomkhosi.	I will go back to play it in prime season.
Ikhasino eNtsha eneLayisensi ye2020!	Product of the year 2020 with a special license plate KVP 2020!
Lanxa umsakazo weStudio 7 wehlulekile ukukhuluma lesikhulumeli sikaRamaphosa, iphephandaba leSunday Mail libike izolo ukuthi iqula leli lizafika ngoLwesibili.	Although Kerry's campaign did not return phone calls, the Senator told the New York Times in its Tuesday edition that he is sympathetic to the union's complaint.
Nathi New Amagama	These are the new names
Abasebenzisi abangenayo bangenza i-akhawunti entsha kalula.	Users can set up a new account easily.
Abayiqondayo, bayayithola; abangayikhokhi, bayikhokhe - Albert Einstein	"He who understands it, earns it; he who doesn't, pays it."" - ALBERT EINSTEIN"
Uma bembuza umbuzo, wayephendula.	Once he asked his questions, she answered.
Futhi lokhu ixhunyiwe, noma ngenxa yokuntula amaqiniso noma ukuhlanekezela ngenhloso ubufakazi ezithile.	This is either due to the loss of evidence or due to insufficient evidence.
Ngingayithola kanjani imfundo eCalgary?	How do I get a scholarship to the University of Calgary?
He:- em ayindi ivvala niku...	Hey you, I am not a coward....
Abaningi balabo abayithatha bancoma futhi isengezo se-mk 677 ngoba ayicindezeli amazinga akhona e-testosterone nama-hormone okukhula, okuyibhonasi enkulu uma ubheka inzuzo.	Many of those who take it also praise the mk 677 supplement because it does not suppress the existing levels of testosterone and growth hormones, which is a huge bonus if you consider the benefits.
Futhi isibuko asisho ukulotha.	A mirror does not give relief.
ijika ukufunwa inhlangano ngayinye ihlukile, 'kokuwa' uhlamvu;	"must have a staff for each of the following ""instruments"": the lower lip;"
Kwangathi inhliziyo yami ingajabula, ukuze yesabe igama lakho.	Let my heart rejoice in the fear of your name.
38Wababusisa, banda kakhulu,	107:38 he blessed them, and their numbers greatly increased, and
Kusukela ngoMeyi kuze kube sekupheleni kukaSeptemba, umoya we-ningizimu-mpumalanga neseningizimu uyashaya.	From May until October south & west winds prevail.
Futhi kwendikimba evamile amaprotheni nsuku engayitholi kuyadingeka.	This adds to the needed body protein on a daily basis.
Bonke oxhumana nabo kungenzeka kuphela ngezindlela zokuxhumana ezinikezwe yithi.	We can only communicated by whatever means we have available to us.
Abameli babamangali manje bacela usuku lokuqulwa kwecala ngasekupheleni konyaka noma ekuqaleni konyaka ozayo.	The court will now pick trial date before the end of July.
Lokhu kwenziwa ngokusebenzisa nokwethulwa kwale imisebenzi zokuxhumana idatha.	This is done through prevention and the use of bat doors.
Loku kumqoka ikakhulu esimweni samanje se-COVID-19.	This is particularly important in the era of Covid-19.
Umbango futhi ukhathazekile umbuzo indima Economist sika, futhi ukuthi lokhu kufanele kube njengoba isazi bathinteka noma umeluleki esisebenzayo.	The dispute also concerned the question of the economist's role, and whether this should be as a detached expert or a practical adviser.
Iqembu lonke lidlala indima ekunakekeleni nokukhulisa imidlwane.	The entire pack participates in the protection and care of the pups.
Isikhathi sokusebenza manje.	Now it is time for working.
La bantu bashe bangqonga nomuzi.	cities have surrounded the city.
Nguye yedwa owayengenza into etshengisa amandla amakhulu njengelanga.	According to him, it can generate the same amount of light energy as the sun.
Zishadane emva kokwazana amaviki amabili izitshudeni zase-Rhodes	They married two weeks after Paul graduated.
(Luka 8:46) UJesu wanikeza abafundi bakhe amandla afanayo negunya phezu kwawo wonke amademoni nokwelapha izifo ezazibathuma ukuba bashumayele umbuso kaNkulunkulu futhi baphilise.	"What's more, Jesus gave His disciples ""power and authority to drive out all demons and to cure diseases, and he sent them out to preach the kingdom of God."""
In the okubi kakhulu umbukwane ithi no.	Worst case scenario, the answer is no.
Further Reading on Ndabaningi Sithole	For further reading, there are many
I love you all guys ningenze ngathanda ukufunda namaPics sengiyawathanda	I love what all of you have done with Books & Quills, and I've loved the features so far.
Njengokuthi, ngokwesibonelo, umuntu owayefisa ukudlulisa ucezu lwendawo komunye ayenalo phakathi nokuphila ngobuqili.	As, for instance, one who desired to convey a piece of property to another which he had possessed during life by trickery.
Ngemuva kwalokho, ungazithola kanjani imbewu engcono kakhulu ye-cannabis online?	How to find the best online cannabis dispensary?
athula ethu siranthathu..	All three have stayed silent.
Asikho nesisodwa isiqalelelo sesigabesi esingavimbela umbuso ekuthatheni umThetho namanye amagadango ukwenzela bona bothole inarha, amanzi nokhunye okukhambelana namatjhuguluko la, ukuze kulungiseke imiphumela yebandlululo ngokwebala kwangesikhathi esadlulako, ngaphandle kwanyana ukutjhida okhunye nokhunye eenqalelelweni zesigabesi kukhambisana neenqalelelo zesigaba 36 (1).	This section further states that no provision may impede the state from taking legislative and other measures to achieve land, water and related reform, in order to redress the results of past racial discrimination, provided that any departure from the provisions of this section is in accordance with the provisions of section 36 (1).
Ngaphezu kwalokho, siyathokoza bona bahlala bakulungele ukusisiza nesizizwa siphelelelwa mamandla ngebanga lokugandeleleka esikufumana ephasineli.	In other words, we are caused to live, thanks to the support we continue to receive from all existence in the universe.
Kambe ukhona owake waya esithenjini ngenkani?	Is there anyone who has never been to a big bead show before?
Emhlenikweni wafayo u	In the case of the deceased
Umndeni wami uphelele manje.	Now the family is complete.
Abantu bakithi bayahlupheka imisebenzi iphelile zonke izinkampani zikaHulumeni ziwile.	People are losing their jobs, and entire companies are going bankrupt.
Uke wahlangana nomlingani wokuphila ohlosiwe ukuba naye noma kufanele yini umnike umthwalo?	Have you ever teamed up with a friend to lose weight or get fit?
Okuncane mayelana nehhotela ...	A little bit about the club...
"A Mallard besifazane ""egqoke"" ahlotshiswe."	"The ""bad"" mother has been identified."
Ngizobanga umsindo ngoba ngifuna ukugeza igama lami.	And I'm going to fight to clear my name.
Ngikubonil' uhamba nami	and I see you walk with me
Angakwenza futhi lokho kodwa kulokho abadlali badinga ukulinda izinsuku ezingama-21 ezizayo.	On the other hand, this can continue for two days, so players should make the most from time they've.
Ngathola ithuba lokuba ngikhiphe lokhu okwakusenhliziyweni yami engangizizwela ukuthi uNkulunkulu uyangisola ngakho.	I decided to challenge what I believe was the limit of God's love for me.
Kuyinto umlutha ngempela.	It really is an addiction.
Engingakusho nje siyikhumbule kabanzi.	Everything else I can barely remember.
Lesi esinye sezizathu ezenza kubaluleke ukuthi ube khona njalo emihlanganweni yebandla. - .	This is one of the reasons why it's important to routinely undergo check-ups.
Ikhebula ngezifizo	convulsive wanting
Wena Sipho uzizwa unjani?	What do you think about your gift?
Uma i-herring inomusa kakhulu, ungayifaka emanzini.	If your cookie dough is too soft, you can place it in the fridge.
nkathi kokuhlala kwabo eGibhithe ingasaphathwa amabili nanhlanu namashumi	Europe, while this period lasted from 2 to 5 years in South-East
Amaphoyisa abe esebizwa, kodwa abatholanga ingane emfuleni.	The police were called but didn't find a gun.
Ungasitshela imfihlo yakho yokuthi kungani uthanda ukugqoka ngale ndlela kusukela kudala ungashintshi?	Can you tell us why you want to keep your identity a secret?
samukelisiwe meaning of life	felicien meaning of life
Silinda: Akaxoshwe	Voight: She's not ruled out.
Ingabe kukhona ukufunza ngemfundiso ethile ngokuphoqa?	Is there a prescribed method for teaching?
Facebook gives people the. izithakazelo zakwaMazibuko.	Facebook provides the website and the advertisers pay the money.
Izingane eziningi zizokhula zikuleso simo.	Many children will thrive in this environment.
I-Iowa, i-Nebraska ne-Kansas amazwe aseMelika emaphakathi	ico, Texas, Nebraska, Kansas and others of the western states
Ngokunikeza ulwazi kwabe-GCIS ngale website, umsebenzisi uvumela ukudluliselwa kwalolo lwazi.	By providing information to the MPG through this website, the user is consenting to such transfers.
Awekho amaphazili ansuku zonke ngoba ungakha entsha ngokuchofoza ileveli yobunzima oyifunayo.	There are no daily puzzles because you can generate a new one by clicking the desired difficulty level.
Inkampani Yakho:	Your company's:
mangilinganiswe ngesilinganiso esilungileyo, ukuze uNkulunkulu azi ukuphelela kwami.	The obvious reason is the purity of my relationship with God.
7 Kwaba kubi emehlweni kaNkulunkulu; ngalokho washaya u-Israyeli.	7 God was also offended by it, so he attacked Israel.
Kukhethwa izixazululo kusekelwe kucutshungulwa ethile ulwazi substantiates isinqumo ukuze kwenziwe.	The solutions are designed to make decisions based on a thorough analysis.
Ngezinye izikhathi bekungekho futhi ngithathe isinyathelo.	Sometimes I wasn't even right.
Make U Stay (gift given)	Get on With It (gift given)
Kukuvumela ushintshe ngokushesha kusuka kokunye ukuzivocavoca uye kokulandelayo.	This system allows you to quickly go from one exercise to the next.
Retha Kundanani	It means to love one another
Ngesikhathi besendleleni bezwe umsindo wengoma obusho phezulu esikoleni, abafundi bakamatikuletsheni nothisha bezijuxuza.	When we read about the tourists coming to the island, teachers and students dressed like tourists.
Wathi kimi: Ngiyalinganisa iJerusalema, ngibone ukuthi bungakanani ububanzi bayo lobude bayo.	And he said to me, To measure Jerusalem to see what is its breadth, and what is its length.
Ayikho indlela yokuphunyuka Berlin inakekelwe ezingaphezu kuka Potsdam.	There is no better way to experience tasmania.
How do I pay Sizwe mthabela?	How do I pay back the federal loan.
Ikhono lokuthumela umyalezo ofanele kanye nesaziso esifanelekile kumsebenzisi ngamunye kubaluleke kakhulu.	The ease of access and proper information that helps a user is key.
Ngiyazifela by Zonke	"""I'm sorry for all"
Tshabalala Sakhumuzi	Death of a translator
1:5 Akekho oyokwazi ukumelana nawe phakathi nazo zonke izinsuku zokuphila kwakho.	5 - No one will be able to stand against you all the days of your life.
Wordpress.org eside kangaka, nokubonga ngakho konke izinhlanzi.	Tempu wordpress.org, and thanks for all the fish.
"A fetus futhi akubi 'iphila "" (okuyinto ikhono aphile ngaphandle kwesibeletho) kuze okungenani izinyanga ezinhlanu emva kokukhulelwa."	"A fetus also doesn't become ""viable"" (which is the ability to live outside the womb) until at least five months after fertilization."
"""Eqinisweni elimsulwa ngathola ukuthi ngemuva kokushiya iTS Records, kwaba nzima ukukhangisa ngomsebenzi wami."	However, I discovered that after I had made the order, it was very difficult to get support.
U-Shaka kwakuyinkosi ya.semashobe-ni.	LG is the king of Yawn.
inkampani enjalo ikunikeza Ukuzivumelanisa nezimo xaxa futhi inkululeko.	Such an arrangement will give you a greater measure of freedom.
Three Zoe Murphy seminyaka emibili ubudala ovela e-Ireland, izalwa PVL okulimala ebuchosheni okubangela wonke umzimba-Cerebral Palsy odokotela.	Three Two-year-old Zoe Murphy from Ireland, was born with a PVL brain injury causing quadriplegic Cerebral Palsy.
(Lula umsebenzi futhi ukuthuthukisa (ukunquma kumele isikhathi eside kangakanani	(Dependent on length and time taken to process)
Kubahlinzeki abaningi be-web host, izinqumo zokuthenga zenziwa kungakapheli imizuzu.	For many web host providers, the purchasing decisions are made within a matter of minutes.
[26:31] He tshela Ngalesosikhathi khiqiza it you are truthful.	26:31 (Pharaoh) said: Show it, then, if thou art of the truthful.
Lokhu kusebenza futhi kubantu abavamile baseTurkey.	The same applies to ordinary people.
One New Man - Amazing!	There's a new boyfriend - he's amazing.
"Akunjalo kudala kwembulwe ukuthi Springer Spaniel bangase bahlupheke izifo sezinzwa ezifana ""intukuthelo syndrome."""	"Not so long ago, it was found that the English Springer Spaniel may suffer from the so-called ""syndrome of anger."""
Uma kunokuthile okubi noma akukuhle kangako okufanele sikusho, ngukuthi bangamahhashi ahamba kancane.	When things are really bad, they're poachers.
'I need to phone my mother' - Ngidinga ukushayela umama wami ucingo.	I need to call my mother.'
Ngakho-ke kungcono ukubonakalisa ephepheni.	It's best if you map it out on paper.
UMaxim Hodak ubhalise lezi zindawo ezilandelayo ezingokomthetho kwirejista yezindawo zomthetho zeNetherlands Bar:	Sylvana Vijn has registered the following areas of law in the register of the Dutch Bar Association:
Ukulalela iKoran, umKristu	by the Barna Group, a Christian
Uyakhumbula ukuthi siluthuli.	He remembers that we're dust.
Leli qiniso waphinda kuqinisekisa ukuthi into engcono - nguye uthenge ngokuqondile nomakhi.	The prize here is also the best as you would be buying directly from the manufacturer.
koda kube nini ezidla ngokungcola kwawo?	How long they reign is often up to them.
Ngithanda ukutshela ngokwami   agciniwe they kimi labo imizuzwana yokugcina ngakho ngangingakwazi belondekile win.	I thought they were renegotiating the deal with me at the last minute and that I would not be able to trust them, so I walked away.
Emuva kwehora lesine, kuzovalwa ukuvota zihlangane zonke izinduna zamaqembu kubalwe amavoti.	As soon as the voting is over, a committee of 40, including representatives for all candidates, will assemble in the Senate Chamber to tabulate the votes.
Abadlali bebhola laseSwitzerland	Swiss football player
3 abantwana bakhe ngizobabulala.	23I will kill her children.
Lagu Ungu - Cududu (All I Wanna Do) [feat Lala Kar...	Falling into sin (which we do every [...]
Ukulimala kwama-sweeteners wokufakelwa kukhulu kakhulu.	The damage caused by grey squirrels is enormous.
Hair bezilokhu njengengxenye ebalulekile abesilisa ababhekwa ngayo.	Hair have always been regarded as a significant part the masculinity.
Umkhakha wezitolo, okhula usuku nosuku, unesilinganiso sama-2020 ukusuka ngasekupheleni kuka-445.	The shopping mall sector, which is growing day by day, will reach an average of 2020 shopping malls by the end of 445.
Amakhona ayindilinga, imiphetho ebunjiwe, izinyathelo nezinye izinhlobo ezikhethekile zingacutshungulwa ngokuya ngezidingo zamakhasimende..	Air conditioning, analytical instruments, workbench, and other components can be adjusted according to customer needs.
Angiphindanga ngabeka umcondo wami esontweni.	I never went back to the Church.
Uhambo olubheke osukwini lokuzalwa kukaJesu!	It's a celebration of the birth of Jesus!
Atholakala emanzini ajulile kakhulu futhi ngenxa yalesi sizathu ahlala engaguquki amakhulu eminyaka.	These practices have deep ancient roots, and have been relied on for centuries.
Lathi siyazifuna izidetails.	I said he needed stitches.
Yini ongayenza abuyise esuka eJalimane okwamanje?	So what can you do in England from today?
Ukuphepha kwezinkuni okushisa iziko Indawo yokubasa izinkuni iyashiswa ngokhuni lwemvelo, futhi igumbi lomlilo livaleke ngokuphelele, ngakho-ke abukho ubungozi bokuvuza kwegesi noma imisebe kagesi.	The electric heating element is entirely enclosed inside the unit, so the risk of contact burns or fires is almost non-existent.
(but I do love my kindle)	(and I love my kids)
Yonke inkimbinkimbi yalezi zinqubo ithinta imiphumela yokuhlaziywa.	All these changes affect the existing processes.
IChina ithembisa ukuba seqhulwini kwezobuchw epheshe	indian government has decided to sell 100 percent stake in air india
Kungani ngikuthanda?	Why Do I Love It?
"UB Brufau uthe lokhu kuzoba ngenye izinguquko eziphakathi nesikhathi eside ezenzeka emakethe wegesi, i-hydrocarbon ""eyamandla ekhulu lama-21."""	When that is accomplished, Abu Dhabi will then have completed its transition from a 20th Century, carbon-based economy into a sustainable 21st Century high-technology economy.'
UAnnastacia Ndlovu usethulela loludaba ...	Lance Hernandez has the story....
Indlela Yokukhuluma	"""How to talk"
Kuyakufanelekela ukuyiguqula, ukusabalalise futhi ufunde okuqukethwe kwayo ðŸ™‚	time to read the documentations, to learn and understand:)
- Inhumation, exhumation	cleanse, exfoliation
Ngaqale ngafundela umsebenzi wokuhwebelana namabhizinisi akwamanye amazwe eBerlin.	Originally, I have studied International Business in Germany.
Ungayakha Kanjani i-Akhawunti ye-Gmail?	How do you get a Gmail account.
Wayemane nje isusiwe futhi ayisekho nabo amapuleti ngalendoda.	They just kept bringing down wounded and there wasn't any more room.
Hlela ngokwezifiso Amathempulethi angu-17+ Unyaka Omusha Ikhava ye-Albhamu	A countdown of the 17 best New Year's Eve performances
Impela akunjalo e-US.	In the US, certainly not.
Yasungulwa ngo-Ephreli 21, 1960, ukusebenza njengenhlokodolobha entsha kazwelonke.	It is a planned city and was founded on 21 April 1960, to serve as the new national capital.
Ngwelezane Empangeni Kwa Zulu Natal - Billboard Finder	Christmas at the Bird's Nest - Wanderlodge Owners Group
IBazooka yasungulwa ngonyaka ka-2011 yathola izithameli zayo ngokushesha.	SoFi was founded in 2011 and quickly became known for its lending products.
Umucu wakhe uzoqala ukuzwakala emisakazweni ngesonto elizayo.	The song is set to premiere to radios next week.
Abantu ubambe kweqembu elinganeliseki kakhulu.	The Serbs are most dissatisfied.
Naphezu kweqiniso lokuthi ama-beets abhekwa njengomkhiqizo owusizo kakhulu, awukwazi ukudliwa yibo bonke abantu abanesifo sikashukela.	While these are a great source of good fatty acids, not everyone is able to consume these, like pregnant women.
Ukuhaha kukaTom Cruise kwabhujiswa	The tomb of St. Martin was destroyed
Ngenxa yoko, ukukhulelwa kwamanzi kungenza.	As a result, breastfeeding is possible.
Kumele ngikhulume ngabantu base-UAE bakhetha uPhillipin njengendodakazi yendlu yabo ngaleso sikhathi.	I decided to create a web site for the church that Katie was serving as a minister at the time.
Iwebhusayithi yethu inikwe amandla ngokuphepha kwe-3D ku-intanethi ye-intanethi.	Daraz is a 3D Secure enabled website.
Amapuleti ama-Tectonic ahamba njalo futhi kule nkathi lapho i-Atlantic Ocean yanda khona.	The aquifer also extends under the ocean at this point.
Real mzansi pussy videos igolo lami elimnandi.	The ones in the TTSP video are my real ones.
Ukulandela lokhu, kubhekwa njengesengezo sokudla esithembisa kakhulu kubasubathi, nanoma ngubani omunye ofuna ukuxhasa ubuchopho babo futhi ngasikhathi sinye akhuthaze amandla abo omzimba.	Following this, it is viewed as a very promising dietary supplement for athletes, and anyone else who wants to support their brain and at the same time foster their physical strength.
Khuzwayo, Nokuphila - Kienda, La	The Ups and Downs of Life - Life Without Les
[3 Ngoba ngomusa engiwuphiweyo, ngithi kuwo wonke ophakathi kwenu ukuthi angacabangi ukuthi mkhulu kulalokho afanele ukukucabanga, kodwa acabange ngokuqonda, njengalokhu uNkulunkulu abele ngulowo lalowo isilinganiso sokholo.	"""I say to every one of you: Do not think of yourself more highly than you ought, but rather think of yourself with sober judgment, in accordance with the faith God has distributed to each [...]"
ISundowns kulindeleke ukuthi ithathe isinqumo ngaye maduze.	Baldwin is expected to make a decision soon.
Lutho okusanhlamvu kungukuthi kwehla kusuka ezingxenyeni ezidliwayo.	The fast is broken by partaking of wheat-based food.
INkosi uJesu yathi izimvu zikaNkulunkulu ziyakwazi ukuzwa izwi likaNkulunkulu, nokuthi ukubuya kukaNkulunkulu kuzohlukanisa izimvu nezimbuzi.	Christ is the lamb of God, and the Bible tells us that Jesus will come to separate the sheep from the goats.
Kodwa base amaqembu amabili in impikiswano omunye nomunye .	Two groups were at war with one another.
Unina angimbonanga kodwa ungcolise I cover yombhede	My wife had saved it but mistakenly tossed the envelope.
sonke - thode	MIND - Lascivious
Zonke izinto zokwakha wayebuye yasekhaya.	All the basic equipment was at home.
Akuzona zonke izinto ezibahambela kahle abafana beWillock phakathi neminyaka yabo yokwakha ne-Arsenal.	But not all of George's life was spent during these years in domestic pursuits.
Umlingisikazi wacabanga abangane bakhe babengeke baqonde.	The girl said her teachers don't understand.
Nkosikazi enhle, yezingelosi zonke,	beautiful of all the angels.
Ngisho noma uhola imali encane ukuchofoza, ungakwazi ukuhoxisa ke nganoma yisiphi isikhathi esikahle.	Even if the starting credit is used up, you can cancel at any time.
Lena okudingayo usuku ehlobo kushisa.	need on a hot summer day.
"Noma ungasagezanga kodwa bangene babes!"""	"But you ain't undressed yet, and the matches are out in the bathroom."""
Ngakho-ke, angikwazi ukuhambisana nezincwadi ngendlela engingathanda ngayo.	So I can't post as much as in would like To.
Kukhona futhi i-Enetician Castle yaseZakynthos eyakhiwe ngesikhathi sokuba khona kwe-Enetician esiqhingini iminyaka engamakhulu amane.	At the same village there is also a Venetian castle from the Venetian occupation of the island during the medieval years.
Izinguquko zesimo sezulu bezilokhu zikhona futhi zizohlala zikhona.	The climate has been and is always changing.
Utshomi lo ngaze simzwele kasithandi thina bantu abansundu, njalo wakuveza sobala.	Black people do not have any interest in harming white folks, it has always been the other way around.
Alibaba News China.	Some news from China.
I-gdebi-kde ingcono kakhulu ngaphandle kokungabaza futhi azikho izingqinamba zokuzinza ðŸ™‚	This is clear glass, there is no warping or special effects:)
Ken Okuyama.	Ken is screwed.
Masihambisane: Ibanga R: Izinhlamvu Zemisindo	Gronk on the A.T.: Sounds of the AT
"wasabi (legemd) """	"""Without fear"" (Lida)"
Mantengase visible.	ly visible.
Ukuvota inkinga idinga ukuthi abavoti vumela amakhasino ezimbili zokuphelelwa umoya okungenani 72 amamayela Nord ngoba Atlantic City.	The resolution specifies that the new casinos must be at least 72 miles from Atlantic City.
Imililo ingeyezilwane (kufaka phakathi abantu), inkinga enkulu kakhulu.	Fires are, for animals (including people), a very serious problem.
16:43 We never wathumela kodwa amadoda phambi kwakho (Prophet Muhammad) kubani We phendla, cela abantu Remembrance, uma ungazi .	04O 14 43 For the Amalekites and the Canaanites [are] there before you, and ye shall fall by the sword: because ye are turned away from the LORD, therefore the LORD will not be with you.
mzanywa dladla	Trying to Murder
Izikhumulo zezindiza eNew York	Airports in new-york
Ngoba ngiwuzwile, kuvela eNkosini, uNkulunkulu Sebawoti, mayelana kwesiphelo kanye abridgement ngokuphathelene umhlaba wonke.	For I have heard from the Lord God of hosts, A destruction determined even upon the whole earth.
Umsebenzi oyinhloko lesi sakhiwo - ukuvikelwa endaweni ethile elangeni.	The main function of the headdress is protection from the sun.
""" I dunno - I dunno nothin' 'bout"	"I answered ""I dunno"""
"Lokhu kwaholela ekutheni ngiye emicimbini yasebusuku exokozelayo futhi ngingathembeki kumyeni wami."""	This has become a secret addiction and I have been unfaithful to my wife. '
Viki ezayo: Ukukwamukelwa njengolungileyo lomthetho.	This week: Voter participation.
Sokhulu, Linda	uncle, and waited.
Kumele kube ilo omthandayo.	It might be someone you love.
"Loba, wazi njani, ndoda langabe uzasindisa umkakho?"" (1 Khor."	Or, how do you know, husband, whether you will save your wife?' (1 Corinthians 7:16).
Kusukela 1872 amakolishi zokuhlala ezehlukene babÃ© abasemaqenjini nyuvesi.	Moreover, since 1872 various residential colleges have become affiliated with the university.
Okwamanje, kunamakhodi ayisikhombisa wokukhomba, ngaphandle kokuthi Siyayazi impahla epulasitiki ngokufaka amakhodi, futhi into ebaluleke kakhulu ukusiza ekwenzeni kabusha, okungahlukaniswa kusetshenziswe futhi.	At present, there are seven identification codes, except for We know the plastic material by coding, and the most important thing is to assist in recycling, which can be subdivided and reused.
Ubusika luvavanyo lwangempela lwempilo.	Winter time is a real test for the body.
walesi - nzima	the challengers
Ngandlela-thile, kodwa izinzuzo uthola.	In some ways, but there are also benefits as well.
Vietnamese insane woman...	She was a crazy women...
Umoya ongcwele kawusiwo muntu.	The Holy Spirit not a person.
Manje usungasakaza ku-TV yakho ngaphandle kwenkinga.	Now you can easily remove it from the TV.
Ngaphandle kwenkantolo isimo besimanzonzo amaqembu ezepolitiki namalungu omphakathi wabantu abamnyama bebhikisha bephethe izingqwembe.	Aside from cracking down on the main opposition party, civil society groups, NGOs and some media outlets have come under pressure from the ruling Cambodian People's Party.
saniy liyona sex imeshe	Now She's Crying Sexism
"""Uma ebhalwe ukuthatha impango,"	If it is meant to be picked up,
Ezinye izindlela zokutshala imali ngo-2017	Viable Ways of Making Money in 2017
Ngokwakhiwa kweNkampani eNew Mexico: Singumhlinzeki wenkonzo eyodwa yokumisa inkampani eNew Mexico, ukuvula i-akhawunti yasebhange eNew Mexico, ukuqala ibhizinisi eNew Mexico nokusetha ibhizinisi eNew Mexico noma emazweni angu-109 emhlabeni.	For Company formation in New Mexico: We are one stop service provider for company formation New Mexico, Bank account opening New Mexico, starting business in New Mexico and setup business in New Mexico or 109 Countries in the world.
4:15 Kwathi ukuthi, lapho izitha zethu babezwile ukuthi selubikiwe nathi, Nkulunkulu wahlulwa iseluleko sabo.	4 15 And it came to pass, when our enemies heard that the thing had been told us, that God defeated their counsel.
Kodwa pacifiers asetshenziswa njengakuqala.	Fishermen's boats are no longer what they used to be.
Uma uvumelana nathi - Joyina i-WSF	If you agree with us, join the Socialist Party.
'Ungakhathazeki,' kusho yena.	"""Do not worry,"" he says."
Abantu bathi luqakathekile usuku lolu.	She knows that today is a special day.
Izizathu yokuncipha kokubaluleka libido owesilisa baningi.	The weight loss on the other hand does motivate a lot of women.
Inyuvesi usebenza towards, athole ngetinjongo tayo tekusebenta ngokuhlakulela izindlela zokwenza abafundi - futhi ngokuphishekela best-practice inductions kanye nakho student.	The University works towards and achieves its strategic objectives by developing ways to engage students - and by pursuing best-practice inductions and student experiences.
Wonke umuntu uyamuhlonipha uBenni, ngisho nababengozakwethu, bonke bayamhlonipha uBenni, ngisho nami.	compares every man, including her ex-husband, to Ben.
Isidumbu sakhe satholakala ebhuthini lemoto ngemuva kokubhulwa komlilo.	His body was found in a burnt-out car in the woods.
I-DAI oyenza kuMenziDAO ingasetshenziswa njengesibambiso ukuze kuthathwe imali mboleko.	The cash value can be used as collateral to secure a loan.
Kugcina sekudaleka izigebengu, ezibamba inkunzi namaphara ahluphayo antshontsha izimpahla ekhaya ayozidayisa ukuze athole imali.	Addicts steal, sell possessions, and prostitute themselves to get enough money to support their habits.
Le Communitheme	the communitarianism
1 year ago Insidethe...	A few years ago there w...
Ngiyiphi imininingwane engingayenza ku-ESTA?	What more can I say about Emilia?
Ngingakusebenzisa kanjani lokhu dolobha womama ukukhokhela sonke isikweletu sendlu futhi indlela yokukwenza?	How can I become my Mom's live-in caregiver and get paid for it?
Siphiwo Samazima	The Gift of Lamentations
Makabeke umlomo wakhe othulini; mhlawumbe kungaba khona ithemba.	Let him rot in the dark - maybe he'll have an idea appear.
Izikhala zamahhala (ama-spins wamahhala ngaphandle kwediphozithi) ekhasino!	We don't receive poker machines (Casino excepted in Western Australia.
Sasiseyizinsizwa ngaleso sikhathi.	We was young at the time.
Igumbi e-ihhotela ibungazwe ngu-Galip	the Hotel Galvez.
Njengoba Jackson County umahluleli, wayenomthwalo wokusingatha noma:	The County Clerk is also in charge of:
"Okunye okungenzeka ukuthi Alfewu wathatha igama lesiGreki efana igama zakhe ezingamaJuda, indlela ukuthi uSawule wathatha igama elithi Pawulu"" (Katolika eziyisisekelo, Ignatius Press, 1988, p."	"Another possibility is that Alphaeus took a Greek name similar to his Jewish name , the way that Saul took the name Paul "" (Catholicism and Fundamentalism , ã‚¤ã‚°ãƒŠãƒ†ã‚£ã‚¦ã‚¹ãƒ—ãƒ¬ã‚¹, 1988, p."
Kodwa kunomnyango ohlukanisa isiteshi somsakazo kanye ne-ops room.	But there is a door separating the radio station and the ops room.
Futhi ukuqhuma kwezibhamu - samuntu ukwesaba yangempela nezinto ezibakhathazayo.	They are human beings with real fears and problems, too.
Ngiyawuqonda umsebenzi, kodwa ngifuna usizo oluthe xaxa	I've been studying but I need more help
4:20 U-Esteri wayengazange kodwa wamemezela kwezwe azalelwa kulo futhi abantu bakhe, ngokuvumelana nomyalo wakhe.	4:20 Esther had not yet declared her native land and her people, according to his command.
Vele ukudweba impendulo imfumbe kumele amehlo noma uvale emehlo.	The way of avoiding the something is to wear a blindfold or keep eyes closed.
James yes, Chase no.	Ah, yes, the Chase.
"Ngemuva kokufunda lokhu okuthunyelwe, nokulalela ithebhu kaRobbins, ngibheke izinqumo zami zeminyaka emisha, ngazidwengula ngabhala isinqumo esisodwa nje esisha: ""Vele ukwenze."""	"In the last few days, after reading dozens of emails and comments from my Newsbud community friends I decided to just get down to it and do it."""
Lokhu kwenzeka uma nje leyo ndawo ilahlekelwa ukholo yena.	That is, so long as his manager doesn't lose faith in him.
sizwe nzama 18 days ago	The Federal Bureau Of Investigation 18 days ago
Thola Izinhlobo Ezinhle Zokunakekelwa Kwezempilo zaseNdiya	In search of the perfect health care system in india
Lala kuhle qhawe lamaqhawe.	Sleep well in the New Reich.
Isikole sika-city club, uGNK Dinamo Zagreb wasebenzisa leli thuba futhi wacela usizo lweMateo Kovacic.	The city's club's academy, GNK Dinamo Zagreb took advantage of that opportunity and requested the services of Mateo Kovacic.
"Ngabe ngizwa lapha ""iba Inofizielle Mitarbeiter""?"	"Want to hear my ""Working Class Hero""?"
I-Road Traffic Management Corporation (RTMC) ngoMsombuluko iveze ukuthi isibalo sabashonile sesifinyelele kwabawu-1 200.	The Federal Road Safety Corps (FRSC) on Tuesday disclosed that it has deployed 1,500
Cishe wonke umuntu ubhekene nobuhlungu begciwane okungenani kanye empilweni yakhe, ngakho-ke ungacabanga ukuthi ubuhlungu kangakanani umqondo wokuvinjelwa kokuhamba ezindaweni eziphansi.	Most people develop calluses at least once in their lifetime, but it can be difficult to understand how this skin condition arises.
Lokucabanga ukuthi sibe nohlelo lokusebenzisa imali zamaRandi 1000.	We had a budget of about $30,000.
Udinga ukuvula ke ngesikhathi umdlalo, kodwa indlela yokukwenza?	Then you need to change the model, but how?
Angizisoli neze ngokujoyina leli qembu.	I wouldn't regret joining this club.
Museum ibonisa lasendulo art izinto.	A local museum shows ancient artifacts.
"""Othanda ubumnandi uyoba mpofu; othanda iwayini namafutha ngeke acebe."""	"""The one who loves pleasure will become a poor man; whoever loves wine and oil will not get rich."" (21:17)"
Yenza umsebenzi elihambisana esigabeni umsebenzi.	work together on a rubric.
Uthe basafuna ukucetshiswa ngezomthetho mayelana nokuthi kumele yini uMadonsela abanjelwe imali ngokulimala kwemoto.	It is also reported that he is now making a cycle claim for damages from the insurers of the car driver.
Noma ubani angakuqonda.	EVERYONE can understand.
Umusa kaBhowazi watshengisa indlela uJehova ayemthanda ngayo owesifazana lo owayeze 'ukuzophephela ngaphansi kwamaphiko' kaNkulunkulu ka-Israyeli.	Boaz' kindness was actually an expression of Jehovah's loyal love toward a woman who had come to 'seek refuge under the wings of the God of Israel.'
Ngemuva kokudla kwasekuseni kuhambela ithempeli likaRamchandi, i-Chandrabhaga Beach, i-Konark Sun Temple.	In the afternoon visit to Konark Sun Temple, Chandrabhaga Beach.
20 Kepha u-Amasiya akalalelanga, ngokuba kwavela kuNkulunkulu ukuba abanikele esandleni sezitha zabo, ngokuba babefunile onkulunkulu bakwa-Edomi.	20But Amaziah would not listen, for it was of God, in order that he might give them into the hand of their enemies, because they had sought the gods of Edom.
Kungenzeka yini ngempela ukuba sisondelane naye?	Is it possible to live near him?
Ezwekazini lonke, nsuku zonke, izinhlangano nabantu ngabanye bayalonakalisa.	Across the world, people and organizations are targets of fraud every day.
Nge ubuhlungu in emphinjeni wakhe owenzÃ© izidakamizwa ezilandelayo:	From details in his Obituary, he served on the following ships:
Angazi ukuthi ngubani odinga ukuzwa lokhu kepha, kufanele ugcwale umswakama futhi u-moisturize njalo.	I don't know who needs to hear this but, you should moisturize and moisturize often.
Thumelela Thumelela Siza Abanye Babhekane Nokucindezeleka	Get others to help influence.
Entre profesor y alumno Phakathi Kothisha Nomfundi	Camaraderie between teachers and students
A usawoti kancane bese wengeza seasonings ozithandayo.	Let's make Pop Corn and add your favorite seasonings.
Belaphe abalimele, bayiswa ezibhedlela ezahlukene ukuze bathole osizo olwanele.	The injured have been shifted to different hospitals for medical aid.
"RFK wabuza Kamuva Lyndon Johnson ""Kungani kuye wabulala mfowethu?"""	JFK's Brother Robert F Kennedy said to Lyndon B Johnson, 'why did you get my brother killed' -
Namhlanje ugqoke isikhindi esimfushane kakhulu.	Teresa is wearing a short-sleeve shirt today.
Kusukela ngeminyaka ye-1960 neye-1970, umtshingo wawudlalwa ngabaculi abaningi bakuleli	During the 1960s and 70s, disco music was popularised in many
Ukhetho Lelaphu elinomyalezo	T-Shirts with the message
Ntokozo Sibonelo Khuzwayo 1 and FortunÃ© Massamba 1	Sadism and Masochism Porn 1
izithako angeziwe angafakwa uma wayefisa zokupheka ngenhla.	Here, other items can be added if desired prior to applying payment.
IUganda imiselwe ukuvula i-Entebbe International Airport ...	The Government of Uganda has announced the closure of Entebbe International...
Kuvela kwaba amakhono.	skills has emerged.
Ngezansi isithombe iqhinga isikuta ukusetshenziswa izicelo ezinjalo.	The table below shows how to use these options.
"Ngangifuna ukumbulala."" - UPaul."	"I wanted to destroy him."" 0"
Inketho elula kakhulu kubantu abaningi bokuqala ukugcina izimbungulu zokudla ethangini le-aquarium.	The easiest option for many first-timers is to keep mealworms in an aquarium tank.
Egameni lenkosi 6:15	In the Name of God live 15:49
usable nonetheless.	They are usable, though.
Ngiyalithanda igama lami.	- I like my name.
Noma ingadluliselwa kwelinye ilungu elingaphakathi enkampanini.	But the ticket is transferable to a colleague within the company.
Ngesikhathi esifanayo, ungenza ukucutshungulwa ushizi.	On the other, you can get curry chicken.
Ekukhuleni kwakhe ube esefunda esikoleni sekhethelo sokufundisa ... Read more	Later he returned to the Academy as a language instructor. read more...
Njengoba Kabusha izinwele ke olungasayikuphinde lube khona.	Once the hair is eliminated, it will never grow back.
(Efesu 4:29) Ake sixoxe ngokuthi kungani kudingeka siqaphe lokho esikushoyo, inkulumo okufanele siyigweme, nokuthi singakhuluma kanjani ngendlela 'eyakhayo.'	"(Ephesians 4:29) Let us discuss why we need to keep on guard when it comes to speech, what speech we should avoid, and how we can utter speech that ""is good for building up."""
Ekufikeni kwabo eTsholotsho indawo bagcina beyithole eNgamu phetsheya kukaGwayi khonale esititshini sesitimela esiya eVictoria Falls.	At the end of the day, the tour operators dropped us off at the railway station for a night ride to Victoria Falls.
"Wanezela: ""Kumelwe nibe ngofakazi balezi zinto."" - Luka 24:44-48."	"You are witnesses of these things"" (Luke 24:46-48)."
"3 ""Neni kubulelezi kale-kale litaba za kwamulaho.*"	"**** ""shall not be subject to judicial review"" ****"
Nokuthula Ngwenyama, Miasma for Solo Violin	by The Mamas & The Papas for violin solo
Kuhle kakhulu, okokufundisa okufana nalokhu yikho okusisiza siqonde futhi sazi ukuthi yini esinayo phambi kwethu.	It's feedback like this that helps us learn and continue to be the best at what we do.
Ukukhulula Ukraine kubahlaseli amaNazi awuzange sithathwe kalula.	Invaders were helped by Ukrainian Neo-Nazis.
Bhala inkulumo elungiselelwe ozoyethula kulo mcimbi.	Arrange a talk show on this issue.
"Izingane icala ""langa thokozile"" kufanelekile izingane enkulisa futhi izingane ezindala."	There is also a 'Day of the Dead' workshop suitable for older children and teenagers.
I-COB tech ingasetshenziswa nasemasimini okufaka isicelo ukuthi amanye amaphakheji ayinayo indlela yokuyifinyelela.	The web-site may also use cookies which are not necessary for its functioning.
Ojal wuod uyoma	The only motherfucker
Umsebenzi ongaxhunyiwe kwi-intanethi uvumela abasebenzisi ukuguqulela itekisi ngaphandle kokuxhunyezwa.	It has an offline translation feature, that enables users to translate text without an internet connection.
Ukwenza ekhoneni zezingane kuleli zwe	Contempts of the children's rights in the world
Nokho, umphumela ekugcineni uyefana.	Ultimately, though, the result is the same.
Yikho-ke kwahlelwa ukuthi kube lothile ozafunda laye.	So, an arrangement had to be made for somebody to write the examination for him.
Ikhupha amathimila amanengi.	It produces a lot of cellolite.
UZondo uyaziwa ngezinkulumo zakhe ezigqugquzela emsakazweni.	Touring Mobilis is known for its traffic updates on the radio.
Kuyaxaka ukuthi umuntu ungena kanjani komunye athi shiqe ngaphakathi kuye.	It's funny how one person can come into your life and flip it upside down.
Ukuwela akunzima kepha kuthatha isikhathi eside ngakho-ke konke kuncike esikhathini onaso.	Finishing a full Iron is not difficult, it all depends on the time you spend on the course.
Ukuze usho isibonelo sedolobha laseNew ...	Let's take the example of a new ...
Kholo Sinqobile Mnyandu says:	obsequious in the dark says:
Ukuqonda ukuthi asikho isidingo sokugijima nxazonke zama-	Recognizing that there is no need to reinvent the wheel in
Umahamba-nendlwana e-Bonney Lake	The lightning in Lake Bonney.
Kusobala ukuthi lesi sikhala idinga flooring ekhethekile.	This system requires a special fluid.
11:5 Kodwa u-Anna Wahlala eceleni ngendlela nsuku zonke, phezu phezulu egqumeni, kusuka lapho wayezoba akwazi ukubona ibanga elide.	11:5 But Anna sat beside the way daily, on the top of a hill,
"""Umyeni wami usehlale esibhedlela amasonto amabili."	My husband was in the hospital for 2 weeks.
"""Yimina omncane kunabo bonke abadlali eqenjini."	"""I am the youngest member of the team."
Izinto ezimbalwa azenzayo ezibonakala zimpumelelo kuye:	A Few of Her Accomplishments:
Khetha umkhiqizo udinga ngamunye.	Choose any one product.
Ngizolanda uSenzo aye ekhaya njengamanje.	I will be heading back home now.
Uma isimo sezulu sizodinga ukuchelelwa okuningi, kuzodingeka ukuthi uvakashele kaningi kunalokho.	If you need a guest permit for longer, you will have to submit additional applications.
Ube seya ezohlobeni zowesifazane, eduzane nawo lo muzi, eyofuna okhiye bokungena ngaphakathi.	One day she went to watch the house of a neighbor lady who lived close by, who had to go into town to do some errands.
"Ngithanda kakhulu inhlonipho yena, ungumuntu onothando nokwaziyo ukungibekezelela,"" kusho uZakwe."	"I want to find a good guy who loves me and treats me with respect,"" Allison said."
Uphahla, futhi angavulwa.	Roof can be opened up.
Isibindi sabo mkhulu phakathi kwabo;	Pride is among them.
"USawule wathi kuye: ""Ningenzeleleni ugobe, wena nendodana kaJese, ngokuyinika isinkwa nenkemba, uyibuzele kuNkulunkulu ukuba ingivukele, ingiqamekele njenganamuhla, na?"""	"And Saul said unto him, Why have ye conspired against me, thou and the son of Jesse, in that thou hast given him bread, and a sword, and hast inquired of God for him, that he should rise up against me, to lie in wait, as at this day?"""
Ngakho-ke, ungaguqukela kuye noma usuke kwezinye izinhlobo ngaphandle kwezinkinga.	Therefore, you can easily take advantage out of this in some manner or protect from some serious effects.
Kodwa indima yakhe ephambili kunawo wonke uye wabonisa kusekude ukufika lapho.	However, his biggest success has come at longer distances.
Ukuhlukahluka kweMicroeconomic: ziyini?	Microfinance: What it is.
wo har pahla waqya zindegi ka	It's still running on the browser
b zonke izibophezelo, amalungelo nolunye udaba oluqedwe yisigaba 240 1 ngengane ziyabuyiselwa.	(b) all responsibilities, rights and other matters terminated by section 267 (1) in respect of the child are restored.
II-UK iyisizwe sesibili esihlosiwe ngemuva kwe-United States.	The UK is the second major country after the US.
Bathi ngikulandela njalo	According to them, they suit me.
E46 I magi abadok	Sixty-four of these have already been
Empeleni, ne izikhala eziningi kangaka ngosuku, senza okuningi kuka ezombusazwe nje.	And day by day, we do so many things that only add to our debt.
Nephepha abelifunda seliyamcasula ngoba sekuyisikhathi eside elindile.	The ones I have read also suffer from a lack of plot.
Vula isipheqi.	Open up a box.
"""Umthetho nabaprofethi kwadingeka isikhathi sabo kwaze kwafika uJohane."	'The Law and the Prophets were proclaimed until John.
"20""Kepha uNkulunkulu wathi kuye: 'Wena siwula, ngalobu busuku umphefumulo wakho uzakubizwa kuwe; pho-ke, izinto ozilungisileyo ziyakuba ngezikabani na?'"	"Will ""What do you deliver to them?"""
Chika, kungani ungahlali phansi ngebhayisikili lami?	Why not cycle on a bicycle.
Ukulele top 5 _ maria gadÃº	The Roaring 20s: Lady Gaga
uKhala Kanjani - Zahiphop	What's Going On Meaning - Shmoop
Kuyasijivaza singababhali ukusebenza kanzima sibhala	We don't let ourselves write bad writing.
Zangwa Nomazango	Rebuffed by Courts
UGrace udikiwe yindlela uWandile amqoqosha ngayo.	Gwen is overwhelmed by Lisa s generosity.
Ehlangothini elingaphansi kwemigwaqo, ukuphela kwemizimba ehlatshelwe imihlatshelo kuyohlala ngaphandle kokungcwaba.	The bathrooms behind the sanctuary will be the only ones open.
Lo mbukiso ungigcinele isimanga.	The spectacle amazed me.
Lokhu ngiyakucacisa, kuzothatha isikhathi eside, kepha kukude kakhulu kunokujwayelekile.	Keep in mind that it will take time, and longer than usual.
Ngakho-ke, mhlawumbe imiphumela yokuguquka kwesimo sezulu ayisiyimbi kangako.	Therefore, the impact on consumption might not be as bad.
We ukuthola inombolo 22.	It's number 22.
Ngo 1838, i-Exeter Diocesan weBhodi Yemfundo ukuxazululwa wathola isikhungo imfundo nokuqeqeshwa schoolmasters, isinyathelo sokuqala salolu hlobo England.	Ann 1838, the Exeter Diocesan Board of Education resolved to found an institution for the education and training of schoolmasters , the first such initiative in England .
Ngesikhathi esifanayo uphenyo wenziwa phakathi kwezinyanga ezimbili.	It followed a two-month investigation.
Unogwaja yizilwane ezivamile endlini.	Insects are commonplace in houses.
Kufanele sihlanze indlu ngaphambi kokuthi kufike izivakashi	The maid is going to clean up the house before the guests arrive.
Isinqumo iza lapho uqala ukufuna.	The decision begins once you start thinking about it.
"Ukuphikisana nalokhu ""ukwenza kabi esivumelwaneni"" bekungabanye abapristi, uMatathias namadodana akhe amahlanu, omunye wabo kwakunguJudas Maccabeus."	"Opposed to this ""acting wickedly against the covenant"" were other priests, Mattathias and his five sons, one of whom was Judas Maccabeus."
Njengobude bazo, ngokunjalo nobubanzi bawo.	stars, as well as their magnitude.
"""Uma lingakasho ukuthi ubani akabulawe ubengabulawa."	"""If he had not arrived when he did he would have died."
Thaila ayala nakedBabe: Beach: Nude	The maps of the city: Navia
Yize bengivele ngikhiphe iningi elingikhathazile, ngizodlulisa umyalo ukuze ngibone ukuthi kwenzekani.	Even when I halfway wanted to put it down, I kept reading to see what would happen.
Ukusebenzisa lolu hlelo lokusebenza?	We want to use this program?
On wonke, izimonyo Indian yenziwe ngezithako zemvelo ziyingxenye asezingeni elifanele.	All nukes in India are in component form.
35Bangitshayile, kangizwanga buhlungu; bangidutshuzile, kangikunanzanga.	35 'They hit me, and I was not hurt; They beat me, and I don't feel it!
Njengoba nje inkolo sisekhona.	Although religion may still be.
Ivumela ushintsho lwedatha kuphela ku-Design Master.	Design changes can be made only to the Design Master.
"""Uchame futhi okwesihlanu."	Okay, now you're right for the second time.
Izimpahla kanye nezinsiza ezilinganisiwe kuzindleko ezingaphakathi kwama- R5,000 kanye nama-R100,000 angatholiswa ngokumema amakhotheshini entengo abhaliwe avela kubanikezeli abavunyiwe okungenani abathathu.	When the proposed purchase/contract cost is between $5,000 and $25,000, at least three informal bids shall be solicited from viable sources.
"Yiqiniso, ""shaba"" ngezinqubo zomsebenzi nokuphumula kwakuyiphepha."	"Of course ""spiritual work"" and ""helping yourself"" were okay."
Abadobi ukuza lezi zindawo catch enkulu.	You are not going into the sea to get those big fish.
AmaMongol nakubheka njengento kokuba ngenhloso embi.	The South Koreans are also guilty of wishful thinking.
Kuba khona imibhangqwana eminingi ukuchitha okukhulu isikhathi babelana ngokudla, fun, nokwakha izinkumbulo obuhlala.	It's where many couples spend a great deal of time sharing food, fun, and creating lasting memories.
"Lokhu ngeke kuze kube sekugcineni kahle."""""	"This is not going to end nicely. """
Around - eziningi izibonelo.	Come on -- there are lots of examples.
"""Ngemuva kokusebenzisa lolu ketshezi izinsuku ezintathu, izinduna zivele zoma zase ziyaphela nya,"" esho."	"""After using the product for a few days, my head started to become dry and itchy,"" he said."
Umuntu ojwayelekile oqhuba ibanga elideibhayisikilitour kuthandaumjikelezophakathi kuka-40 no-60Izinkulungwane (Amakhilomitha angama-64 96) lilinyeusuku.	40 to 60 milesThe average individual conducting a long-distance bicycle tour will cycle between 40 and 60 miles (64 - 96 kilometers) each day.
Abanamakhono umbhali American.	American literary agent.
(Iqeda ngolimi lwesiNgisi sengezwe ngokuvumelana nemithetho ezisohlwini section ekhethekile kwalesi sihloko).	(Conducted in accordance with applicable sections of California law.
Ngiphonsela inselelo ukuthi ngeke uthole umbono ongcono we-Lavasa kunasefulethini lethu:).	I challenge you won't find a better view of Lavasa than from our apartment:).
Iphuzu alilawulwa! >	The term is out of control!
Imibiko ehambelanayo Kutholakale 6 wezidumbu zabafuduki olwandle	report is based on interviews with 67 sub-Saharan migrants
Isethulo sethu siyatholakala kuwebhusayithi ye-ISIRC.	The summary is available on the IRS website.
8:13 Base bebuya empini ngaphambi kwelanga,	Judges 8:13 And returning from the battle before the sun rising,
Umusa okhonjiswa umuntu ohluphekayo nosweleyo?	Shown compassion for the poor and needy?
Kungenzeka wavumela phezulu ngombana ukulandisa kumhlathulula njengowathatha umndenakhe baphuma e-Uri.	In fact, he tells us so in his author's note when he assures us that he has taken liberties with his family's story with pure abandon.
Babengenaso isikhathi sokubuza amakhasimende ukuthi bayawadinga yini amapulasitiki.	They do not have time to ask whether the customer needs plastic bags.
Kuyaziwa ukuthi lo mshado uhlale unyaka nonyaka.	It is my understanding that this event is held each summer.
Isici esibalulekile kule nqubo ukuthuthukiswa ukuhlaselwa AOE.	A crucial element to this happening is the improvement of AI.
"""Lapho kungenzeki kungenzeka: ezamehlela empeleni non-abavamile."""	"And when it doesn't come, really, really, really bad things can happen."""
"Yisiqubulo Taurus owesifazane: ""Ukusebenza kanzima usuthela!"""	"The voice of Ishtar rings out: ""Mortal, thou hast done well!"""
Kuhlala kuphela ukugqoka, ukuthi isizukulwane esilandelayo sabantu abadlali abasha sizophumelela kakhulu.	It always has seemed to me that writers assume that the next generation is going to have a perfectly happy life.
Kodwa umzimba wakho wenza futhi usebenzise ezinye izinhlobo eziningi ze-hormone ezithinta ezinye izici zempilo yakho-kusuka ezingeni lakho lamandla, isisindo, isimo sengqondo nokunye okuningi.	However, a woman's body produces other types of hormones as well that influences other aspects of her health including her mood, weight, energy level, and more.
Kumele thina ngamunye sihambe indlela yethu singabi nalutho oluthinta omunye kithina - yini engalungile kulokho?	Each of us has to find our own path through life - there is no one way.
Umsebenzi udingeka ngaphansi kwazo zonke izimo futhi ngezinye izikhathi kuzo zonke izimo zezulu.	Action is needed at all levels and on all timescales.
Ikhishi namuhla ikhiphe kudivayisi owenza lutho.	Today, shake off the self-pity.
Bernard unethemba lokuthi lolu suku kuyoba inhlekelele kuye.	I hope this movie is a hit for him.
Mani Å¡Ä·Å«ningi.	Who is grieving.
abanye ukuba basize.	others to help them.
Nokho, lapho udoti ubuchwepheshe imiphumela enjalo engathandeki cishe ziphinde zenzeke.	Upon decommissioning, these effects are likely to be reversible.
I-thrombosis ejulile ye-vein - Ukwakhiwa kwamagundane egazi emilanjeni yakho emilanjeni ejulile kubonakaliswa ubuhlungu nokuvuvukala kwemilenze yakho.	Deep vein thrombosis- The formation of blood clots in your legs' deep veins is symptomized by pain and swelling of your legs.
njalo uma ethenge ukudla uvele	Every time they get food out of date.
"Njengoba isisho sibonisa, ""ezishibhile futhi onamileyo."""	"Label says: ""Rich and smooth."""
imininingwane yezezimali enjengezinombolo zekhadi lesikweletu / lasebhange;	Financial information such as credit card or bank account numbers;
Igazi kusukela emzimbeni	the blood of the body
Ukuqonda i bullish ekukhoneni ngaphambili	Defeating the Bullwhip Effect in Forecasting
Kuze uze ufinyelele noma yikuphi ubuso, akukho lutho olungashintshwa.	Till you find your voice, nothing can really change.
Kodwa abantu abaningi abalibambi ngezandla zombili leli thuba eliyivelakancane.	So many people do not take advantage of this simple opportunity.
ukuhamba nge-style controlande izimoto ezihlukahlukene kuhlanganise izimoto, amaloli, izithuthuthu kanye nezikebhe ukuzingela izitha zakho, ukugijima endaweni yendawo yokudlala noma ukuphunyuka ngokushesha.5.	Free a variety of vehicles, including cars, trucks, motorcycles and boats, to hunt down your enemies, drive into the play area or flee quickly.
Ebuzwa ukuthi kungabe wumuntu onjani ongaba senhlanhleni yokuthandana naye, uveze ukuthi ufuna uswahla lwensizwa esukile egadeni futhi enephakethe eliqinile impela.	When asked what is one business idea he is ready to give over to others, he replied that he has a child who has a severe food allergy to sesame and nuts.
Ngalesosikhathi wayemdinga sibili umngane weqiniso.	He was really a friend in need.
"Yinyanga lapho izingane ezifunda isikole zenziwa ukuba zilalele inkulumo kaDkt King ethi ""Nginalo Iphupho"" futhi kungenzeka zinikwe amashidi aqukethe isithombe sakhe azowafaka umbala bese elenga odongeni lwekilasi."	"It is the month in which school-aged children are made to listen to Dr. King's ""I Have a Dream"" speech and are possibly given sheets containing his image to color and hang on a classroom wall."
Kwezinye ngokuningiliziwe izinto ezithinta izikhali zamakhemikhali nezinto eziphilayo abe ukufana okuthile.	In any case, there were separate treaties covering chemical and biological weapons.
Lokhu kungenzeka uma lezi zifo ezilandelayo:	It can happen if the following conditions occur:
Lokhu kuyisici esibalulekile ekuthuthukiseni umnotho ngempumelelo lesi sizwe.	It is paramount to the successful development of our nation.
2 wakwatapheya, osuswe isikhumba kanti waqotshwa izicucwana ezincane.	They also observed a pair of shoes that were wet and coated with grass cuttings.
Ngo endlini waseGibhithe yizicukuthwane	The Mystery of the Egyptian Vulture Country House
Ngaleso sikhathi ngangiqala ukuqaphela konke ukugijima kwe-5K.	That was the first time I started training for a full 5K.
Kuyadingeka ukuba acabangele ngaphambi kokuthenga.	It needs careful planning prior to buying.
Anginalo iqiniso lokuthi ngizokhona kanjani, kodwa ngizokwenza ngandlela thile	I don't know how I'm going to do it, but somehow I will.
Kodwa manje njengoba ungekho ngihlezi ngikhubekile	However, now that I'm pregnant I haven't been hangry.
Chinaza Onwubiko, Chinweizu Ejikeme Udobi	tions, but inhumation, even under barrows, is also attested
Kungani ngikubeka kanjalo?	Why I put it like this?
Njalo bayangihlola futhi bangibuze ukuthi ngizizwa kanjani.	"""They always look out for me and ask how I'm doing."""
Obama 2016 _ Banal Leakage	for 2016 - North America leads the way
Ukupaka kwamahhala ne-WIFI.	Cocksure and fancy-free.
Ngicabanga ukuthi singakwazi jabulisa abantu.	We think we can fix people.
"Angiyicabangi impilo yami ngaphandle komculo. """	"I just can't think of a life without music."""
hlola iwebhusayithi yami futhi ungitshele ukuthi ucabangani.	Visit my website and tell me what you think.
Kungokokugcina lapho umuntu eyocwengwa ngaphambi kokuphethwa komsebenzi wokuphatha kukaNkulunkulu, futhi bonke labo abalandela uNkulunkulu kumele bamukele ukuvivinywa kokugcina, kumele bamukele ukucwengwa kokugcina.	All action with respect to the faith of others must be exercised by God while we wait for the last judgment.
Ngemva yalesi sifo, ukusetshenziswa eside izidakamizwa e amakati kungaba ngokuphawulekayo sibe sibi impilo.	After a long illness, a longThe use of drugs in cats can significantly worsen the state of health.
Phila eziyingozi kakhudlwana kuleli zwe.	a more dangerous world.
Bangu izinhlobo eziningana zabathengisi lapho abafuna umsebenzi bangaqala khona ukuqashwa.	There are several types of retailers where job seekers can start employment.
"NguNkulunkulu kuphela ongakwenza lokhu!"""	"Only God gets to do that."""
sindisa nxusani 0Z8 start no	Getting Started with v2.0.8
Okunye osekugqanyiswa eyobudlelwano lo Mengameli abenabo namazwe angaphandle ikakhulukazi awase-Europe okubalwa iFrance.	A key focus of our preparatory work has been engaging with fellow EU Member States, including France, who face similar challenges to Ireland.
Ngemva kokuncedisa indoda le lemuli yayo baqalisa ukusiza abanye ababehlala kulesosakhiwo.	Along with the committee's members, Lelono started to visit residents.
Yiningayi - Mt.	It's matt.
Yazana nombungazi wakho, u Bastien	We find your friend, Bassam.
Ngibone ukuthi ngeke akwazi ukulwa ngendlela inkosi eyasifundisa yona sisekwelakwa Mthethwa.	It would have been impossible for me to figure out the truths the Lord has taught me.
Indodana ingenza abantu bahloniphe ababelethi bayo namkha ibenze babadelele.	The child may lose trust and respect for their parents or idolize the celebrity.
Yini ongathanda, ma'am?	"""What DO you want, Mother?"
Kulokhu, iziguli zinelungelo lokukhetha udokotela zabo.	Patients will have the right to choose their family doctor.
Ngemva kwesikhathi edingekayo, begeza off the zehena.	When used, they wash down the drain.
Manje kukhona cishe akayena umuntu oyedwa owayengeyena ujwayelene nomsebenzi wakhe e-movie.	She was most definitely NOT the person she acted in her films.
Ngino Nkulunkulu 'geka ashintshe	The God Who is Unchanging
Note: Sinabathuthukisi edolobheni ngalinye.	Fosters: We need fosters in all areas.
Mhlawumbe esikhathini interglacial kulezi zingxenye yayithambile kakhudlwana futhi isimo sezulu esifudumele.	On the other hand, surface temperatures in these parts of the Atlantic Ocean may have been higher in the past.
Ziyakwazi kulula umshini, kukhona Weldable, futhi kungaba kwezulu lukhuni, kodwa hhayi amandla okusezingeni eliphezulu ukuthi 2000 futhi 7000 ongafinyelela.	It has good mechanical properties, it is easy to machine, it is weldable, and can be precipitation hardened, but not to the high strengths that 2000 and 7000 can reach.
Indlela aphila nale fomu?	The future of the form?
ls -a: bonisa amafayela afihliwe.	D/A: writes out voltages.
Ngaphansi kwezimo ezijwayelekile, sibhekisa isilinganiso semiklomelo engcuphe engu-1: 3 - ukuze kuthi uma ufaka i-oda esigxotsheni esingu- $ 60, singahlose ukuthola inzuzo engu- $ 180.	Under normal circumstances, we target a risk-reward ratio of 1:3 - so that if you were to place an order at a stake of $60, we would aim for a profit of $180.
Omunye simple slip-up and BAM, ubhekene gone.	Single press of the button and bam, it's on.
Amahlelo la asisiza bona sivikele iinhliziyo zethu.	They help us to open our hearts.
Kulaba abathathu wayetusekile kunababili, waba yisikhulu sabo, kepha akafinyelelanga kwabathathu bokuqala.	Of the three, he was more honorable than the two, for he was their captain; however he attained not to the first three.
Ngakho, nginesu elingcono.	I have a better Plan.
Uma umama okhulelwe akuyona 25 iminyaka, ingozi e isilinganiso 1 kuya 1400.	For women under 25, the probability of having a special child is 1 in 1400.
Ngakho-ke, umzimba uthola ukwaneliseka okungenamsoco ngaphandle kokulimala kumanyikwe.	So the body receives the necessary elements, without causing harm to the stomach.
Yingaleso sikhathi lapho i-passport yakhe ishintshile.	It was at this point that my status changed.
Ngokuya nge-DigiTimes, njengoba babelane ngayo Ama-MacRumors, ukuzinza ngokusebenzisa ukufuduka kwenzwa kuzobakhona kuwo wonke amadivayisi azokwethulwa ekupheleni kuka-2021.	According to DigiTimes, as they shared MacRumors, sensor displacement stabilization will be present in all devices that will be launched at the end of 2021.
Kodwa senza lokho esifisa ukuthi abanye bakwenze kithi. - UMathewu 7:12.	We do to others as we would have others do to us (Matthew 7:12).
Ngi buzile into zonke, Zi sho ngazwi linye zonke;	I'm supposed to answer each thing with a single word.
Musa uphakamisa ngokwakho, kungenjalo ungakwazi abakholwanga, kodwa musa kancane amakhono azo.	not tread it blindly, but in the light of knowledge.
Ukushintsha ukunikezelwa kosizo ukuhlangabezana nezidingo ezingqangi ukubhekana nokungalingani kwaphambilini.	The need for corrective measures to deal with the consequences of past injustices is overwhelming.
Abaholi bebandla babecele ukuba labo okungokokuqala befika enkonzweni beze ngaphambili.	Fire district trustees brought the plans to county board members for the first time.
Inkampani ye KPMG ithi abantu ababesenza imali enengi ngesikhathi kusasetshenziswa idollar le Zimbabwe balahlekelwe sokusetshenziswa imali yamanye amazwe.	Chinese media pointed out that the company's owner lost large amounts of money in currency trading and fled out of China.
"Ubonisa futhi uqinisekisa ukuthi (a) akutholakalanga ezweni elingaphansi komngcele woHulumeni wase-US, noma oqokwe nguHulumeni wase-US njengezwe ""elisekela amaphekula,"" futhi (b) ubhalwe ohlwini noma yiluphi uhlu loHulumeni baseMelika bamaqembu enqatshelwe noma anqunyelwe."	"You guarantee that (i) you are not located in a country that is subject to U.S. Government embargo, or that has been designated by the U.S. Government as a ""terrorist supporting"" country, and (ii) you are not listed on any U.S. Government list of prohibited or restricted parties."
"""Engikubona njengo-kusidlisile eKapa ukuthi sakha inqwaba yamathuba kodwa sehluleka ukuwa-sebenzisa."	"""I think we have to work more on our conversion because we created a lot of chances but failed to convert them into goals."
Kuthiwa zingaphezu kuka-50 izimoto eseziduniwe umkhondo wazo ongakaze utholakale kusukela ngo-2017 kuze kube yimanje.	Further data reveals that over 170 routes have been cancelled for 2017.
Lishe laba ngumlotha Worker Indawo	Sendmail has evolved into a work-horse
Zakudala Zama ukoma imicu.	Trying to clear old stock.
Futhi umphumela wokulungisa uzofakwa kuhlu ngezansi komyalezo.	The result of the modifications will be available back in the calling program.
Kukholakala ukuthi babegqoka Kristu.	They were reportedly dressed like Jesus.
Futhi ungagcina omningi isikhala ukuthi namuhla kumelwe.	However, many people might feel that it still applies today.
"Bekungasilo usuku lwethu."""	"It wasn't our day."""
Ubuhle Bakho House Song	This Is Your House Song
Ngakho kungakhathaliseki ukuthi lezi zinyoni oyisiphukuphuku?	So, these are the stupid birds.....
Kunamagquma amathathu kuphela angatholakala emikhawulweni yedolobha (eJingshan Park enyakatho yeDolobha elivinjelwe) futhi izintaba zizungeze inhlokodolobha ezinhlangothini ezintathu.	There are only three hills to be found in the city limits (in Jingshan Park to the north of Forbidden City) and mountains surround the capital on three sides.
UMchunu uthe amanye amalungu ombutho wamaphoyisa afakwe ngaphansi kwalolu phiko.	The honorable member said some members of this Government had participated in that practice.
UHlelo-Ukubhala ikhompyutha amaphakheji ngokuqondene nezinjongo eziningana.	Writing computer programs for various purposes.
14Usenze saba yisiga phakathi kwezizwe, ukunikinwa kwekhanda phakathi kwabantu.	14 Thou makest us a proverb among the nations, and a nodding of the head among the people.
Ubengumfundisi wezokuxhumana nobuntatheli kwangqondonkulu.	He was a paramedic and communications specialist.
Eminye amaphrojekthi amaningi okuhlala aqhamuka endaweni.	Numerous other cultivars are grown on a local basis.
Mindset Cabanga (Cabanga is the	The distinction (I think) is that the
Ukugijima kusihlwa kunenzuzo yokuthi umzimba wakho ulungele ukuvivinya umzimba.	Walking is an easy exercise to get your body ready for the day.
Name: bhekisisa Zondo	Name: Looking After The Herd.
I-Democrat ibukeka ingalungile.	Democrats certainly seem to be evil.
ngenxa yekusasa labo kanye nekusasa lomhlaba wabo.	about their future and their hometowns' future.
Ngalokho-ke, nasenze into ephambene nokulunga, kufuze sibawe uJehova asilibalele ngehlawulo kaJesu.	When we've done something wrong, we can be held accountable through the grace of Jesus.
Kungaba zithathwe kuyi yimuphi ubukhulu, umkhiqizo ezifana isidlo inyama neze konakalisa.	Traceability, when it comes to animal products such as meat, is incredibly important.
I-bandage enamaqabunga ishintsha izikhathi ezi-2 ngosuku.	Grubby bandages that are changed twice a day.
[mp3] Izintombi Zase Mhlangeni - Bhasobha Nsizwa / Usuka Emqadini listen to all release completely in mp3 impossible, download release album mp3 impossible too	Coolio - 1, 2, 3, 4 (Sumpin' New) listen to all release completely in mp3 impossible, download release album mp3 impossible too
"U-Abimeleki wathi ku-Isaka: ""Suka kithina, ngokuba unamandla kakhulu kunathi."""	And Abimelech said to Isaac, Go away from us, for you are mightier than we are.
Iziphathimandla zendawo ziyaphenya.	The local authorities are investigating.
Lapho uwathola, kudingeka uwavikele angahwamulwa yilanga.	If they must stay outside, ensure they have protection from the sun.
Uma ungowalapha futhi iminyaka ivuma, unelungelo lokubamba iqhaza uma sekuvotwa.	If you are eligible, and have taken the steps to become registered, then you have the right to have a say in the election.
Yilokho okushiwo yile bhulogi.	That's what that certificate means.
Kula mathebula kwamukelwa nguFunda kabanzi...	These plates are highly appreciated by ......
Ayinaso isikrini ngolwazi.	It does not have zero knowledge encryption, however.
Incwadi yesithenjwa	the book of hope
Okumhlophe, Okubomvu, Okumnyama, Okuluhlaza okwesibhakabhaka, ngokwemfuneko yangempela yekhasimende	color white, black, red, blue..et. according to customer's requirement
Wena kuphela okunye senze isimo sishube.	You are the only one putting stuff up in animation.
(IsAmbulo 13:3, 4; 16:2) Lokhu bakwenza ngokulihlonipha sakulikhulekela izwe labo, uphawu lwalo noma amandla alo ezempi.	(Revelation 13: 3, 4; 16:2) They do this by giving worshipful honor to their country, its symbols, or its military might.
Let George Do It ukulele	Let George Do It (0)
I-iyunithi yokuqasha ephelele ibungazwe ngu-CÃ©sar Mauricio	A man's labor never belonged to Caesar.
Ngicela ukuthi ngiqale ngiye ezintabeni lamankazana angabangane bami ukuze ngiyekuba labo okwezinyanga ezimbili.'	"I'm going to look at the fingers of the two other women who are coming to see me now that are a couple of months along."""
Noma okungenani iningi.	Or at least most of.
Uma uhlela ukugubha ngezinye izinto, uyafuna ukukwenza ngesitayela.	When you plan to celebrate with some bubbly, you want to do it in style.
Ukudla ingxenye yomzimba kugaywe, manje obizwa ngokuthi i chyme, akube kusakhulunywa ngaye isisu bese iqala adabule amathumbu amancane.	The partially digested food, now referred to as chyme, exits the stomach and begins passage through the small intestines.
"Kuyini esingakwenza ukuze sitshengise ukuthi siyawulalela ""umthetho kaKhristu""?"	"Q. How can we fulfill the ""law of Christ?"""
Futhi ngo-September 21 (Ukuzalwa KukaKristu laseTheotokos) izimpawu ngokuphathelene nekusasa ukuphila abashadayo.	Also on September 21 (Nativity of the blessed virgin) signs were made about the future life of the spouses.
Indlela esetshenziswa ngayo	The manner in which it is used
Kungakhuphula ubungozi bomdlavuza wekhanda we-pancreatic:	These factors may increase the risk of getting pancreatic cancer:
"""Usahleka namanje?"""	"""Are you laughing yet?"""
Kwazi bani, mhlawumbe la idatha ukwenza abantu abaningi ukuba bathuthukise ukuphila kwabo siqu.	Who knows, maybe it will make people more determined to change everything.
Imvamisa ngiwumlandeli weFedora, kepha izinketho eziningi ziba ngcono	I'm a big fan of zooms, but many others prefer fixed.
Gcina le nja ku-leash yabo ngaso sonke isikhathi futhi uqiniseke ukuthi bahlala eduze kwakho.	Always keep your dog on a leash and be courteous to those around you.
"""Ilizwi elikhulunywe ngesikhathi esifaneleko lifana namahabhula wegolide akghabise esitjeni sesiliva."" - IZA."	"""As an apple of gold in silver carvings is a word spoken at the right time for it."" - Proverbs 25:11"
Kwezinye izindawo, umbala wawusetshenziswa ngokufafaza imibala ngokushaya ingxube nge-tube.	In other areas, the color was applied by spraying the pigments by blowing the mixture through a tube.
Thandekile Ruby	My best friend Ruby
1:3 Kuba yabona, INkosi iya kuphuma endaweni yayo.	3For behold, the LORD is coming forth from His place.
Sebenzisa Lapha!	// use it here.
Imane, kukhona umthetho owodwa kuphela - isikhathi.	Well, in English we only have one word: Time.
Bavame ukubhekana nezinkinga esikoleni, bebhalwa nge-ADD	Learning difficulties are often picked up at school.
ukukhiqizwa nyangazonke abangaphezulu kuka-1500 amasethi.	More than 1500 forecasts are made every month.
(Gen. 3:6) Abantu abaningi abaye behluleka ukuzithiba baye babhekana nemiphumela ebuhlungu.	(Acts 13:22) Many a battle has been lost through failure to follow orders.
Tag: thokozani langa ukuzala ukuzelula	Topic: I'm pleased to say its official
Lapho-ke amathuba makhulu okuthi...	Therefore, there is a high chance that...
Nasi isichazamazwi sami saseSpain / sesiNgisi.	That is either English or/and Spanish.
Ukulele Tabs Take That ukulele tabs	The rule of thumb is that growth
"""Sinezinto eziningi okufanele sizilungise."	"""We have a lot to improve."
Qalisa kudokotela futhi qiniseka ubambe imvukuzane ehlinzwa.	Go to a surgeon and you get surgery.
10.33 Uma ngabe kukhona izixhushuxhushu zabasebenzi ukuphepha kufanele kuqiniswe.	3, transaction security needs to be strengthened.
Ongusihlalo we SGB uThandi Shezi uthi ngeke nje baze bayeke ukubhikisha kuze kube ukuthi isikhalo sabo sikathishanhloko siyezwakala.	The protesting Aam Aadmi Party leaders said that they will not call off their strike until their demands are met.
Unikeza isiqondiso esisidingayo ukuze senze izinqumo ezinhle ezidumisa uNkulunkulu.	He provides the guidance we need in order to make good decisions, ones that honor god.
"Isikhungo sizovalwa kuze kube kukhishwa isaziso esehlukile,"" ngokusho kwesitatimende."	"""The course will be closed until further notice,"" according to a news release from the college."
Uluhlaziya kanjani uhlobo lwethu ngesandla	It goes hand in hand with our status
Ukugibela edolobheni futhi ezindaweni ezimagebhugebhu	Return to the Flooded City
Sigcine kushampeni wasoGwini uNkk.	Put yourself in the place of Mrs. Matthews.
Imikhakha emithathu ...	The three fields...
Kwaze kwaba kweMpi Yezwe Yokuqala.	until after the first World War.
Isibonelo, uma ungeza ikhadi lesikweletu noma enye indlela yokukhokha ku- akhawunti yakho ye- Google, ungayisebenzisela ukuthenga izinto kuwo wonke amasevisi ethu, njengezinhlelo zokusebenza ku- Google Play Isitolo.	For example, if you add a credit card or other payment method to your Google Account, you can use it to buy things across our services, such as apps in the Play Store.
8:6 Ngoba ngokwaso futhi kwa-Israyeli: isisebenzi kwenza kwaba, futhi akuyena uNkulunkulu.	6 For it is itself also from Israel: a workman made it, and it is not God.
ISerotonin Selective Reuptake Inhibitors (i-SSRIs) yindlela yezokwelapha ejwayelekile ekhethiwe yokubhekana nokuphazamiseka kwemizwelo nokudangala.	Selective serotonin reuptake inhibitors (SSRIs) are a group of medications used to treat depression and anxiety disorders.
"""Kulala Desert Lodge is amazing"""	"""Beasts Of The Southern Wild"" Is Incredible"
Into kuphela ukuthi kwakungase ukwesabisa - ukucindezeleka.	The explanation could also be very simple: Depression.
About rofanini - Thingiverse	It's ALL about Rooney.. ffs
Dunedin Ukulele Lessons	D'Andrew teaches
Futhi, ufuna ukuqinisekisa, kusukela ku-Stage 1, ukuthi okuthunyelwe kwebhulogi yakho kuzokwazi ukuma ngokumelene nokudlula kwesikhathi futhi uhlale uwusizo ngisho neminyaka kusukela manje.	Also, you want to make sure, from Stage 1, that your blog post will be able to stand against the passing of time and stay helpful even years from now.
Ngakho, iqembu lokuqala lemithetho lihlanganisa izenzo nama-akhawunti wokudlala.	The first section features the games and gambling options.
vs Sindile Manengela	They were well-versed
Naphezu ukuthuthukiswa omuhle ukuhweba iimfesi, zikhona izinkinga ezifana nokushoda isikhala okudayisa.	However, despite benefits such as transplants, cloning does carry some difficult ethical issues.
"Nokho, lesi sidakamizwa ""Flucostat"" Ezimweni ezinjalo, ngendlela efanayo akusebenzi."	It also works not in Firefox in these cases.
UKoma uthe akayazi le ndoda kodwa kungenzeka ukuthi yake yahlangana nayo enkantolo ecaleni elithuize noma nomuntu owaziwa yiyo le ndoda.	Koma says he doesn't know the man, but he could have dealt with him or someone he knows in court at some stage.
Angazi noma umzimba wakho	I don't know whether the bodies
Lokhu kuhle kumakhompyutha amadala nakan...	This is What Old Computers Are Good For...
"^ Noma, ""ngilindele isahlulelo."""	"Yes, ""I'm ready to be judged."""
"Kodwa ningatatazeli uma uxilongwe ""ukuguga ngaphambi kwesikhathi umzanyana."""	"But, make sure to not run any one test for an ""extended period of time."""
Wadala zonke izinto futhi unokuhlakanipha namandla angenamkhawulo.	created all things, and set them in order, and endowed them with
- Izinto Ezintsha Eziyishumi Eziphezulu Engizifundile	Top 10 things I learned.
Lawa maplanethi amakhulu amane egesi abizwa nangokuthi amaplanethi weJovian noma amaplanethi angaphandle.	The four inner planets are also known as rocky planets or the terrestrial planets.
Umculo kamuva waya eLondon	the musical in london
inqubo Exchange yephasiphothi eneminyaka engu-20 no-45 iminyaka akuhlukile version odlule.	The Card of 10-20 years ago is not the Card of today.
Sake Ushintsha umhlaba.	Sometimes change the world.
""" Tag dodane"	Go to Dodds.
Futhi ukufaka umlingani?	The right to pick a mate?
Ngenxa yalokho, ukuma okumele kubonwe kufane kufane nokudonsa okuphikisiwe.	That said, the shape that can be seen is consistent with a canid pad.
Ngayinye yalezi imithombo kungaba azimisele njengoba yithuluzi ulwazi.	Any one of those disciplines can provide the necessary knowledge base.
Njengoba kutjhiwo ngaphambili, isifundesi sihlale somile eskhathini esinengi.	As noted earlier, the defense has sustained a good level.
Sasha Obama se ...	"""Michelle Obama is now..."
Balimaze azinikela amakhanda abo!	They would also have their heads back!
Uchazile kule video kodwa. . . .	It was explained in the video...
Siza ingelosi yakho encane idlule isigaba esibuhlungu...	You need to help the little dragon pass through...
A: amazing, bazinga	A: In so many ways, its amazing.
Lokhu kuphenduke enye yama-blog wami engiwathanda kakhulu!	Now it's one of my favorite weblogs!
Ungabese nokuhlola izingxenye iyonke.	So you can take a look at all of the data.
I-20% ivaliwe eSitewide Mayelana Amakhava nakho konke.	2% is locked in ice caps and glaciers.
Ngokusho kwabo, ihhotela akuyona entsha, kodwa izinombolo kuwo ethokomele, ahlanzekile, nge yokulungiswa fresh.	According to them, the hotel is not new, but the rooms in it are cozy, clean, with fresh renovation.
Deca Durabolin kwase kuqala kuhlelwe 1962 ngumuntu Netherlands inkampani eyenza imithi.	Deca Durabolin was developed in 1962 by a pharmaceutical company in Netherlands.
Women naked bikini	Naked women in bikinis
Ukuzazi ngokwakho kuyisiqalo sakho konke ukuhlakanipha.	To understand yourself is the beginning of all wisdom.
Sizozifihla Kuwe (We will hide in You)	"We're going to hide you with us."""
Indlela engcono: Zitshele ngemiphumela eziyobhekana nayo uma ziziphatha ngokungafanele.	More of: teaching the consequences of crime.
Ukuba ujeziswe Phakade, ubuyoba nokuPhakade.	That punishment is death and it will last forever.
Ingabe ufile ngokulwa nokuguga?	â† Have You Been Fighting A Losing Battle?
CVT akakwazi ukubhekana umthwalo.	CTB won't be able to keep up.
1989) kuyinto enyuvesi kazwelonke Catholic njengoba kungabantu abangaphezulu kuka 11,000 abafundi emhlabeni esewonke yayo e Fremantle futhi iBroome, Western Australia, futhi Sydney eNew South Wales.	1989) is a national Catholic university with more than 11,000 students across its Campuses in Fremantle and Broome , Western Australia , and Sydney in New South Wales .
Izindawo zokuhlala e- Abu Road	the sessions at abbey road
Amaphesenti angamashumi amabili nesishiyagalombili esifundeni akha inxenye Yezindawo ezimbili Zobuhle Bemvelo Obungafani: I-North Downs ne-The Weald ephezulu.	Twenty-eight per cent of the county forms part of two areas of outstanding natural beauty: the North Downs and The High Weald.
26:39 Kepha uma ezinye ezimbalwa zazo zisasele, bayakudangala ngeziphambeko zabo, ezweni lezitha zabo, futhi bayohlushwa, ngenxa yezono zawoyise nezabo izono,	26:39 But if some few of these still remain, they shall waste away in their iniquities, in the land of their enemies, and they will be afflicted, because of the sins of their fathers and their own sins,
Yebo, uKeanu Reeves owayedlala njengabalingisi abakhulu be-movie wenza ingcebo enkulu ngayo.	Keanu Reeves, the lead actor in the film, appraised them highly.
Engeza sonke i zonke izingcezu imishini futhi wande lokhu Imininingwane ngu 0.6 ukubala izidingo zangempela.	You add all the fuses together, then multiply by 10, that's the actual power rating.
Ingabe kwakungelona lolo usuku olujabulisayo?	Isn't this a happy day?
Abashayeli nalapho ehamba endleleni ngeke zihlolwe.	Even the vehicles that pass through the checkpoints are not checked.
kuyinto ukwakhiwa okungokomfanekiso ukuthi	It is a symbolic representation of
Abalandeli babememeza bethi 'Kev, ngingaba nesithombe?'	"""People were going, 'John, can I have a photograph?'"""
Kwaze kwaba ngo-1918, lapho kumiswa eCzechoslovakia.	We did so in 1918 when Czechoslovakia was created.
Kuphephile ukusho ukuthi imoto muhle endleleni.	It is safe to say that the car is pleasant to drive.
Endumeni Civic Association	Chairman of the Civic Association
Uthando lwabo luqinile futhi alungeke luphele loba sekutheni.	The love is strong and unerring.
Imane Bethi	This is merely saying
Phakathi naleso sikhathi esifanayo, isizukulwane esisha sentsha esikhulile e-United States sasibonisa ukuthambekela kokusebenzisa imali eningi ezintweni zokunethezeka.	In the United States, on the other hand, a broad public was accustomed to investing long term at fixed interest rates.
Simunye 2 vintages	- 2 whetstones
"Ngisenazo ezinye zezinto zakhe epotimendeni elingaphansi kombhede wami."""	"I got some in the bag under my bed."""
Kuthiwani nxa wake wakhipha isisu?	What if YOU were aborted?
Kholwa noma ungakukholwa, kwakungo-1923.	Let's see - no, it was 1973.
Yilowo nalowo esishukumisa kubo, ngokuqinisekile Allah, emva kokuba wacindezela yabo, iyona Forgiver (kuya amantombazane), i Nomusa .	We believe that each person must repent and turn away from their sins, in order to know the forgiveness of God.
Abakwazi ukuthi lalotshwa ukuhluza kanye reggi r'n'b.	It is not known if it is related with the contemporary Nikon BCB flash unit.
ibiyiqhawe kimi.	He was a true hero for me.
Mhlawumbe umyeni uthanda ukuzihlalela buthule ekhaya ngesikhathi sakhe esikhululekile afunde incwadi.	In his free time, he likes to read and spend time relaxing at home.
swathi samala Dec 8, 2008 10:44 AM (in response to swathi samala)	Mr. Jawfish Oct 3, 2008 10:42 AM (in response to Mr. Jawfish)
ukuqashelwa elilinganiselwe yokuthi intando kuyinto qualitatively mkhuba esiyingqayizivele phakathi kwezinye izinqubo ngokwengqondo;	Stressing that accessibility to persons with disabilities is an integral part of smart and sustainable mobility;
Ake uqale nge yokuthi ezimweni eziningi walizwakalisa into engaqondakali ngisho sona.	Every so often on a rare occasion he will say something that is inaccurate.
Pe Carbon Kuvunguza Ukugxilisa Pipe Production Line	The things aboutcalcium carbonate production line.
Yini eyobangela ukuphela kwezwe?	What will cause the end of the World?
Ukuphakama kweMeshi: I-0.6-2.5m ingenziwa ngezifiso ngokuya ngezidingo zamakhasimende	Length: Standard length is 2.2m, it can be customized according to customer's requirement.
Ungafihli ubuso bakho kimi ngosuku losizi lwami; beka indlebe yakho kimi, ngosuku engimemeza ngalo usheshe ungiphendule.	Do not take my name in vain, And do not the day of rest profane.
Sebenzisa ngokuqapha kubantu abanokwehluleka kwenhliziyo.	Use caution in patients with heart failure.
Lo mphumela azoboniswa ngemuva nolunye usuku.	The result will be available one day later.
Kunabantu abaningi ukuthi musa siyifake ulwazimagama yakho iyasebenza, futhi nakakhulu abangawazi ngisho ukwazi ukuthi yini kahle.	You'll find regretably numerous businesses who don't do the correct do the job and even more worryingly don't know what to do.
Uma kuzobalwa inani labantu abebekhona kuyacaca ukuthi lowo mhlangano awunanzuzo kakhulu kulabo ababizwe kuwo.	This option appeared to have little to no support from those attending the meeting.
Lolu hlobo izinto Kulula ngempela ukuyisebenzisa.	These things are actually really simple to use.
Isibonelo esihle salokhu kungaba yiyunithi yokupholisa umoya.	An example of this would be a lighting console.
"""Yeka, zinhle kuyinto unvarnished."	"""It's quite a selfless thing."
Ngo inqubo yokuxhuma i-inthanethi kanye cable TV akukho mqondo wokuthi imfundo ayiphelele.	An online degree program isn't the exception to a pricey education.
Mina Calini	My name is Calton.
Ibungazwe ngu-Telari	marketed by telomerase
Iphupho labo bonke abahambi ukubona umhlaba.	It's every journalist's dream to travel and see the world.
Licasulwe ezinye izimenywa zingase kube ngaphandle ukuthi ikhokhwe-Wi-Fi, obiza $ 15 ngelanga.	Day passes, which are available to non-members, are $15 per day.
Kwinombolo yomqondisi lapho iyunithi ithuke.	to select the number when the unit is in standby mode.
1993 liqhuma ibhomu e-World Trade Center omunye imibhoshongo amawele.	A bomb went off in the World Trade Center garage in 1993.
Nokho, esidlekeni ovulekile, ungaqali.	As far as the projects inside, don't get me started.
Ukuze leli sonto elidlule Bengilokhu owesaba ukufa.	Until 5 weeks ago, I have been terrified of death.
Ugabuga - Mini	modern-day {adj}
"I kinda miss these."";"	I miss all of them.'
Sinxusa uHulumeni wesifundazwe aluthathele phezulu lolu daba.	We urge the Government to take the matter seriously.
Obaba kufanele uqale ukuxoxa izinto ezibaluleke nezingane zabo kusukela zisencane.	Parents need to develop a healthy relationship with kids from their early childhood itself.
"""Uyenza khakhulu"""	"""he did very well"""
Ngakho-ke, lapha ungadlala ngokuphepha indima yomfokazi.	Therefore, here you can safely play the role of a foreigner.
Isitatimende sokuthi imininingwane esesazisweni inembile.	that the information in this document is accurate.
Inkinga enkulu yezinja ze-Feist yi-hip ne-elbow dysplasia.	The most common conditions are hip and elbow dysplasia.
Kodwa ikhwalithi embi izinto zokusetshenziswa othengiwe ukusetshenziswa amahlamvu ngaphandle kokwazi ubuchwepheshe unakho ukulimaza.	On the other hand, stored value transactions using smart cards can be anonymous.
Futhi ngoba kungenziwa.	Because it it could be done.
Ngaphezu kwalokho, le sevisi ngisho etholakala ku-intanethi.	But even this information has been suppressed on the internet.
"""Impilo ifana nomdlalo ofuna ukunqoba kuwo izingqinamba ezikumisile ekufinyeleleni ezinhlosweni zakho."	"""Life is like a game where you seek to overcome the obstacles that stand in the way of achieving your goals. ..."
Cishe ingxenye yesihlanu yesiqhingi saseNyakatho kanye no-66% weSouth Island yizintaba.	Around 60% of the South Island and 20% of the North Island is mountainous.
32 Ngalokho vukani ebusuku, wena nabantu abanawe, niqamekele endle;	32 Now therefore, rise up by night, you and the people who are with you, and lie in wait in the field.
uzojula ozojula uzojula awuzujula ongezujula ungezujula	overextending and running deep, which you can't get away with for
Place of Birth: Mabhuyeni, Empangeni	Place of Birth: Bodrum, Turkey
Waziwa kakhulu ngegalelo lakhe kwi-Music Industry; hhayi eNigeria kuphela kepha nase-Afrika.	He is best known for his contribution to the Music Industry; not just in Nigeria but Africa as well.
Cha, i-Box24 Casino ayinazo izici zokubheja ezemidlalo	No, Hotel Plaza 24 doesn't have a pool.
"Akulona ngempela ""okunamathiselwe"" nganoma yini ngaphandle kwekhadiarine."	This isn't really 'bad' for anything except a throwout bearing.
Uithol Samuel	Sam's judging
Amasosha amemeza: 'Asiphumeni lapha!	"The neighbors were yelling, ""Get out of here!"""
Isengezo esimangalisa kakhulu sendiza enophephela emhlane ye-AgustaWestland AW139.	Japan has been a reliable customer for AgustaWestland's AW139.
Lona wesifazane oshadile indaba enjalo kufanele yesabe.	Any obsession with this woman is well-founded.
"Le vidiyo emfushane (8'21 "") eyenziwe yiScientific American - iClitoris, ingumlando othakazelisayo we-clitoris."	"This short video (8'21"") by Scientific American - the Clitoris, is a fascinating history of the clitoris."
Udinga ukuthola ukuthi ubani nesandla kulokho okwenzekile nokuthi ubani uyowa ngenxa yomonakalo.	We need to find out what happened and who is to blame.
Inhloko isimo wasinda kuphela imoto armored.	The driver survived with only a broken leg.
Ingabe kuyazuzisa ke ukuya ngaphansi ngommese likadokotela ohlinzayo ngenxa yokuthuthukisa ukubukeka kwabo?	Does it make sense to increase the rated voltage of the capacitor in order to prolong its useful life?
Kukhona akulona iqiniso yibona ukuthi AmaSulumane abakholelwa kuJesu.	Do Muslims believe in Jesus.
Shingeki no Bahamut Cap.	There is no confidence in Chief Gatto.
u nga bi njengabazenzisi;	shalt not be as the hypocrites
Home Webshops Zalando Lounge	bellevue house national historic site ?
Zulu ukubuza	from the sky and asks
Noma mhlawumbe omunye umbuzo?	Or possibly some other issue.
Ovulation While _ All video's _	My back.... the whole video
Abanye ososayensi bacebisa ukuyiyeka ngokuphelele.	Some experts say to cut it out completely.
Â·Ukwamukela noma okwamanje ukuya ekolishi evunyelwe uhlelo lwe-full-graduate noma lwe-graduate e-United States.	â€¢ Currently enrolled full-time or accepted by an accredited four-year college or university in the U.S. or Canada
Okuningi nakakhulu kunjalo, uma umnikazi ngemva kokuthenga isilwane uyaqaphela ukuthi izinga ayikwazi bayamnakekela amnike imali eyanele ukunakekela.	Worse than that, once a vendor finds a supplier they're happy with, they rarely look at whether they could decrease the price they pay for the goods.
(Sung in Zulu & Tswana) (in Zulu) Siyakhothama (We bow down) Njengengelosi ezulwini (Like an angel in heaven) Siyazithoba (We humble ourselves) Phambi kwaBaba (Before our Father) Thina sithi (We say) ...	Then we will stand around the throne of God with the angels and saints, as we prostrate ourselves before the throne and worship God (Rev 7:11).
Uke wayigibela intaba?	have you ever been on a mountain?
Ukubanjana okwabiwe kuqala ku-$ 2.95 / mo.	Plan starts from $2.95/mo.
Haze amaze maze released: 1991	When it started: 1991
Futhi izingane eziningi zokudala kukhona unodoli ukucula Elsa!	Miles is a boy Lalaloopsy doll that can sing!
Ngoba amadolobha akuyona into oyisebenzisayo.	Because people aren't machines.
"Nansi umbhalo ofushane wenkambinkimbi: ""Kumelwe sibe qotho futhi siqaphele ukuthi imali eningi ebhange lethu ifika ngokuqondile ekusetshenzisweni kwezwekazi lase-Afrika."""	"He says: ""We have to be honest, and acknowledge that a big part of the money in our banks come precisely from the exploitation of the African continent."""
nenhle Njalo Viktoriya Bekhem, sekuyisikhathi eside okuyinto kube lokuma isitayela.	Victoria Beckham has always had a keen eye for fashion.
Leli gama lihlanganisa inkulumo futhi Anglicism.	The word is therefore an anglicism.
Ngakho ibhukhimakhi isinqumo esihle kuwe?	Is Prepaid A Good Choice For You?
Ukucaciswa ukwakhiwa lesikhashana uthango elinye ithuba sabafowabo unomphela uma kocingo liyadingeka nsuku yesikhathi esifushane ezifana isitoreji, ukuphepha komphakathi, ukulawula izixuku, noma ukweba ekulondolozeni.	Specification Temporary construction fencing is an alternative to its permanent counterpart when a fence is required on a short-term basis such as for storage, public safety, crowd control, or theft deterrence.
ulaba to nani-khakhar	See also Bochner's
Amandla aphezulu, isisindo esikhanyayo	Ultra-thin, light weight
Yini leyo yokuba yisisebenzi sikahulumeni?	What is a Civil Servant?
Wakwazi unqobe ngokwayo phakathi uthando lwakhe.	It was predictable in its love of getting its own way.
Kwezinye izimo, le isibotjhwa umelana.	In some respects, refugees face a different situation.
Konke enginako isipho nje!	Everything I have is a gift.
Iphuzu olandelayo - ukukhulelwa uqobo.	First of all, there is the process of pregnancy itself.
Izinketho zebhange kanye neqiniso elihlala likhona lokuthi ukukhethwa kwezikhala zeselula neminye imidlalo yasekhasino bekungaba kukhudlwana yizo kuphela izici zekhasino ephathwayo esingathanda ukuyibona ithuthukiswa..	The slightly fewer banking options, and also the selection of mobile slots and other casino games could have been bigger, are the only issues we'd want to see improved.
Funda ukusisebenzisa ezitshalweni zakho.	Learn how to use these in your farm business.
Bazoba senkingeni othisha abafika esikoleni bedakiwe	Teachers who are struggling with alcohol
Kuyini ukususwa kwezinwele ze-enzyme?	What is the debranching enzyme?
Qiniseka ukuvakashela le ndawo, uzothola eziningi imizwelo eyakhayo.	- Be certain to have plenty of positive emotions.
Labo abathanda lo mdlalo, Ziyazi ukuthi kukhona ezimbili izinhlangothi Tranformers.	At this, the beginning trader should know that there are two kinds of the process.
Ikamelo e-ifulethi ibungazwe ngu-Yalila	The electric chair by needle.
U- Disemba no- Janwari yizinyanga zokuphumula eziqondana namaholide esikole okuphela	The months of December and January cover our summer school holidays.
Nakani ngokwakho, uthole esebenzayo!	You find the opportunity to work for yourself!
Kakade kusukela onyakeni wesithathu ukukhula Sebeyeza ziyahlukahluka. amaduna asekhulile ngokuvamile ezincane kuno nezintombi zabo at 4-5 cm.	In most other cultures to date, men are, on average, three to four years older than their mates.
HomeSofa Minimalis ModwaySofa Minimalis Modway	Antonym of path of least resistance
Isilinganiso sobude bokuphila zohlobo okuyisilinganiso seminyaka engu 12-15.	average life of 12-15 years.
Kungcono kakhulu ukukhonza izipelepele ezigxotshiwe?	Wouldn't it be better to use coloured dots?
Labo 8 Louiza	The Louisiana Opt...
Iningi lontanga yami nalo lalenza okufanayo.	Several of my work colleagues did the same.
Indlela yenza ekhaya, ngaphandle kokusebenzisa imvubelo?	Or wondering how to work out at home with no equipment?
"Qaphela ukuthi idivayisi ibonisa umphumela kuphela, njengoba ukuze uthole isisindo ngqo odinga ukukwazi ukubaluleka ""g"" lesifunda."	Remember, the sensor only knows that the film needs 'x' amount of light to be properly exposed.
Futhi abazali ayisadingeki.	Both parents are not needed.
Le ndawo elisondelene ukuhlala manje ukwakha ngokunethezeka.	This part of town is firmly urbanized now.
Kaningi - Abkhaze	In most cases, the frozen
unelungelo lokuthola amanzi, wonke	Everyone has the right to drink Water -
lihle ikakhulukazi ehlobo.	It is especially beautiful in the summer.
Bahleka ngani na? 2.	2 they're laughing.
Futhi okwekati ubona enkosini yayo?	"""Have you seen my master?"
Kubalulekile ukuthi ochwepheshe bÃ©nza konke okusemandleni abo nempahla Akawukhululi wena bekuhlupha futhi bafika singakapheli isikhathi esibalulwe isikhathi.	It is important not to wait for the customers to come to you with their problems and challenges, but to be prepared instead.
Isolezwe lithole ukuthi ukusakazwa kwezinhlelo kugcine ngoLwesine.	The Cuban government said the discussions are scheduled to end Thursday.
Futhi ngiyokwandisa impela inzalo yakho, ngiyakwenza futhi izizwe ngawe, namakhosi ayovela kuwe.	And I will increase thee very exceedingly, and I will make nations of thee, and kings shall come out of thee.
Kuleli zwe 7 billion abantu, futhi ngokuqinisekile phakathi kwabo kukhona uzobe bani esihle, futhi ubani bayokwazisa uyasazisa.	We are 7 billion on this planet and I'm pretty sure someone out there will also like them.
Kufanele uthole kwesigaba okuyiphutha noma node, ekubuyiseleni noma ngokuphelele ulibuyisele.	to try to overturn it or reverse its course, in full or in part.
Wayefuna ukushada nendodakazi kaLabani encane uRachel.	Eventually he asks to marry Laban's daughter, Rachel.
Thola le t-shirt enhle yombhoxo esitolo sethu ngokuchofoza lapha	Take a look at our amazing clothing store by clicking here.
Dvweba sitfombe engqondweni yakho ukuthi ufuna uthole umphumela.	Envision yourself having the end result.
Kulokhu, ngokuzenzakalela isiqophi imodi alukhethiwe.	This protocol has not been arbitrarily chosen.
Kodwa lokho nje lutho ngeke benze kanjalo, futhi ngeke ukuvela.	However, it simply isn't possible, and will never happen.
Ngikholwa ukuthi isikhathi sokunaka nokugxila kukhulu kunanini ngaphambili.	This is the time, more than ever, to focus.
Mookho Ramabusa	H.H. The Rulers
Sebenzisa indwangu ethambile ukukhipha noma yiluphi uthuli	Use compressed air to get rid of dust.
Kumemezeleni .	E! proclaimed.
Enkabeni ye-Texas, ihhovisi lethu lendawo e-Houston,	at the Johnson Space Center in Houston, Texas,
Uma kwenzeka unomsebenzi obala ekuphathweni okuvulekile, ungase ukhethe ukuthola tattoo ebangeni ongawafihla.	In the event that you have a vocation out in the open administration, then you may choose to get the tattoo in a range that you can conceal.
Ekhangayo, kodwa ezinikeleyo.	respectful, but engaged.
Yile leased engingayenza.	This was what I could afford.
Ngakho-ke kuvela ukuthi amadoda amthandabuzana ayidlala indima yokugqugquzela.	There is no doubt therefore, that the Testicles plays a role in Prostate development.
Izindwangu zombala zombili ze-Yarn zadaywa &	Within the Tyne & Wear area also scrap
Sibamba intambo.	We don't dock the tail.
Noma kunjalo, isilinganiso sokucindezela siyahluka kusuka ku-steroid kwesinye.	Nevertheless, the suppression rate differs from a steroid to another.
Ingcweti angenza ukususwa izitsha abathintekayo.	A bidder will be able to remove the undescended testes.
Akunandaba ukuthi uhlela ukusebenzisa siphi isikhali, njengoba ukutholwa kungasuswa kungakhathalekile usayizi noma uhlobo lwenhlamvu.	It doesn't matter what stock or configuration a rifle is in, it shouldn't be banned for appearance sake.
Izibuyekezo of the ngesikhathi owalondoloza imiphumela yenqubo kukhona ngabanye.	Reviews about the time during which the effect of the procedure remains, are individual.
Ingabe iqhawe Olympic iqhawe emhlabeni izikhathi eziyisishiyagalolunye.	the World Drivers' Championship nine times.
Sungula ezigxotsheni kwezinkuni.	Start with wood floors.
joyous celebration 18 yeki inhlanhla yokwazana	Engagement shoot - a great opportunity to get to know each other better
Kunoma yikuphi, unganqaba ukunikeza idatha yakho siqu.	In any case, you have the option to refuse to provide your personal data.
"32 Aniyikuthwala sono ngenxa yakho, lapho seniphakamisile okuhle kwakho, ningahlambalazi izinto ezingcwele zabantwana bakwa-Israyeli ukuba ningafi.' """	32 And ye shall bear no sin by reason of it, when ye have offered from it the best of it; and ye shall not pollute the holy things of the sons of Israel, and ye shall not die.
Uhlobo ngalunye lwesilwane lubhekana nemiphumela yalo ngamazinga okushisa aphezulu.	Every area is suffering in these high temperatures.
belusizi kakhulu ngezwi alishilo lokuthi abasayikubona ubuso bakhe.	They were especially grieved by his statement that they would never see his face again.
Wayeneminyaka engu-47, 37 ngawo (ngekhefu) kwaba isikhulu eMoscow.	At 39 (going by his date of birth - 1937) he became a military ruler at 39.
Ikhambi Universal ukhwehlela alikho.	There is no UNIVERSAL solution.
"IBhayibheli nalikhuluma ngoMbumbi onguJehova uZimu, lithi: ""Kuwe kunomthombo wokuphila."""	"The Bible points to our Creator, Jehovah God, and says: ""With you is the source of life."""
Le noveli ithandiwe nguDonald Trump... # Wonke amalungelo agodliwe..	dONALD tRUMP HATES this group of people.....half boiled educated.
I think Walez eat kids anyway.	I think that Wally is going to eat the Professor in the end.
"""Ukugwema ukuqamba amanga kuyinto enhle kakhulu."""	"So it's best not to lie."""
Turkey ihlukaniswe yaba izifunda 7 zokuphatha.	They are divided into seven areas of operation.
"""Kumele ngikubeke kucace ukuthi kukhona abanye ozakwethu abebekhala ngokuthi lo mgomo uzofinyeza amalungelo abantu kepha akekho onelungelo lokuthatha impilo yomunye."	"""I must admit that there were some colleagues who felt that this policy would infringe on human rights but the no one has the right take away somebody's life."
Kungokufanako nangabalandeli bakaKrestu abazesiweko, 'ikhaya labo elisezulwini.'	"The same is true of Christ's anointed followers, whose ""citizenship exists in the heavens."""
bizobike Carbon ebike 2019	Ipcc special report on renewable energy 2019
Ngokuthakazelisayo, UMthethosisekelo isimo sika 1845 kuhlulekile ukubalula isihloko imfundo ephakeme.	Interestingly, the state's Constitution of 1845 failed to mention the subject of higher education.
Kusukela Ezweni Elisha	From the new world
Lokhu kuzosiza ukuvuselela amandla akho.	This will help to re-energise you.
iszimile u mad?	You want to get crazy?
Eyona nto ingcono yokushintshana Novacoin	The most effective ways to use cocaine
Ngakho ingxube ngeke kugcine ductility futhi homogeneity.	Globalization doesn't have to mean uniformity or homogeneity.
Bona futhi ezinye ze-CV eziyisampula kwiwebhusayithi yabo.	Have a look at some of the support resources on their website.
UK benzene emissions higher than US	China's emissions standards are stronger than ours
Eyi kunzima futhi ibuhlungu lendaba kunzima ukugqunywa umsila esikoleni esisha.	It must be difficult and exciting to be in a school in a different coutnry.
Ukuze kutholakale lesi sifo ngesikhathi futhi siqale ukwelashwa kwaso, bonke abantu abaneminyaka engama-40 ubudala banconywa odokotela ukuba bahlolwe njalo ngonyaka.	Due to the importance of early detection and treatment, everyone over 40 is recommended to have an annual screening test.
Sibashiye bonke, kodwa munye.	We made it out of all of them but one.
Ezemidlalo kuyingxenye nolimi yokuphila yomfundi.	Education is a part of the life of the students.
Okuluhlaza: â‰¥ 80% amandla	Green: Less than 70%
Kodwa musa khipha amabhodwe.	Don't cut the stitches though.
Ngiyawuthanda umkhaya wami.	- I LOVE my family.
16:11 futhi ukuze lonke iqembu lakho limelane neNkosi?	Numbers 16:11 11 Therefore you and all your company are gathered together against the Lord.
Isis, we miss ya!	Jesus H. Christ, I missed it!
UJowashi waselala laboyise, uJerobhowamu wasehlala esihlalweni sakhe sobukhosi.	13 Jehoash rested with his fathers, and Jeroboam sat on his throne.
Okuwukuphela okushiwo azithathe yakhe - ngaphansi yokubuyisela njengoba ngalendoda.	It's something he can only guarantee by sending her back - so he had.
Inyathelo 3 Ukubetha ngesivinini esiphezulu.	Step 3 is the quick getaway.
Ngithi ngithi I'm sorry if ngakwenza kabi (you know I'm sorry)	And I am sorry if I did (which I know I did)
Ukwakhiwa Kwenkontileka YeMeter 4 izigidi ezingu-960 eziyi-TL	4.6 million cubic metres of .
Jenda Embangweni Edingeni (underway)	let's ride on the subway
Ngaphezu kwalokho, abantu bayoba isifiso nakakhulu ukucela izinsiza zakho uma umnotho iqala ukuya ekwehleni.	More people are willing to make the switch when the economy is booming.
Sesizohlala phansi sibone ukuthi esingakwenza ukwenqabela imikhuhlane ebantwaneni yikuyini.	We learned what we can do ourselves to prevent disease outbreak.
"Ngaleso sikhathi, Leon Livermore, esiphezulu Chartered Trading Standards Institute, wathi: ""Izigebengu abakhiqizi kokunganaki ngokuvamile ukuxhaphaza baningi futhi azame ukunqwabelana emakethe nemikhiqizo ezishibhile futhi iyingozi."	"At the time, Leon Livermore, chief executive of the Chartered Trading Standards Institute, wi: ""Criminals and irresponsible manufacturers will often exploit high demand and attempt to flood the market with cheap and dangerous products."
Njengebhonasi, ngokugcina ugaxekile ngaphandle, lezi zihlungi zogaxekile zikusiza ukuthi ulondoloze isikhala emafolda akho eposi.	As an added bonus, these wallpapers help in keeping your home fire-resistant.
Yomuntu kanye neyeqoqo kuwo wonke amabhizinisi ethu emhlabeni.	personal and corporate people all over the world.
Ezinye izindawo zokuhlala e- Ormond Beach:	List of Companies in Ormond Beach:
Kungase kube ngisho nezikhathi ebusuku.	It may happen even at night.
6 Ngencike kuwe kwasesiswini; nguwe owangikhipha ezibilinini zikamame; ukudumisa kwami kuyakuba ngawe njalo.	6 From the womb of my mother I rely on you; You brought me out of the mother's womb; You are always the object of my praises.
Kuyini for osomabhizinisi zasekhaya?	What's In It For Homeowners?
Kuwo wonke emakethe ihlukene, simelela izinga phezulu.	In a global marketplace, it is highly competitive.
Canon EOS 1D Mark II - enhle kakhulu professional ikhamera yedijithali, ukukhululwa esasimenyezelwe February 2004.	The Canon EOS-1D is a professional digital single-lens reflex camera launched in November.
Gouache futhi emifanekiso.	The Gowans are also pictured.
Angisho ukuthi yisixazululo esifanelekile kepha okungenani yiso engisisebenzisa ngempumelelo ethile.	It is not the best solution but I can at least get some work done.
"""Angazi nokuthi ngizoyikhokha ngani le mali engayiboleka ebhange ukuze kuqalwe leli bhizinisi."	?And I am not sure that the bank would lend me the money to start up the business at the level I would want to.
Kuphela manje Ngiyaqonda ukuthi kungani.	Only now do I understand why.
(ii) uma kuba nesidingo ngenxa yomthethosisekelo noma ngenxa kahulumeni omuhle; noma	ii . if it becomes necessary for the purposes of the Constitution or in the interest of good government; or
Eminyakeni edlule, i-AVBOB yabelene ngezigidi zamarandi kumalungu ayo ngamabhonasi akhethekile nezinzuzo zokungcwaba zamahhala.	Over the years, Cellcom has given away millions of dollars in prizes and giveaways to its subscribers.
Umndeni kaselby uthi usufisa ukubona kwenzeka ubulungiswa ngecala lokufa kwelungu lawo.	Sushant's family has been actively seeking justice for the actor's death on social media.
Kungcono ukukhetha okukhethwa umbala, okuyinto ungavumeli imisebe yelanga.	It is better to choose color options that do not pass the sun's rays.
Ukwelashwa kwe-asthma ezibhedlela kuklanyelwe ukuhlangabezana nezidingo nezidingo zakho ngazinye.	Each acupuncture treatment is specifically tailored to your needs and complaints.
Yena lolokuyengako namuhla,	That's what he is today.
Ukwakheka Kwebhizinisi (Okwenziwayo Nenzuzo)	Entrepreneurship (in the form of profit)
Futhi ivesi elilandelayo liyesabisa nakakhulu.	The very next verse is even clearer.
Ngangazi ukuthi akenzanga noma yikuphi kwalokhu.	We know that he didn't do this.
Yiziphi izici of amajaji eNkantolo yoMthethosisekelo Russian?	What are the fundamental laws established judicial system of the Russian Federation?
Hlanganisa nama-hazelnuts aqoshiwe.	Includes roasted hazelnuts.
Phakathi kumiswa isimo labetibambile ekunqotshweni indawo enkulu Russia amaMongol-AmaTatar.	Near the border with Mongolia is a large Russian settlement - Irkutsk.
2 0 no. no. yes.	second half.No.
"Awunayo ukuxazulula izinkinga ""usohambeni."""	"These workouts cannot be changed ""on the fly."""
Ukunquma okuyinto treadmill kuhamba phambili ekhaya, abasebenzisi belulekwa ukuba sinake ukujiya lendwangu.	Trinity Street in the town has been closed and motorists are advised to drive with care.
Kufanele ubike ukuzalwa kumasipala lapho ingane yazalelwa khona.	A birth must be registered in the district where the baby was born.
Bukhona ubuwula ekushayweni yinduku eyodwa kuphindelela	It's a bit of an odd feeling contemplating dual booting again.
Ã¢ â‚¬ Â¢ Ingabe ziyoshukumiseleka nakanikelwe imiphumela yabo?	â€¢ Are the conclusions justified by the facts presented?
Yebo, ngisho nangaphezulu kokujwayelekile kunalokho abavame ukwenza.	Even More Than I Usually Do.
Ngiyethemba ukuthi iyakusiza impela ...	I hope it truly helps...
who fucks sinazo yolwa	where we don't have to fight
"""Ngibatshele ukuthi badukile, akekho umuntu wesifazane lapho ngiphuma khona."	She says I'm good, but nothing beats a woman.
Wadluliselwa kulesi sibhedlela wahlala isonto.	She was ordered to stay in hospital for a week.
Benginamaphupho njengowo wonke umuntu	I had a dream of all the
Sikhuluma nge nitrogen.	Pertaining to nitrogen.
Uma kukhona okungahambi osobala incazelo - akukuhle ukufaka.	If an explanation is not logical, it is not an explanation.
Kungaba pretty ezidumazayo.	It may be very disappointing.
Anna Sisani	D'Anna, now
Asikhumbule ifa segolide wezwe lakithi futhi siziqhenye ngokuba yingxenye Australia	"""Let us remember the golden heritage of our country and feel proud to be a part of India."
3 Ngibhekise Kuwe Rethabile Khumalo 5:00	Hopelessly Devoted To You 03:00
Inqola Yokuthenga Enamasondo Amabili	The two-car garage
I do not Age I Level Up	I Don't Get Older I Level up
Ngokubuka kwabo, ufana nogesi osinikeza amandla hhayi Umuntu. ...	Light comes to us as energy, as n...
"""Ngicela wenzenjalo, Sisi,"" kusho uMaVilakazi ngezwi eliphansi."	"""Shut the door, please,"" said Ida, in a low tone."
Futhi, bazi nokuthi ukufa kusemnyangweni wabo	She, too, realizes that death is in their midst.
Ibingekho efuna ukugoba uphondo ePeter Mokaba izolo	No one had to give Ro Parra directions to Pimlico Race Course yesterday.
Uzama ukuthola indlu kagogo?	Are You Looking For A Home Like Your Grandmother?
Angiqiniseki ukuthi ngiyavumelana naleli gama Abathonya beMega ngaphakathi kwe-infographic, noma kunjalo.	I'm not sure what caused the plaintext to be placed in my files on the original SD card.
Le yimfihlakalo yabo eyimfihlo.	That will be their secret.
Indlela machining phezu komhlaba th ...	Walk through the kitchen t...
>> Ngomusa uhlanza ngenkathi kufakwa umswakama omkhulu	***Only Happy When It Rains is available in five sizes.
"Lawa ochungechungeni TV ""South Park"" izinhlamvu."	"the animated television series ""South Park."""
Hhayi kwaze kwanzima ukusonta kulezi zinsuku zokugcina.	It will be no different with the church in these last days.
Isikhathi eside amahhashi ayizinhlobo eziyinkimbinkimbi emphakathini, Kepha kungokokuqala ukuthi kube khona ukukhombisa ikhono lalo lokweqa umgoqo ophakathi kwezinhlobo uze ukwazi ukufunda imizwa.	People have known for a long time that horses are a socially sophisticated species, but this is the first time they have seen that they can distinguish between positive and negative human facial expressions.
Ngalesi sikhathi, singasho kalula ukuthi isiNgisi yilona limi olugqamile emhlabeni.	One might think that English is the most spoken language in the world.
Ungasebenzisi itjhila elisetjenziswa nguwe woke umuntu ukuhlwengisa amabele amanengi.	Don't use package to produce gross revenue.
Roulette Isu Win omningi Cash!	Gree won a lot of money.
Noma kunjalo, labo abasele ekhaya bangasiza izikhonzi ezisenkonzweni yesikhathi esigcwele ngokulungela ukunakekela abazali bazo asebekhulile uma kudingeka.	However we are also able to offer Companions who are willing to assist in the home on a full-time basis with care of the independent elderly (non-medical).
"""Umngane wami ungithumela manje umlayezo othi abantu bayasuswa ePower."""	"""Now my friend is trying to make a sign to piss people off."""
5:15 Bheka, O ndlu ka-Israyeli, Ngizohola phezu kwakho isizwe esikude, isho iNkosi, isizwe esinamandla, isizwe sasendulo, isizwe ongeke usazi ulimi lwaso, futhi ngeke ukuqonde abakushoyo.	Jeremiah 5:15 Lo, I will bring a nation upon you from far, O house of Israel, saith the Lord: it is a mighty nation, it is an ancient nation, a nation whose language thou knowest not, neither understandest what they say.
Ngiyabe ngizafunda kuze kube nini?	How long will you make me wait to read that?
Babengawanaki wonke amanye ama-imeyili, imibhalo nezingcingo.	They would ignore all further e-mails, texts, and phone calls.
Manje yebo, uma sebekhona, bangahlala isikhathi eside.	After all, if they did, they might live longer.
Eyakho ipikitsha ikhona na?	Do you have the Piston?
Unkosikazi kaMengameli waseZimbabwe uGrace Mugabe uthi uzosiza uMengameli Robert Mugabe abuyisele izwe esimeni somnotho esifanele, ngokusho kwemibiko.	Zimbabwean First Lady Grace Mugabe says that she will assist President Robert Mugabe in steering the country into economic recovery, according to a report.
Ukunakekela ukunakekelwa kwezilwane nokusebenza kwezilwane.	Protection and Care of Animals.
Abangenamakhaya futhi bafuna ikusasa elihle	Help for the Homeless and Hope for the Future
Lo mkhiqizo futhi manje iyithuluzi omkhulu, kubalulekile ukuze izinwele enempilo.	Water is also a very crucial tool for healthy hair growth.
Bonke babejabula ngokuthi base, ngaphandle onqobile.	And everyone rejoiced when they were defeated.
Mina yayiphumula futhi Endi Hug.	I was lying down and taking a rest.
Iziphi Izizathu Ezimbili Ezenza UNkulunkulu Angayiphenduli Eminye Imithandazo?	There are reasons why God doesn't answer some prayers.
Ngemininingwane engaphezulu, zizwe ukhululekile ukubuka ividiyo ephelele ye- isethulo sokumaketha esingena ngaphakathi.	First of all please try to find the full context of the Video.
"Ukuze uzwisise ngokuphelele ukuthi igama elithi ""zemikhosi"" awabona ngempela ukuya eSpain noma Latin America ngemikhosi kazwelonke."	"Interestingly, the term ""political party"" does not find mention in either the American or Indian constitutions."
Ngiyabonga nangezipho uTshatha angiphe zona.	Also thank you for the gift's.
"Mina loyihlo sesibhudule sabhudula sikudinga.""  - ULukha 2:48."	"""Your father and I have sought you sorrowing."" ---Luke 2:48"
sawubona, hey kwesinye isikhathi ayisebenzi, kungani lokho kwenzeka?	sometimes it doesn't work though. why not?
Akugcinanga lapho njengoba kungakapheli sikhathi esingakanani nomengameli we-EFA naye ememezele ukuthi uyasula esikhundleni sakhe.	It wasn't long afterward that the President of OWU resigned.
uyodinga oyodinga eyodinga akayudinga ongeyudinga engeyudinga	What you need is someone who does not have a need to
"""Ungangitshela igama lakhe?"""	"""Can you tell me your name? """
c. ukusiza isikhungo sezezimali ngokuhambisana nokwenza imisebenzi enjalo.	c. assisting the financial institution in complying with performing such activities.
Uyothi Wabonani Mfazi Ongazalang	Seeing a pregnant woman
Ngebanga lokuthi baba zizoni, bahlongakala.	mortify their sins, they are lost.
Njalo ehlakaniphile.	He's always been wise.
Amafulethi wonke ibungazwe ngu-Rafaela	The interviews were all given by Bob Rafelson
Futhi ngikholwa kakhulu kunani lezokwelapha manje lama-amakhowe e-psilocybin ukwedlula engikwenzayo nge-cannabis.	I would describe the cannabis that I'm using now more as a hallucinogen.
Kodwa ubuhle bayo abugcini kulokhu kuphela.	But the awesomeness is not only that.
Watch Cewe ngisep enak banget porn tube video	Trapped by the succubus online porn video
Lashukumisa akuyona insimbi noma ingxubevange; kuyinqubo lapho kusetshenziswa khona i-zinc enamathela evikela insimbi ukuvimbela ukugqwala.	Galvanized is not a metal or alloy; it is a process in which a protective zinc coating is applied to HDPE to prevent rusting.
Ngaphambi kokuqala kwamakilasi, khetha inkambo efanele evela kumqeqeshi owaziwayo futhi ulandele imithetho yayo.	Before the beginning of classes, choose the appropriate course from a well-known coach and follow its rules.
Pawn a Alfa Romeo Kwenzekile	The story of Alfa Romeo
Awesome icons nonetheless!	That's a beautiful icon!
Sisesikhathini sesizini lapho ubadinga khona bonke abadlali bakho ikakhulukazi laba abamqoka.	This is a big culture change, so you need support from all parties, especially those at the top.
nenzeni nje olwandle?	what do you do at sea?
Ezinye, kodwa hhayi zonke, zalezi zimo zihileleka ukusetshenziswa okungeyona okungalindelekile.	Some, but not all, of these include exemptions.
Cover lungasetshenziswa njengoba isikhwama.	Cover can be used as a purse.
Kungani amacembe awohloka kusukela rose, futhi ungabasiza kanjani ubuhle ezingezwakali?	Why creativity isn't limited to the arts - and how you can blow the lid off your creativity.
"""Lukulu lwa wantu ayingi"""	"""A large number of persons"""
Inombolo yabo ikhamuluke eside kudlulwe eziyikhulu.	Their numbers have swelled to over 100.
Igama lomkhiqizo oqediwe Inani lomkhiqizo ku-1XE, g	Official Full Name platelet derived growth factor C
Ngokushesha, uma uthenga PC entsha, ngeke ukusekela Windows 7 noma 8.	Soon, when you buy a new PC, it won't support Windows 7 or 8.
^ Mhlawumbe zokuhlasela.	Perhaps to launch an assault.
Siza ingane ukucabanga ukuthi eyokwenzeka iplanethi uma Leso naleso sakhamuzi iphula umuthi owodwa?	Ask her what the world would look like if every single child were born to a single parent.
Futhi has nobudlelwano obuthile sleepwalking.	There's also a connection with sleep.
Le ncwadi ikakhulu siqukethe yakhe	This book is primarily comprised of.
kukhona, kodwa lokhu ngokwayo.	itself, but it is.
Sikhombise ubuso bakho mntanami!	Show me your tongue, son.
Kodwa iqhaza amadoda kuphela ababemelene zokulinganiswa kwamalungelo abesifazane.	Was it only men that fought for women's rights?
Sikhothama kuwe	We are Moving Towards You
I-ikhaya eliyindawo yokuhlala ephelele ibungazwe ngu-Yvette	What's left of Yvette Lation's house.
Ucwaningo lwenziwe ezikoleni ezimbili ezisesiyingini saseMhlathuzana.	The study was conducted in two special education schools in Hong Kong.
Longdress Lowo Kencana Ungu Mandala Ungu	The Comptroller of the Currency is the oldest bank regu
"Ubungavaliwe ngani?"" kubuza uMnuz Ramatlateng."	"Why did he sign it?"" said Mr Charalambos."
Best kanambambili ongakhetha izinkampani abadayisi canada	Winner of Best Managed Companies in Canada
â€¢ Ukubhedlela	â€¢ Hospitals.
25:24 Niyakulazi ulinameke ngegolide elicwengekileyo.	17:02 Oh, you know the story of the golden calf.
I remember nani	I remember better.
4 amalitha amanzi.	four of water.
futhi usisindise kulo lonke usizi	Save us from all misdeeds
"""Okungaphezulu kunjengaleyo ephansi; kuyini ku-Basis kufana nalokho okuphezulu. """	"It is so much more than the superficial; it is so much deeper, its about sacrifice."""
Baze bagibela phezu kwendlu bamehlisa ophahleni kanye nohlaka ukuze bakwazi ukumngenisa ngaphakathi phambi kukaJesu.	Someone had to haul him to the top of the roof, and lower him straight down through so that he could get to Jesus.
Ngaphezu kwalokho, akukakaqali, ngaphandle kwalokho, sonke besizokwazi ngakho.	In other words, everyone would know of it.
Ake sibone ukuthi singabuyekeza kanjani i-Explorer.	Let's see how we might use the Explorer.
ngokuhlanganisa amasu amaningana kanyekanye.	Combining several concepts.
Ngohlelo lokusebenza lwe-Mac OS X Mavericks noma ngaphezulu	Operating system - Mac OS X Mavericks or later
Ngelakhe yedwa.	for Him alone.
Uma bengakwenzi, kahle, okungenani ubungazama ukusiza.	If they don't, well then at least you tried.
Esegunjini, iqhwa zinhlayiya etshalwa okwenziwe ngayo ngisho kungenzeka ukunikeza ijamo design.	The steam vents are zig-zag in design allowing even distribution.
Ngiyayibheja inambitheka kahle njengoba ibukeka.	I'm sure it tastes as pleasing as it looks.
Vula ngomshini Molding Line	Open a command-line tool
Uma abaphukile, umzimba ogulayo.	If it is disturbed, the body becomes ill.
Kukhona izihlalo zotshani ongazithatha uhambe nazo ukuya olwandle kanye namathoyizi olwandle wezingane.	There are chairs and an umbrella to take to the beach as well as some beach toys for the kids.
Ngikhipha kanjani ohlwini lwababhalisile ku-Facebook wami?	How can i remove ads from my facebook page.
Noma mhlawumbe ugqoke uhlelo lwe-bracket?	Or wear a neck brace.
Yini ubuncane be-oda lakho?	Finally, what's your niche?
Iphrojekthi engavamile yalesi sakhiwo ibangela imizwa exubile phakathi kwabantu abahlala edolobheni.	The new signs have sparked mixed feelings amongst the townsfolk.
Yini iso elihle elishayolayo?	So, what's Dry Eye?
Linha: Yu Yu Hakusho	Country of origin: VN
"""Sifike lo Mkhandlu ungenayo imali ngendlela yokuthi kuye kwaphoqeleka ukuba sithathe isinqumo sokuba kubuyekezwe amanye amathenda ebesinawo."	"""The current summary judgement provides us with several options to recover the debt owed to us."
Ingabe bathatha isikhathi eside ukubuyisela lokho kulungiswa kuye?	Will it take a long time to get them back off?
Simangele Manzini	Fascinated by the water
Sithemba ukuthi ngokusebenzisa izindlela zethu ongayenza ngokwakho isisindo sakho ezinjalo.	We hope we can count on your support in this way.
Futhi igama laleyo ndawo labizwa, 'I-Oak Yokukhala.'	And the name of it was called Oak of Weeping.
Kodwa isimiso somzimba sokuzivikela akusho ukulala.	But the immune system does not sleep.
Lolu lwazi kufanele lufakwe esigabeni samazwibela noma sokuphawula seposi.	This evidence must be in the form of a letter, notice, or other official document.
Bhekisisa ukuthi ubude besikhathi sokwenza umsebenzi othile buholela kusiphi isimo... [some part of sentence missing]**	Determine if the relation is a function. { (0, 1)... - OpenStudy
Ngaphezu kwalokho, kukhona nobunzima lapho ukhetha usayizi.	There is also the difficulty of judging wins.
Ningalaleli abanye oNkulunkulu ngaphandle kwami ningabakhonzi.	"""You shall have no other gods beside me."
Insikazi kungaba amabhu amaqanda esiswini.	Female can lay eggs in its lifetime.
Amafasitela kufanele kube mhlophe.	The windows were blank.
Lapho kukhulunywa ngaye okokuqala ke ezitholakala catacombs waseRoma ekuqaleni kwekhulu lesithathu.	Its earliest appearance is in the catacombs of Rome in the third century.
Ubufakazi bukaJobe buyisixwayiso ezizukulwaneni ezilandelayo, futhi lesi sixwayiso sizitshela ukuthi uma zingamnqobi, uSathane uyohlale ezimangalela njalo futhi ezinakile, azisobe zaphunyuka ekuhlukunyezweni nasekuhlaselweni uSathane.	Some may argue that when we are spirit beings we will no longer have Satan and his demons to temp us to do evil, and yet, we can see that Satan did not have any outside force tempting him when he became lifted up in pride and made the decision to rebel against God.
Lokhu kwalandelwa ukuvakashelwa kabili okufushane ngo-2016.	that consisted only of two brief sessions in 2015.
Ideal Alfred the Great Images	king alfred the great novels
Njengoba inketho - nje ubheke abanye ukuba umngane wakhe isicelo efanayo.	Instead of making the reservation alone, ask your friends to do the same way.
Ngemva kokubeka imigomo badinga ukuthi lilinganise, hlunga uqale ngokubaluleke kakhulu.	Set objectives Before creating, the most important thing should set goals.
Kufanele futhi ususe ifolda .kde4.	Also fits the Nikon D4.
12:3) Esihlokweni lesi sizaxoxa ngokuthi uJehova usincedisa njani nxa sigula, silohlupho lwemali lalapho sizizwa singaselancedo enkonzweni yakhe ngenxa yokuguga.	12:3) This article will discuss how Jehovah helps us in the following situations: (1) When we suffer illness, (2) when we experience economic hardship, and (3) when old age makes us feel as though we had nothing useful to offer in Jehovah's service.
Ushakov ayikwazanga ukwenza okuhlukile.	Keshav could not do so.
Imiphi imikhiqizo emisha emakethe?	What are the other products on the market?
Ngokomthetho isiRashiya, bonke abasebenzi banelungelo ukuphumula.	In Germany, all employees are legally entitled to paid vacation.
Camptothecins ngokuyinhloko asetshenziswa ephashini, isifuba, umdlavuza ubuchopho.	Camptothecins are mainly used in lung, breast, and brain cancer.
Ukuvula zokubhala ibhizinisi, ungakwazi ukunikeza inkonzo umbhalo ukunyathelisa futhi ukukopisha izithombe kanye imibhalo.	an on-screen comparison, you can select to print a report detailing the changes as well.
Erina lya Nyamuhanga yandi, kandi thukaminya thuthi ngoku thutholere ithwalikolesya?	What's with the use of apps and Chucky is now linked to all technology?
Kubanjwa imihlangano ukuze kuhlelelwe ukusabalaliswa kwephrojekthi.	Discussions are underway for the kickoff meeting.
Lokho kuyoba lula ngathi ukuwabeka.	That'll make it easier for us to rule them.
Baphatheka kabi abazali bakhe ngoba uSipho elimoshile ikusasa lakhe emuva kokuba bemyalile ngokukhetha phakathi kwabangani ababi nabahle.	And his parents were also proud of him - after they got through being angry and concerned for his safety.
Into eyodwa ongaqiniseka ngayo ukuthi nobabili nizokujabulela lokhu.	Be sure it is something you will both be happy with.
"""Sithi ukubotshwa kwenduna akuqondanga."	Our position is that the intention of the judge was not clear.
Abaningi babo bafunana okwakuthandelene futhi wadala lo okuthiwa kwenethiwekhi.	With sheer will and determination, he created what is known as The Black Sphere.
ngani mapriso.	because the priests.
10:6 INkosi ibuza amalungisa nabangendawo.	Psalm 11:5 The Lord examines both the righteous and the wicked.
Kwezinye izimo, impumuzo lasetshenziswa.	In this case, relief was granted.
ukwahlulela kusho	What the Court's Decision Means
Indawo yakhe yathathwa ngabanye abadlali.	Other players have  replaced them.
Isikimu sinophahla lokutshalwa kwemali lwaminyaka yonke lwama-Rs 1.5 lakh.	This year's Budget has raised the annual investment limit in the PPF to Rs 1.5 lakh.
Okokuqala, ukusebenza eGoli.	first in Haiti.
Bambalwa abantu ababanikeze ithuba.	Very few people get this opportunity.
32563 Awukwazi ukusebenzisa ifayela lesifanekiso ukudala i-database ngqo kusayithi le-SharePoint.	In SharePoint 365 it is no longer possible to open web pages directly in SharePoint 365.
Nazi Izizwe Ezihlukahlukene ZaseThailand.	There are a variety of Thai girls.
Isibonelo saka-Abrahamu singakusiza njani?	How do you feel about the Book of Abraham?
Suka ngakwesokudla.	Off the straight.
Inhlangano, evikela lonke ulwazi olwabiwe ngaphakathi kwezilungiselelo zemihlangano eziyimfihlo, isebenza ukuletha abagembuli abasanda kuvunywa endaweni lapho bangaqhubeka khona nezimpilo zabo, babuyisele noma ngubani olinyazwe ukugembula kwakhe futhi kamuva asebenze njengomeluleki kwabanye abasendleleni efanayo.	The organization, which protects all information shared within confidential meeting settings, works to bring newly admitted gamblers to a place where they can carry on with their lives, make restitution to anyone who has been harmed sustainable their gambling and later serve as a mentor to others who are on the same path.
Kumele ngenzeni uma ngiyisisulu sodlame olwenzeka ekhaya?	What Should I Do If I am a Victim of Domestic Violence?
'Ingalo eqinile'.	"A strong arm man."""
Ubunzima nezingozi eziningi ngeke kusidangalise, nesibhakabhaka esiwayo ngeke sisiqede amandla.	Difficulties and challenges should not discourage us.
"Sinamathisele izithombe ezisuka kwi ncwadi yakwa BookDash ethi ""I can get dress myself"" (Ngingazi gqokisa mina)."	"Playlists containing ""I Got Habits"" (feat."
Qaphela ukuthi ayivumelani nezimpawu eziyinhloko!	Note that it does not agree with the cardinal signs!
Eenkhathini zekadeni, ikosi beyingekhe ikhulume nesisebenzi sayo ngalokho ekucabangako nendlela ezizwa ngayo.	A slave could not speak his mind to his master.
Kungani izinwele zami ziwa	Why I don't make my hair
Akwaziwa ukuthi kuzaphetha ngani ukutshengisela lokhu endaweni ezinengi kweleMelika lapho inengi labantu akade likhangelele ukuthi uClinton uzanqoba kukhetho lolu.	It doesn't change the story from the earlier debates in which most people seemed to see Kerry as the winner.
