Hivi karibuni nimehama kutoka mji mmoja kwenda mwingine na mara nyingi nimekuwa sipati huduma ya Intaneti kwa miezi 3 iliyopita, na vilevile kutengana na mwenzi wangu wa kimaisha kwa zaidi ya mwaka.	I recently moved cities and have been largely without the internet for the past 3 months as well as splitting up with my partner of over a year.
Hatua nyingi zaidi hufanyika juu ya kichwa.	More progress has been made on the heads.
& # 8211; Mahusiano kwa vijana waliookoka.	It#8217;s about a mutually-beneficial relationship.
Tutakuhakikishia ulinzi milele.	We'll always protect you.
Serikali imelenga kukifufua kiwanda hicho ambapo imefanya utafiti ili kubaini namna bora ya kukifufua.	A Steering Group was set up to oversee the project, which has explored ways in which selection methods can be enhanced.
"""Kwa pamoja tunaiomba sana serikali"	"""Instead, we are calling on the government"
Wakati huo ilikuwa iko katika Huis kumi Bosch huko La Haye.	At the time, it was housed in Huis ten Bosch in The Hague.
36Akapatana naye kujenga meli za kwenda Tarshishi; Wakazijenga meli hizo huko Esion-geberi.	36 He joined him in building ships to go to Tarshish, and they built the ships in E'zion-ge'ber.
"Ndundame; ""Mmmh, Jamani Mimi naona niishie hapa, nimewasindikiza vyakutosha"""	"relation to Africa: ""I have been there, I have lived there and seen"
"a pop quiz question iliongezwa: What song lyric, ""for all those times wewe stood kwa me,"" come from zaidi ya mwaka mmoja uliopita by cherl12345"	"a pop quiz question যুক্ত হয়ে ছিল: What song lyric, ""if I could reach the stars, I'd give them all to you,"" come from বছরখানেক আগে by cherl12345"
Washukiwa ni;	they are stationed;
Je umeridhika na hali iliyopo?	Are you pleased with what happened?
"Alisema, "" Msimamo wetu ni rahisi, hakuna cha kuzungumza."	"She said: "" My position is very simple and it hasn't changed."
"Wakajibu wakasema,"""	"""But,"" they replied,"
MUcholl Wagon.	In Vaughn.
Kujifanya tunajua kila kitu	We get to know everything
Angali bado kijana na mchango wake kwa jamii yetu bado ni mkubwa.	He is still a miner and their family has grown to considerably.
Ninadhani kuna makubaliano ya chini kwa chini ambayo watu wengi hatuyajui.	I agree there are numerous laws that many of us are unaware of.
Miye nilichukua picha hizo saa 11.30 jioni.	I took this picture at 11:30pm.
Maeneo ya vijijini, ni 2% tu.	In rural locations, the figure stands at just 22%.
Watakuwa na mfano ya kitu!	They'll have a sample.
Je hii tume itakuwa ni ya Haki kweli?	Is this one going to be true?
Sara akipayuka shauri yake.	Sarah intended to follow her advice.
* Pulizia pareti: Si.	The Pitch: No.
Alikuwa ni mtu pekee aliyeruhusiwa kuingia mahali patakatifu sana katika hekalu ili kutoa sadaka maalumu mara moja kwa mwaka.	The physical high priest was only allowed to enter the Most Holy Place in the temple once a year, on the Day of Atonement.
"""Do ya want a nice lil' pony hug, ma'am?"""	"""Try to think him a good man, won't you, dear Liddy?"""
ila hao wote ni washamba na hawajui wananataka nini kwako	They simply don't know everything you are doing, and they don't know what you want them to do to help you.
Karibu sana mkuu,tena kwa mikono miwili.	near the shoulder with both hands.
Unaogopa au una wasiwasi wa kwenda kuona daktari wako wa meno?	DO you have a fear or phobia of coming to the dentist?
Wanapenda ngono angeweza kululipa wewe!	They live by the fact that they're able to outlast you!
US hapa unamkiss mke wapo popote.	Everywhere we see pictures of naked women.
Navyofahamu mimi kauli ya Waziri mkuu ni kauli ya serikali, kama aliahidi ni jukumu la serikali kutimiza.	I am trying to flush out from the Government the truth of the position, namely, that it is a scheme of nationalisation as the Prime Minister says.
na mambo yake ya ki-ilimu ambayo yalikuwa hayakuwa yakijuulikana ila katika	But besides that they were written in languages, known only to
Matokeo Darasa La Saba 1996	school division of the 1996
"aka ""Chicago Story"""	"The story of ""Chicago"""
Ni vizuri kuwa na kitu tofauti na fresh katika kabati lako.	It's good to have something different in your assortment.
dunia na wote waishio ndani yake.	Listen, O earth and all who are in it.
Katika Mafunzo Mafupi ya Kiinjili ya Westminster, swali la kwanza ni: Je, ni nini mwisho mkuu wa Binadamu?, yaani ni, ni nini lengo kuu la Binadamu?.	From the Westminster Catechism, the first question: What is the chief end of man?
Charama dhatu: - last dhatu.	Giant pandas: the last refuge.
Hiyo inaitwa 'unrelated event	"it's called ""accidental"""
Angalia tafsiri za '-員' katika Kipolandi.	Check 'HSS' translations into Spanish.
Kwani marekani hawana makampuni ya kutengeneza handset??	So... the US doesn't have immigration laws?
Chanzo: Nipashe Jumapili.	A: I will be starting Sunday's Supper.
"""Hakuna njia ambayo ningepoteza pesa kwenye upasuaji."	"""I have no other way of making money to survive."
Sijakuja hapa kucheka na wewe, nimekuja kukufunza adabu.	I'm not here to punish you; I'm here to teach.
Antonio Conte hasira za faini ya FA azipeleka kwa mkewe	Katherine, filled with anger at her sister's
Makuta: Huh?	See also: Ben?
"""Wakasema: Ewe baba yetu tuombee msamaha kwa dhambi zetu, hakika sisi tulikuwa ni wenye makosa.""Yusuf: 97."	"They said, ""O our father, ask for us forgiveness for our sins, for we are truly at fault."
Tunapendekeza utumie programu ya kutafsiri mashine ambayo inaweza kutafsiri maandishi kwa urahisi, kama programu ya Vocre, inapatikana kwenye Google Play ya Android au Duka la Apple kwa iOS.	We recommend using machine translation software that has a Spanish translation tool and can easily translate text to speech, such as the Vocre app, available on Google Play for Android or the Apple Store for iOS.
Kinachoendelea ndani ya chama chetu ni mapambano ya kukuza demokrasia.	What's happening in Mexico is a struggle to establish the rule of law.
Upande wa upinzani unataka mabadiliko ya kisiasa nchini Zimbabwe.	During the rally, they demanded democratic change in Iran.
Hebu fafanua hilo ili Doctor nifanye kazi yangu ipasavyo!	Leave it to the experts to do the job right!
Amewasihi waweke vipaumbele vyao na kuendelea kufuata malengo yao ya juu ya mambo ya maendeleo endelevu, kama vile mabadiliko ya tabia nchi, kuwawezesha wanawake, kuwawezesha vijana na mambo mengi mengineyo.	He asked them to set priorities and stay focused on issues such as sustainable development, climate change, women's empowerment, youth empowerment, and many other issues.
au kale kafella kengine huwa kwa The Trend.	But one age group is bucking the trend.
Maadili ni miongoni mwa vitu muhimu sana katika ujenzi wa jamii yoyote lile, bila uwepo wa nidhamu ya kutosha jamii yoyote ile haiwezi kuendelea.	ROSP strongly believes that education is the most crucial foundation stone of any society; without which the development and progress of any nation is not achievable.
Taarifa ile ilimshtua kila mtu na hofu kuu ikatanda kijiji kizima.	This home has been all over the news and it frightened many people.
Inaelezwa kuwa alikuwa akinywa pombe sana licha ya kuwa daktari alimkataza kufanya hivyo.	He continued to drink alcohol despite the fact that he was instructed to quit it by a doctor.
"""Siwatishi, lazima niwaambie ukweli."	"""I don't care, you must tell me the truth."
Kwa hiyo kama ameshinda sisi tufanyeje,	And he has sent us, to do it.
Hatua ya 2 - Chagua aina ya wavuti unayotaka na uchague kiolezo kilichojengwa hapo awali.	Step 2 - Select the type of website you want and choose a pre-built template.
Presagen sasa amepanga kuongeza mtaji mkubwa wa kukuza ukuaji katika miaka michache ijayo.	The FortNite team is still working on supporting a wider variety of devices in the next few days.
Karibuni zaidi	In the more recent
Haleiwa Hawaii.	It was founded in Hawaii.
Nakushauri ukacheki HIV.	He conquered HIV.
"sh. milioni 1.7 kwa siku,"" alisema."	"1,500 million a year,"" he said."
Kina baba wakiendelea kupata sadaka	There's Daddy's with the sacrifice
kasema labda wataona hizo movies kabla hajawaambia..	Check out movies before you see them.
"Kila mtu anahitaji eneo kama hili nadhani, nikiwa mmoja wao."""	Everyone needs a family member like that, I think.
Rais mkongwe wa Zimbabwe Robert Mugabe, mwenye umri wa miaka tisini, sasa ameteuliwa kuwa mwenyekiti wa muungano wa Afrika-AU.	90 year old Zimbabwean President, Robert Mugabe has been announced as the new Chairman of the African Union.
""" Mshukiwa alikamatwa na anazuiliwa katika kituo cha polisi cha Kapsokwony huku mwaathiriwa ambaye sehemu zake za siri ziliharibiwa sana anapokea matibabu katika hospitali ya wilaya ya Kapsokwony,"" Ndiwah alisema."	"""As we speak the suspect is in custody at Kapsokwony police station while the victim whose private parts were badly damaged is recuperating at Kapsokwony district hospital,"" he said."
Habari zaidi kutoka eneo hilo zinasema kuwa kumekua na mapigano usiku wote wa kuamkia hii leo.	Some of the community resisted the eviction and clashes continued throughout the day.
Unaweza kuagiza ugawaji wa mwezi mmoja wa Dianabol halali mtandaoni kutoka kwa Misa ya Crazy kwa gharama ya wastani ya $ 64.99, ambayo ni akiba ya kifedha ya angalau $ 20 ukilinganisha na gharama ya bidhaa hii kama ilivyoainishwa kwenye tovuti kadhaa za mauzo.	You can purchase a one-month supply of Legal Dianabol online from Crazy Mass for the small price of $64.99, which is a cost savings of at the very least $20 when compared to costs of this product as noted on several competing sales websites.
Badala yake watekeleze agizo hilo, kwasababu walikuwa na muda wa kutosha wa kufanya maandalizi.	It would no doubt reassemble itself, but they had enough time to escape.
Katika Uingereza usajili kama mwanasaikolojia wa kimatibabu na Baraza la Taaluma za Afya (HPC) ni muhimu.	In the UK, whiteness as a original interpretation with the Health Professions Council (HPC) is human.
kiburi kwa viongozi na watumishi wa umma.	Humbly To Officials and Leaders.
Ulizo la Kuacha: Wafu wataishiki tena?	The context is clear: the dead is restored to life.
Home Entertainment Chid Benz afungukia muonekano wake wa nywele	mr blandings dream house mr blandings builds his dream house cast
whilo Hia Majesty tho King waa on	The Siths The King is Dead
COL 2:3 Ndani yake zimefichika hazina zote za hekima na elimu.	Colossians 2:3 in which are hid all the treasures of wisdom and of knowledge.
mo music akitaja kitu asichoweza kukisahau kuhusu	30. a song that reminds me of something sad
KimChi Making Workshop	Kombucha making workshop.
Make Your Night Shine.	Do your night sky.
Eti anadai tusisikilize uongo wa wale!	We need to put pressure on the liars!
Naomba suala la uhamisho kwa wafanyakazi liangaliwe.	I want to address the workforce question.
Matokeo yatakuwa kwamba utaanza tena kuvuta sigara.	In other words, it makes you not want to start smoking cigarettes again.
Wale Tuliowapa Kitabu kabla yake, wao wanaiamini (Qur-aan).	Those to whom We gave the Scripture (i.e. the Tawrah and the Injeel, etc.) before it, - they believe in it (the Qur'an).
Itakuwa wazi katika kizuizi cha siku 3 cha kukomeshwa kwa saa ..?	Isn't it said that the Three Days of Darkness will descend ...
Nimemsikiliza kwa makini sana, nilichogundua ni kuwa kwa sasa Bunge letu linafanya kazi kama idara ya serikali na si mhimili unaojitegemea.	I took their education very seriously because I see it as a parental role, not a government role.
Waajiri wengi tu bado wako hivyo.	A lot of consumers still do.
"Tunataka kumjua kila mmoja wenu!' """	"I want everyone to know!"""
• China yasukuma mbele mageuzi mapya vijijini	• New York City has an advanced
"Kanem amesema, ""ni lazima tukabiliane na vikwazo vinavyoweza kuturudisha wakati ambapo wanawake walikuwa na sauti ndogo kuhusu maamuzi ya afya ya uzazi au kuhuzu maisha yao kwa ujumla,"" ameongeza kuwa, ""vita vya haki na maamuzi vinapaswa kuendelea hadi pale itakuwa ni hali halisi kwa wote."""	"Natalia Kanem said: ""We must push back against forces that would see us return to a time when women had little say in reproductive decisions or, for that matter, in any area of their lives,"" ""The fight for rights and choices must continue until they are a reality for all"""
Woods, Kisha	planks of wood, then
""" Ways To Make Your Engine Run A..."	How to Drift a Motor...
Alifikiria kaka yake wa miaka 12 ambaye yuko kwenye chumba chake.	A 12 year old girl stands in her bedroom.
Sibishani na kiongozi.	Speak to the leader.
Huwezi kubadili kaya ile na kuchagua kaya nyingine.	You can't replay or make a different choice.
Hiyo ilikuwa ni Mei 2013.	This was May of 2013.
Jaji Fremr alibaini kuwa hakuna kesi ya kujibu kwa watuhumiwa hao kutokana na tathmini yake katika ushahidi uliowasilishwa na upande wa mashtaka kwa mujibu wa mwongozo wa mahakama hiyo.	Imhanruor said the defendants were not given an opportunity to defend themselves during the hearings that led to Justice Oyinloye's judgment.
"""Siku moja nitakuwa na familia, lakini si kutokana na msukumo wa jamii."""	'We will have a family Christmas, but without Maria.'
Natafuta wauzaji wenye bei nzuri (ndogo).	I'm looking for inexpensive pets.
Ninaomba chupa moja ya ____.	I want a cent...
Akayafunga na akasema: ((Hakika roho inapotolewa, macho yanafuatia [kupoteza uoni)).	He closed them and said, 'When the soul of a person is taken away, the vision of the eye also follows it.'
Kweli huyu mzee ni green snake in green grass!	He is a black snake in green grass.
Polisi walinitesa kwa saa nne lakini bado hawakupata habari yoyote kutoka kwangu.	Madarine had been out for four weeks but had captured nothing.
Gharama ya usajili wa kampuni ni nini New Mexico?	What Taxes Are Owed on Business Income in New Mexico?
Uzoea tofauti.	Teaching is different.
Nasimama na hii comment	I'll leave this comment
sidhani kama kuna atakaepona kwenye hii tsunami ya M4C	I don't think he got any move changes in Sm4sh
Na ukitaka kumchokoza ilikuwa rahisi.	If you want to do so, it's easy.
Mkuu Tanira tatizo lilikuwa imani hairuhusu..	Manoah's biggest problem, however, was a lack of faith.
Akielezea uharibifu huo,	In describing the raid,
jiji kuendelea na maandalizi yake.	The company continues to pursue its plans.
Kimsingi sidhani kama naweza kulala naye kitanda kimoja tena.	I don't think I could ever sleep with anything on again.
Mkusanyiko wa nyimbo 8 za Fulstan Amani.	A list of 8 words by pacificlight.
Ila rafiki zangu wengine wanavalishiwa kwenye chupi na waume zao.	Two intimate friends got divorced from their husbands.
Kwa hiyo, unapaswa kuweka malengo kwa ajili ya mtoto wako.	Therefore, you have to prepare your child.
Kanuni hii imetengenezwa na vyama na kampuni za EU, kwa kuhusika kikamilifu na maoni kutoka kwa wadau wengine, pamoja na mashirika ya kimataifa, NGOs, vyama vya wafanyikazi na vyama vya wafanyikazi, na pamoja na huduma za Tume ya Ulaya.	The Code has been developed with EU associations and companies, with active involvement and input from other stakeholders, including international organisations, NGOs, trade unions and trade associations, and together with the European Commission services.
Afrika Kusini ina pointi moja.	South Africa has only 1 point.
"""Shukran ila kaka mie ni mke wa mtu."	Hansa is just one woman.
Zidi kumwamini na kumtegemea katika kila hali.	She places her trust in Him in all situations.
Watu ni mimi.	folks is me.
Bw Abramovich, mwenye umri wa miaka 51, atakua ndiye mtu tajiri zaidi nchini Israel sasa.	Mr Abramovich, 51, would be the wealthiest individual in Israel.
Sasa, kila mtu anapaswa kujua mwenyewe ndani ya moyo wake.	Each person knows what is in their own heart.
"Sasa, niko najifunza na tano kati yao."""	"""Now I have five of them."""
Baada ya hapo alitoweka kwenye macho ya watu na hakusikika tena.	Then he turned away from the mirror and did not look in it again.
Shein mjini Moroni na fasili ya kisheria	The Book of Mormon and Social Justice
From the recording Paka ya Mwezi	From the album Pink Moon
Usichukue dozi mara mbili.	Never take two doses.
Lesha Center	The new Center
kinyume na taratibu.	As opposed to the POTUS.
From the song Hakuna Matata:	in the song, nothing can be explained:
Tanzania were...	Tanzania is a...
Hapana mungu isipokuwa Allah na Muhammad (s.a.w.w)	no God but Allah, and Muhammad is the
mi nafikiri we unapitia mid life crisis.	I think you're having a mid-life crisis.
kutoka kilo 112 nilizokuwa nazo before diat.	I weighed 127 pounds before I got pregnant.
Hakika 2000 ulikuwa mwaka ...	There was a 2000 ...
"""Kwa nini unataka kuuchapisha muswada huu?"	Why do you want to write to Prezi?
Wewe ndiwe taa ya maisha, wewe Ndiwe mweza vyote.	You are the author of life; of every living thing.
Wote hawa wana maendeleo.	All of them made progress.
babu V.babu February 1, 2014	Sara B. on 1 February 2014
Kwanza, huenda Loti alitenda kwa imani.	We can see from this verse that Lot was a true believer.
Karibu uungane nasi kila Jumapili	in almost every Saturdays
Носки McKinley Asio kids р.	Cornell Macneil has no children.
Mambo Kumi 10 Usiyoyajua Kuhusu Adolf Hitler Kumi Muhimu	10 things you don't know: adolf hitler
kama alikuwa mlevi nafikiri aliacha na kuwa mcha mungu.	He was belligerent, and he lost his fear of God.
huduma nyingine za kibinadamu zimeboreshwa, ndivyo matokeo y a somo lake	additional phases have been introduced, resulting in the number of phases
Na mimi mnibakizie jamani,vitu kama hivyo sijawahi kuvila nina miaka kadhaa	"""When I went to New York I tried to remember things from years ago."
Tupo katika kipindi ambacho hatujawahi kuwepo tangu mfumo wa vyama vingi uanze.	None of us have ever lived in an era when the banking system has collapsed completely.
Feeling alive yet?!	"""How are you still alive?!"
Mini Warehouses.	The mini crawls.
Jovic, hata hivyo, haijulikani na wachache wa magari yenye kupendeza sana, mafuta, msungi na wasichana.	Jovic, however, isn't noticeable by a handful of pretty impressing cars, booze, the swagger and girls .
Ulimi mwema wamtoa nyoka pangoni.	The tongue of a bell strikes the shell.
"""Kikosi cha Zimamoto cha London pia kimeitwa katika eneo la tukio kusaidia kupona kwa mwili."	London's Business Design Centre has also been confirmed as a vaccination centre.
Alitumia gari hilo	He was driving the car
OCD wa eneo husika pia aliandika taarifa ya tukio hilo.	Kwang Soo's agency also released a statement regarding the incident.
Siku hizi kuna pre paid roaming.	What is available today are rubber hoses.
"Je, si Neno LANGU husema, ""Baraka kwa wale wanaotii."	"remember His words, that ""blessed are those who mourn."""
Mkoa kiwango cha chini kabisa ni Iringa kwa 8%.	Inbound penetration is a maximum of 8%.
Haraka sana mpeleke hospitali au kwenye kliniki ili aweze kufanyiwa upasuaji.	have quick access to transport to hospital or home for emergency treatment.
Ni nani anamwogopa nani na kwa nini?	"Who are you afraid of and why?"""
Mi ningeongeza	I'm going Thêm
Samahani sikupata muda kujibu hii on time.	Manchin did not respond in time for this report.
Enough to make ya break and shake ya $$#	In addition to buffing & shaping of the nails. ~$30
Unapowasili Uingereza, gari lako litafanyiwa majaribio kadhaa na marekebisho ili kuhakikisha kuwa inafikia viwango vya barabara kuu ya Uingereza.	When your car is MOT tested, the testing station is required to run through a series of standard checks to ensure that it meets with the safety and environmental legislative standards applicable in the UK.
56 Lakini wao walimjaribu Mungu	(3:15c) but they also have put God
Wauzaji wamizani aina zote digital& analogy	the ideas of Digital Electronics and all types of Analog and Digital Modulation
"Next Story → Saida Karoli ""Nilidhani nitakufa kabla ya Ruge, Dr. Mengi kanipigania kaondoka"" (+video)"	"Drew Rub answered, ""The fourth (a large snake), I'd drop dead of (a heart attack)."""
- Sema Ukweli (@SemaUkweliKenya) September 15, 2021	Learn the Truth (October 31, 2021)
Ni Nani Anaongoza Watu wa Mungu Leo?	Who are God's chosen people today?
Kwa wiki takribani nne hivi, sijaonekana katika safu hii.	Four failures in a week, I don't remember seeing this before.
Ndivyo ilivyokuwa hapo awali, ndivyo itakavyokuwa tena.	It has been this way before and it will be this way again.
Check Link pia kwenye bio au profile.	See also the Table of Contents or Maps.
Jaribu hiyo next time.	Try it for next time.
Kupitia unachokifanya kuna mtu anaguswa sehemu.	Things you do are driven by something.
Makadirio ya hali ya hewa duniani yanaonyesha kuwa chini ya mazingira yote, joto litaendelea joto - na miaka kama vile 2019 itakuwa kawaida ya muongo huu.	Research published in the journal Nature shows that as global temperatures rise, the Arctic will not be spared, and fires like these may
Itakuwa ni aibu kubwa kwa rais wa nchi kufumbia macho upigaji.	It is all very well for the Leader of the Opposition to shake his head.
Tea - ww tuna mayo 77, salad 40	Mo, 57 years - Canada.
Zaidi ya nusu ya watoto duniani wanakabiliwa na tishio la vita, umasikini na kutengwa kijinsia - china radio international	Over half of the world's children threatened by war, poverty, bias:
Concern yake hapo ni hou mwaka.	The factor here is that he is a one year rental.
Nishakuwa mwehu tayari!	I used to be prepared!
Huo mfano wa practical trainings ulioutoa ni sahihi kabisa.	The training provided by them is really effective.
40 yeye ambaye huwamwagia dharau wakuu,	The One who conquered the grave.
Mars aka mr.	Marge has passed on.
Na mwende mnapo amrishwa. ***	when you are hoeing).
Tumia zaidi nuru unayopata!	Make the most of the light you have.
Kwa wazi, hii itahitaji kuwa mtu unayemwamini kabisa.	This means that they must be a trustworthy person.
Daudi Nyaburi	David showed courage.
pamoja na uhuru wake.	upon his freedom.
Kesho hatunayo ahadi	We ain't promised no tomorrow
- Kristo kinachojulikana, Maitreya amesema zaidi ya miaka 30, bado inafanya kazi ulimwengu unrecognized, katika mwili hapa duniani.	- The so-called Christ, Maitreya has said more than 30 years, operates the world yet unrecognized, in a physical body here on Earth.
Ni nini ilitokea wakati Yohana alikuwa na umri wa siku munane?	What happened to John Newton when he was six years old?
Jitayarishe Kutoa Maelezo	Be prepared to give explanations.
Nina sababu nyingine: mtu huyu ana uwezo wa kuelewa vitu vyote, hata vitabu vya watoto.	The communicators: These people understand all the languages, even that of animals.
Yi, Jinyao (2)	Yes I Will (2)
kwa taarifa yako huyu ndio mwanamke mfupi kuliko d	A lady who had more money than c her
Ni muhimu kukaa hydrate, haswa ikiwa uko nje wakati wa mchana.	It is important to stay hydrated, especially if you are outside during the day.
Cheap MBT Womens Katika Outlet Sale	the free fatty acids in the extracted
Yote nakueleza, mengi umeyapitia	I've told you all a lot of
Amini usiamini mtoto wa kike alipatikana hai zaidi ya saa 14 baada ya garli alimokuwa kutumbukia ndani ya mto uliofurika huko Utah marekani.	A baby girl has been found alive in a car more than 14 hours after the vehicle plunged into a river in Utah.
Machapisho kuhusu programu za Facebook Facebook wasikilizaji wa muda mrefu zaidi kuliko wastani.	"""The demographic of Facebook users shows that they're much older than Instagram's."
Tabia za maafisa wa serikali ya Tanzania huathiri kwa njia taratibu mfumo.	The Omani Government's economic diversification plans are positively impacting the economy.
George Njogopa na maelezo Zaidi:	Roger becomes even more concerned about
Kwa hiyo, ina maana kwamba tunacho chanzo cha uhakika cha fedha, tunachokihitaji ni kuhakikisha kwamba chanzo hiki kinatumika kwa madhumuni yale.	Therefore, it would be safe to say that we have a right to see that base need fulfilled.
mimi nimipenda hiyo ya watumwa wa kiimani wanaoshindanisha mitume wao.	I would love to read stories of believers who challenge their mentors.
siku iliyokubalika kwa BWANA?	The day of the Lord?
Kwa kweli kikundi chenu ndio bora zaidi mwaka huu wa 2015!)	This is your BEST OF 2015!
Fuata hatua hizi inaweza kutatua ADAPTER vifaa wireless kukosa [...]	These defects may contribute to a loss of synaptic plasticity. ..
...ndo mana tunaendelea kuwa maskini.	Fine... but we are still poor.
Lakini ilinibidi niwe makindi katika muda wote wa mashindao.	Similarly, there was enough to keep me occupied throughout the flight.
Muda mfupi kabla, rais Temer aliuta amri inayoidhinisha kupelekwa kwa jeshi katika mji mkuu baada ya makabiliano makali wakati wa maandamano yalitoendeshwa nje jengo la Bunge.	Earlier, President Blaise Compaore had fled to neighbouring Ivory Coast after massive mass protest resulted in a military coup.
Nashukuru kaka kama mmojawapo wa wachangiaji na wasomaji mliokuwa na moyo wa kuachilia mapema.	I am compelled to thank you for being one of the few public scholars on Mandaean texts and origins.
Welcome nyumbani Elvis!	Welcome to the elephant house!
Mara kadhaa nawasikiliza viongozi wa	I've had the experience of hearing leaders
Kucheza katika mapanga giza.	Playing in the moonlight.
Wakaishia hapo kwenye nn?	They're going to be on OGN Live?
Wakati watu wengi wanaamua kukarabati nyumba zao, mara nyingi hufanya kuchimba kabisa.	When individuals decide to sell their home, they are often overwhelmed with the whole process.
Alichosema Rama Dee kuhusu sakata la madawa ya kulevya	MaryW commented on the word pharmacovigilance
Kama kuna mwingine anapenda picha yake iongezeke hapa kwenye hii list anakaribishwa	If a member would like their photographs to be displayed on this website,
Nilipokuwa na miaka 20 hivi	When I was about 20.
Ni Haishu bian.	He is my Bwana.
"""Awataka wanasiasa wasifanye makosa kulinganisha marais"	"""They don't want migrants to cross"
Mbunge wa Jimbo la Kilolo Venance Mwamoto amegawa vifaa mbalimbali vya michezo kama alivyowahidi ...	The Egg Harbor Township resident has been linked to a number of incidents, according...
"""EU na UN wana ushirikiano wa muda mrefu na wa kipekee."	"""The European Union and the United States share an important and unique relationship."
Slaa tukarudi kwenye gari.	Wasiu returned to the car.
Timu ya TSCSA imeshashiriki ziara kadhaa za nje ya nchi.	The Geologists' Association organizes a number of overseas field meetings.
Hivi sasa, taratibu za ufuatiliaji wa injini zimekuwa ngumu zaidi na zenye akili.	Today, risk management has become even more critical and challenging.
Hii hawezi kuletewa	this can not be undone
Iko siku wananchi wataamka	On that day the voters of the town
"""Nimekuwa katika ndoa kwa miaka14 na 'tuna' watoto 3 (wanaume) lakini si wangu."	I have been married for 14 years, we have 3 kids (all boys) but none of them belongs to me.
Mipako tu ya unyevu juu ya kuta itazuia kuonekana kwa mold.	Only the tinniest of ripples give away the surface of the water.
bad alike.	Same as MALE.
Hizbullah: Marekani na EU zinazuia wakimbizi wa Syria kurejea nchini kwao	baghdadhope: The U.S. and U.N. Have Abandoned Christian Refugees
Hayo mambo ya kwenye movie yaache kama yalivyo.	the movies make it out to be.
Utaimiliki fleti yenye huduma kama yako wewe mwenyewe.	challenge to an on-foot soldier such as yourself.
Ni bure ikiwa fomu AOP ni kukamilika kabla ya kuondoka hospitali.	It's free if the AOP form is completed before leaving the hospital.
"Lowassa amuambia Rais Magufuli ""inatisha lakini usitishike, umma na dunia inajua"" _ MUUNGWANA BLOG"	"Kambwili says, ""Don't worry country men & women, its global"""
Yohana 14.3 - mimi kwenda kuandaa mahali.	John 14:2-3 ÒÉ.I go to prepare a place for you.
Sasa nitaambia watu nini kwa ofisi?	What do I say to the Sheriff's Office?
I hate them, pamoja na kuwa mimi ni subscriber pia!	I hate ND but I'm also a realist.
Hivyo yeye ndiye anayelipotezea taswira nzuri bunge kwani hajui anachokifanya.	He has decided that his life is forfeit because he does not know what he faces.
wapate kula mali kwa dhulma.	the income of the wicked is for sin.
Jopo iliyoteuliwa na Rais mwaka wa 2003	implemented in 2003 by the Bush
Clarissa Explains It All Klabu Zilizohusiana	clarissa explains it all box set
Kwa mujibu wa tangazo lililotolewa hivi karibuni, safari zote za ndani ikiwemo za Durban, East London na Port Elizabeth, sitasimamishwa kuanzia Februari 29 mwaka huu.	All other national destinations, including Durban, East London, and Port Elizabeth, will cease to be operated by SAA on February 29, 2020.
Kusini Unguja Women Over 50	South branch single women over 50.
Mimi peke yangu hufanya misaada yangu.	I'm only doing my own favorites.
Subiri ujumbe kutoka benki kama unastahili	//update the rest of the message if necessary
Maana hali ya uchumi ni ngumu	On the other hand, the financial situation is tough
Anazungumza na wazazi wetu.	He talks to his parents.
Wadau wakiwa kwenye kongamano la afya	controversies in public health
Supernal Sounds (Live) - Bheka Mthethwa	Supercavitating propeller - See: Fully
Nilizingatia sana fair play.	I'd play fair game.
Hapa chini ni Thesis yake ya Shahada ya Uzamivu;	Here's your upcoming film line-up;
maisha yake vile atakavyo halafu nyinyi muwe	your life, and how you will
Slaa hakuwepo Jangwani.	Nell was not in heaven.
Mimi nakumbuka kwenye maadili ya uchaguzi mwaka 2010 ilikuwepo.	I are actually practicing legislation in Arizona considering the fact that 2005.
Huwa ninaenda kuchukua vifaa ninavyohitaji,	I am going to get the things I need.
Naweza kumeza tembe ya kutoa mimba ikiwa nimegunduliwa kuwa na STD au ambukizi katika mkondo wa uzazi?	Can I qualify for life insurance if I've been diagnosed with Celiac Disease or Sprue?
Gari uwezo: 65 200 malori au magari ya abiria	Capacity: 64 cars and 600 passengers
Profile on the website zaidi	Additional content on the website
"Alikumbuka enzi zake za ujana na kujisemeza, ""Lo!"	"He closed his eyes and muttered to himself: ""Good God!"
Wenye nguvu (potential) ya kuwa chochote.	He is omnipotent...all-powerful.
Mpina mwenyewe ndani ya mwezi mmoja sasa.	a song in a month.
Sowore ni muanzilishi na mchapishaji wa Wanahabari wa Sahara (SR), ambalo ni gazeti la habari za uchunguzi la mtandaoni.	Sowore is the Publisher of Sahara Reporters, an online media organisation.
Juzi juzi wamepita vijana wawili lakini hawakurudi.	Summer nights have passed two young men but they did not return.
Unakasirika mara nyingi kadiri gani?	Tell me how often you get sick.
"^ Ao ""uchungu wa nafsi yangu."""	"Like the ""apple of my eye."""
Katika nyekundu kama ilivyo mara tano chini.	Down, like five times.
Baada ya kutumia yangu rahisi No-Nonsense Fat Kiwango System , nimepata wanafunzi kuniambia wangeweza kuwa na kulipwa zaidi ya $ 1,997 tu kupata taarifa hizi mafanikio ...	I received an email letting me know we had to pay them $18 to extend the preapproval...
'Kwani unaenda maternity?'	"""Do you go to Breightmet?"""
Jonathan Harshman Winters III (amezaliwa tar.	John Lovett III Carter (1) was born.
darasa litaanza muda gani?	When the class is going to start?
"""Taasisi mpya ya uchumi wa wazi imekuwa ikiboreshwa kwa kasi."	"""The new institutions of the open economy have been steadily improved."
Alisema polisi wanaendelea kumtafuta dereva huyo.	The police said they are still looking for the driver.
Amerika ilifanya hivyo si kwa sababu ya huruma, bali ni sababu	It was made for Americans, not for
Bado haitusaidii kwa chochote katika nchi hii.	It still hasn't hit us over here in Europe.
Utumwa umefanywa na wote pamoja na waafrika wenyewe.	Many were enslaved along with the Africans.
Je ni haki kuwalinganisha.	But it is fair to compare them.
Na tukamuandikia katika mbao kila kitu, mawaidha na maelezo ya mambo yote.	And WE wrote for him upon the Tablets about everything an admonition and an explanation of all things.
Unataka mazungumzo tu bila chaguzi za ujumbe wa kibinafsi?	Do you wish to communicate with the world, without any linguistic barriers?
Wasifu wa L'O inakataa kabisa taarifa hii, Anya ndiye penzi lake pekee kwa miaka mingi.	The abridged audio of this title is absolutely awful, but for years it was inexplicably the only audio version available.
hebu nenda kwenye mgomo wenu na utuondolee ujinga wako hapa.	Go back to your body and stop your expectations.
inanisumbua sana#) ama nilivyosema awali% ninyi ndiyo wau wa kwanza	"It's their way of saying ""watch the the @#*% you say!"""
Atawasamehe wote watakaotubu.	He forgives those who truly repent.
"""Kabla ya Mkutano&hellip;"	until the outbreak of the war.&quot;
"Chapisho jipya - ""Kusababisha Mabadiliko ya Hali ya Hewa: Masomo kutoka Asia Kusini"""	"Presented a paper entitled: ""Engaging with Globalisation: Lessons from South Asia"""
Iraq na Uturuki wafanya mazoezi ya pamoja kijeshi	Turkish and Azerbaijani armed forces launched joint military exercises on
Hint: It's not wewe au me.	Hint: it's not you or I.
Mimi sio daktari, wala sijacheza moja kwenye TV kwa hivyo hapa ni chini ya matibabu ya kila mmoja:	I am not a doctor, nor do I play one on TV; so this is not qualified
Vile tumempa sheria na uwezo---	And we serve them with truth and honesty,...
Kwa Wajasiriamali hasa wa sekta ya Kilimo...	Especially for the fans of the ge...
Utafutaji wa jiji la jiji	Search for The Town
Kama wewe kama wewe Nifuate Mtandao wa Twitter, Facebook, Google + au kushiriki na vitufe chini ya chapisho hili.	If you like what I do, tell people via Facebook, Twitter, Google+, reddit, or however you get down.
Gumzo la video la moja kwa moja na warembo moto!	Hooray for fire and explosives!
Wewe kaokote vichwa vya kuku kwa lema sikuu hii	All of you are distinguished members of this steel frame.
Ana kazi kubwa, lakini kama yuko makini anaweza kuifanya.	A lot of difficult work, but if you do it, it is manageable.
Na watu bila hiyana wanana nunua.	Uncivilized people make.
Bondia Sergio Martinez, kutoka Argentina, kulia akimpiga ngumi Miguel Cotto, wa Puerto Rico, katika mpambano wao wa ubingwa wa WBC World Middleweight Title boxing match Saturday, June 7, 2014, in New York	Miguel Cotto, of Puerto Rico, knocks down Sergio Martinez, of Argentina, during the first round of a WBC World Middleweight Title boxing match Saturday, June 7, 2014, in New York.
Mahojiano yako kuhusu elimu yake hayakunirisha kabisa.	Their talk about school hadn't gone well at all.
Hii ilitokea katika Ligi ya Mabingwa ya mwisho mchezo wa 16 dhidi Diego SimeoneAtletico Madrid.	This happened in a Champions League last 16 game against Diego Simeone's Atletico Madrid.
sasa hali ya usalama mtandao kwa mujibu wa twakwimu imekua ikiongezeka huku	Moreover, the threat posed by cybercriminals is growing in
Ongeza thamani ya maisha yako kwa kujenga maisha yako.	Make your life more worth by adding value to your life.
Huyu mukulu mbona anatuchanganya?	"""Why did the Emperor summon us?"
Kesho nitaweka link yake.	Tomorrow, I will give you the link.
And the inayofuata siku wewe bring me down	One day you take me up and the next day you bring me down
aisee huu ni msaada kwa wakati muafaka, mimi nahitaji ushauri kwenye website yangu.	Since I'm clumsy, I need a case on my smartphone.
Kwa hiyo hapa tutaangalia yale mambo yaliyosababisha Kiswahili kitumike katika eneo kubwa.	For a start we shall understand what it entails with the Swedish massage in this case.
Alizaliwa Kivum mwaka 1952.	He was born about 1952.
Hatuwashawishi viongozi wa kisiasa wafanye mambo tunayotaka, hatupigii kura vyama au wagombea wa viti vya kisiasa, hatugombei vyeo katika serikali wala kushiriki katika harakati zozote za kutaka serikali ibadili mambo fulani au kubadili serikali.	We do not lobby, vote for political parties or candidates, run for government office, or participate in any action to change governments.
Mfumo wetu wa kisiasa Endelea	Therefore, our political system
Hakuna huduma bora unayoweza kuipata bila kugharamikia.	No good work should go unpunished.
Anabolic steroids ni haramu nchini Marekani, Kanada, Uingereza, na Australia, Lakini wakati unakuja kwa dhima wakati ni hawakupata doping, vitu kupata ngumu.	Anabolic steroids are illegal in the United States, كندا, المملكة المتحدة, وأستراليا, but when it comes to liability when you're caught doping, things can get complicated.
Ilikuwa rahisi kuiunganisha Afrika katika miaka ya 1960 kuliko ilivyo sasa.	It was much easier to get lost back in 19th-century America than it is today.
Hata katika visa hivi, matibabu ya uzazi yanaweza kufanikiwa kwa kushangaza.	Even in adults, orthodontic treatment has good chances of success.
Jinsi Ya Kuishi Na Ugonjwa Wa Kisukari.	Living with bipolar illness.
"""Sielewi mtakapomtoa lakini ni lazima tufanye majaribio!"""	"""I don't know if it will be successful, but we have to try."""
Mheshimiwa Naibu Spika, jambo lingine ambalo nataka nizungumzie ni...	Damitty, this is another one I need to buy...
Wengine ni waandishi wa kutoa habari tu walizokutana nazo.	while others simply evaluate the materials that have been submitted.
Moto wa Magufuli umeanza... aluuu! -	Asap started the sh*t...
Huu siyo wakati wa kuzungumzia sukari tena!	Now is not the time to focus on Growth !
Sio mbaya kwa sababu dakika 23 si nyingi kama ingekuwa siku nzima.	Aim for about 20 minutes a day - it doesn't need to be for long as long as it's daily.
Kwa mwenye sababu yake pls naomba nisaidiwe.	Is why I wound up at cpf, to get help.
"Aliongeza, ""Nikikuuliza yapi mengine utajibu nini ? ."	"She added, ""What else would you expect me to say?"""
Shorts Bikini Uk	A Short Tour of the British Museum
Mimi pia, ninahitaji pesa za ziada kusaidia mfuko wa ndoto yangu na kuishi vizuri zaidi.	I'm also trying to save up some money so I can get back into real estate and be more flexible.
Mauaji hayo yaliangamiza maisha ya Wayahudi milioni sita wakati wa utawala wa Kinazi 1933-1945.	An estimated 6 million jews died in the holocaust during the 1933-45 nazi rule.
na uwezo wa kulishughulikia na hata kulifikisha katika vyombo vya kinidhamu vya	ability to govern and even causing them to question the sincerity
Uchawi ni roho mbaya .	Lust is an evil spirit.
(211) na hilo halifai kutoka kwao na wala hawaliwezi,	And they are not worthy of it nor can they be able to do so.
Tumepata ushindi mkubwa.	We have won a greats victory.
Masimba na Teddy wakarudi mpaka nyumbani kwao.	tees returned to their homes.
Tunahitaji mabadiliko katika dira ya uongozi ili tuwe nchi yenye uhuru kamili.	We need borders in order to be a country.
Minyororo ya Binadamu inaonyesha kitendo cha usemi wa kibinadamu, kutekeleza kitendo cha pamoja kati ya watoto wengi kuibua hadharani msimamo mitaani, kwa hali hii: omba Amani na Usijali kwenye sayari.	A human chain it symbolizes an act of human expression, performing a combined act among numerous children to make publicly visible in the street a position, in this case: ask for Peace and Nonviolence on the planet.
Kusafisha hufanyika mara moja kwa wiki.	The purification is carried out 1 time a week.
"(trg) =""98""> 6 ambao wakawaweka mbele ya mitume , na walipokwisha kuomba wakaweka mikono yao juu yao ."	[Greek names] 6These seven were presented to the apostles, who prayed for them as they laid their hands on them.
Akawa ni kama anamchukia mumewake.	was as if he hated his father.
ijapokuwa Adamu alikuwa ameanguka.	Adam, though, was floored.
Sio tu kuhakikisha kwamba...	Not only do we ensure...
Kuna kundi kubwa la watumishi wa serikali wanaostahili kufukuzwa kazi mara moja.	We have a great group of kids who want to Obey right away.
Akaniangalia na kuniambia nina macho makali.	He saw my face and said he would be careful.
Ahsante Mungu maana imeandikwa tushukuru kwa kila jambo......mbivu na mbichi zitajulikana tu	we have to thank God on everything.. bad and good stuff..
Yaani siwezi fanya kitu chochote akiwa karibu kwa maana atafikisha ripoti chochote kile nimefanya	It truly is the one thing I can't live without because it does everything that I enjoy.
BC: Kwa siku huwa unatumia muda kiasi gani kufanya masuala yanayohusiana na blogs kwa njia moja au nyingine?	TGP: How much do you interact with the players on a day to day basis?
Mshahara wa ajira ile ulikuwa maradufu wangu.	Amazon was twice the price.
Ujumbe wa Malaika Gabrieli kwa Mariamu.	The Annunciation by the Angel Gabriel to Mary.
Mambo yaliyotafutwa sana Tanzania 2016:	China's launches in 2016:
"Malalamishi hayo yaliyowasilishwa siku ya Jumatatu na Nils Melzer yanataka kufanyika kwa uchunguzi wa mara moja kuhakikisha kuwa Rusesabagina ambaye ni mkosoaji wa wazi wa muda mrefu wa serikali ya Rwanda ""bado yuko hai. """	"The complaint filed Monday with Nils Melzer asks for an immediate investigation to make sure Rusesabagina, long an outspoken critic of Rwanda's government, ""is still alive"" after being accused of terrorism."
Na wakatokea hao wanaosema wanaweza wakafanya	"""They do what they said they did!"
wa + li4 (untruths)	+4 more St Leonards (9)
Alisema ameona kwenye televisheni watu wakitoa maoni yao juu ya kampuni hiyo ya ndege kuwa ni nzuri kwa sasa na yeye akaamua kusafiri na ndege hiyo.	He saw on TV that the authorities are recruiting volunteers to help, and he immediately decided to go.
Ms all del Chamizal,	the city of Ma'alot,
Bibi karudi chini, lakini bwana, hasira zikampanda...utapata talaka, kwanza nani kakupatia haya maradhi, na mimi mgonjwa, hata unyumba wenyewe wanishinda!.	You be damned, the murderer even listen to me,... but sad, private whom I told you.
Makusudi ya Chama cha Usambara Citizen Union ni:-	The aims of The London Community Flower Show are:
joel lwaga yesu nipende leo kuliko jana	This church has helped me love Jesus more today than yesterday.
Wale ambao wanachagua kuishi karibu na Uwanja wa Ndege wa Eindhoven watalazimika kuzingatia akaunti ya uwezekano wa usanifu wa kupita kiasi.	Those who choose to live close to Eindhoven Airport will have to take account of the possible nuisance of overflying aircrafts.
Lakini mara nyingi wanaonufaika na punguzo la kodi	They do, however, often use the blunt instrument of funding
Mungu ampe nini tena.	God provided yet again.
Najua ya kuwa yeye aweza kusema vizuri.	I know that he can speake well.
Mafuriko yaendelea kutishia Pakistan.	The Afghans are still trickling into Pakistan.
Hatua inayofuata ni kushiriki hatua za utambuzi.	The next step is to engage in action.
Alisema kauli mbiu ya maadhimisho hayo mwaka huu ni 'Mikono safi kwa	"He also said this year's exam was ""very easy,"""
Sorry, siwezi kufafanua zaidi.	Sorry i can't explain more.
Tu akupenawai.'	"invite you."""
unashiriki vipi?	What are you participate.
Ni hakika kukusaidia kupona baada ya workouts yako, lakini kwa bei, kuna bidhaa bora huko nje.	Yes, it takes effort to get your work into the product, but when it's out there, it's rewarding.
Mabadiliko ya hali ya hewa yanatufanya tushindwe kuwa na uhakika wa mustakabali wetu, hata hivyo jambo moja ni dhahiri kuwa jamii yetu inalo jukumu la kugeuza hali hii, si kwa ajili yetu pekee bali kwa vizazi vijavyo pia.	"""A particularly pleasing aspect for me is that the building is carbon neutral, which I think sends a real message about our commitment to being an organisation that not only cares about its people and its communities, but also about the environment around us."
Na hata watu wenye heshima zao naona sasa hivi wanaona hata aibu kuwa associated na serikali ya sasa.	Today the members of the media aren't even embarrassed that they have allowed themselves to become an arm of the Democratic Party.
All in all, they sometimes gain something ila cha kuhofia ni kuexpose kila kitu kwa hawa majangili.	Everyone's afraid of something, but only the brave conquer their fear.
Lakini la muhimu zaidi mkeo aridhike, akisharidhika mnaweza kufanya hivyo.	Most importantly, she proved that you could be a woman and do all that.
Kwa Mfano wa Bwana Yesu na WanafunziB Y W f i Wawili wa Emmaus.	Cooke and the other two by H. Moses.
Ukiamka kesho hautakumbuka uliyoyaandika leo.	When he wakes up tomorrow, let him forget everything that happened today.
Hivi serikali yetu inatupeleka wapi.	That is where this government has left us.
mwisho wa mwaka tuwe makini barabarani	Cheers at the end of the road
Kwa mara ya kwanza katika spishi ya saizi hii na rangi [Zaidi ...]	For the first time in the racing and driving genre,...
Inayoahidi leo ingekuwa imeyatekeleza katika miaka 40 iliyopita.	Hope lost had now been renewed over the last 40 days.
Ni hapa kila mwezi hoteli ikigaiwa Sh.	This space is hosted by Nanci Monthly.
- Mtodos: OnKey; OnTime.	Shaunti: All at the same time - and all the time.
mwandishi: Kitu gani kinakuongezea kipato?	The implication is: what are you doing to add value?
Hii biashara mbaya sana.	This is particularly bad trade.
Karisha - So Cute!	Be careful - it's catchy!
- Familia ilifichua kuwa tangu Desemba 2020, marehemu alikuwa kwenye mashine ya kumsaidia kupumia	The family divulged that since December 2020, the deceased had been on a life support machine.
Ukweli # 1: WWII isingefanyika ikiwa USSR haikutia saini mkataba wa Molotov-Ribbentrop na Ujerumani ya Nazi.	Fact #1: WWII would not have taken place if the USSR had not signed the Molotov-Ribbentrop pact with Nazi Germany.
Utafiti uliofanywa na Chuo Kikuu cha North Carolina umehitimisha kuwa wanawake vijana wanaweza...	Research done at the University of Kansas shows that being able...
iweze kutoa uamuzi.	it could make a decision.
Mheshimiwa Naibu Spika, kwa hiyo, siyo kweli kwamba marekebisho haya sasa yanataka kutambua mifumo ya Kimataifa, siyo kweli hata kidogo.	Dani is right of course that having doubts about the current multilateral arrangements does not make you a protectionist.
Rugangazi: Nisingependa kuzungumzia mahusiano binafsi ya viongozi wangu.	Chad: I'm really not interested in discussing my relationship with my brother.
Dakika 20 kutoka pwani ya Copacabana.	20 min from Copenhagen airport.
nuru video wake up fuck	The eyes of the demon light up.
(b) Yeye Hawezi kuonekana	B) Not being able to see
Baba, asante kwa umati wa Wakristo ambao walitoka katika mataifa yote kupata kadi zao za wapigakura.	Thank God there were people of all races that agreed with the civil rights movement.
Mbinu #1: Kujenga tovuti kutoka mwanzoni	M1012: Building a Website from the Ground Up
Hakikisha namba yako ya simu na barua pepe zipo kwenye tangazo, na pia toa majibu ya maswali yao haraka.	Keep your photos and information up-to-date and respond to questions and reviews quickly.
Wakristo wanashambuliwa nchini Msiri.	Christians are being persecuted in Muslim countries.
19 Katika mwaka wa kumi na nane wa kutawala kwake Yosia ikafanyika pasaka hiyo.	19 In the eighteenth year of the reign of Josiah this passover was kept.
Nilikuwa wa kwanza kuchukuliwa.	I was the first one to be arrested.
BCAA ni muhimu amino asidi kama vile L-isoleucine, L-leucine, na valine ya L ambayo haiwezi kufanywa katika mwili wa binadamu na kwa hiyo lazima itumiwe katika mlo (15).	BCAAs are essential amino acids such as L-isoleucine, L-leucine, and L-valine that cannot be made in the human body and therefore must be consumed in the diet (15).
Kalita, Jitumani M	C'mon, wine, take me
Hivyo, maelezo yake katika makala hii YANAWEZA kua na upungufu wa kitaalamu hapa na pale.	Hence, research in this field can be related to both the organizational and technological aspects.
Jameni wana jf.hubu nitoeni taka za machooooh!.	Take me out fwh the ballgame.
Marekebisho ya Liturujia yaliyoamuliwa na Mtaguso wa Vatikano II yalijitahidi kuwaandalia Wakatoliki chakula cha Biblia kwa wingi zaidi.	The fruits of Vatican II have been bitter for the Catholic Church.
Hizi study tour nyingine mmhh.	It's another MSI MB.
"""Deni la kijamii na kimazingira ambalo maskini mijini wanadai linaweza kulipwa kwa kuheshimu haki zao tatu kuu ""za L tatu (Kwa Kiingereza) "": Land, Lodging, Labour."	"The social and environmental debt owed to the poor of cities can be paid by respecting their sacred right to the three Ls: Land, Lodging, Labour."""
The Kidogo Method	The little schemer
Ntamuaminije mtu wakati Ndiyo kwa mara ya kwanza tu tunaonana.	I try to not bring it up the first time we meet people.
Steroids za anabolic zilianzishwa mwishoni mwa miaka ya 1930 kimsingi kutibu hypogonadism, hali ambayo majaribio hayatengenezi testosterone ya kutosha kwa ukuaji wa kawaida, ukuaji, na utendaji wa uhusiano wa kingono.	Anabolic steroids were created in the late 1930s mainly to deal with hypogonadism, a problem where the testes do not produce enough testosterone for regular development, development, and sexual performance.
kufanyia kazi hayo yaliyotajwa hapo juu	out the above-mentioned work
Pengine wanajikinga na vumbi tu.	Also, maybe they're just trying to avoid obesity.
Unathubutuje kumsihi mfalme kwa tabia ya kiburi na kwa ...	Are you optimizing ROI and...
"inayopendelewa performance in ""Michael""?"	"significance in the performance ""smile."""
Huoni wivu kuwa the other woman???	You sure we aren't married to the same woman!?!
Swali,je kuna mwenye aliyepata tetesi kuhusiana na habari hii?	The question is whether somebody has written such a thing.
8Wakati wale watu wenye ukoma walipokuja sehemu ya mwisho wa kambi, wakaenda kwenye hema moja na kula na kunywa, na kubeba fedha na dhahabu na nguo, na kwenda na kuzificha.	8When the lepers arrived at the edge of the camp, they went into one tent after another, eating and drinking wine; and they carried off silver and gold and clothing and hid it.
Huyo hana cha message anapoteza wakati tu.	The message-thing is just a waste of time.
Haubadilishi aina ya mazoezi	It does not exclude any class of
Alisema Nya.	He said He ate.
Halafu wazazi hao wote wanakuwa wazazi wenu.	And then there are always your parents.
"""Tumefanyia kazi sana kwa siku nyingi."	"""We've been working some long days."
Yaani nikiusikia huu mwimbo,nafreeze ghafla,cjui kwa nini.	And listening to the album with fresh ears, I can see why.
Muasisi wa Jumuiya ya Bunju Community Support Profesa.	The Chicago Teachers Union supports this education champion.
Weye bwanamkubwa hebu kuwa unafanya homework kabla haujawambia wengine hawafanyi yao.	You have got to clean your own house first before you tell other people that they aren't doing it right.
16 Kwa imani katika jina la Yesu, huyu mtu mnayemwona na kumfahamu ametiwa nguvu.	"""By faith in the name of JESUS, this man whom you see & know was made strong."
Ofisi inapaswa kuwa mahali rahisi kwa wateja wenye uwezo.	The area needs to be a location that can easily be found by the attendees.
Hakuna chochote kinachohitaji kutafutwa kwa kina sana - ingiza programu-jalizi na uweke wijeti mahali unapoihitaji.	Don't plan on that has a hectic agenda, and adjust the work plan when needed.
akizungumza na mwanaume mwingine.	He got speaking to another man.
Hawana tumaini, kwa hiyo wanapenda mutu fulani awasaidie.	They are hopeless and look to someone to love them.
Least I Could Do karatasi za kupamba ukuta	I could have at least got a soap box.
"""Nimekukumbuka sana Dickson,"" alisema Linda kwenye simu."	"""I hate you so much,"" Shawn said into the phone."
HAYA MENGINE TENA Usafiri wa Mchungaji.	This applies again to the hero's journey.
Natumia muda mwingi kujifunza kwa namna tofauti maisha ya ndoa yalivyo.	I am spending a LOT of time learning to change my relationship of money.
Kumbe hiyo ilikuwa raha ya wanafunzi?	Or was it the luck of the Irish?
Nikaona ana miaka 29.	I have children 29 years old.
"wajiandae kufungwa."""	"send them to jail."""
Ashuke kutoka msalabani nasi tutamwamini.	come down from the cross, and we will believe in him.
Hii ni hatua ya kwanza kabisa na muhimu sana.	Thats the first and most important step.
26Yoabu alipoondoka kwa Daudi, alituma wajumbe kumfuatia Abneri, nao wakamrudisha kutoka katika kisima cha Sirah, lakini Daudi hakulijua hili.	3:26 When Joab had come out from David, he sent messengers after Abner, and they brought him back from the well of Sirah; but David didn't know it.
Kwa manufaa zaidi,jitahidi usome kwa makini na uelewa haya:-	For best results with monitoring AD, read and understand the following:
Whatsapp wameanzisha njia mpya ya kukaribisha watu kwenye group kwa kutumia link.	Kelloggs have created a new strategy to engage with the customers via text.
"""Vizuri sana na pole kwa yote yaliyotokea hapa nchini kwenu."""	"""It directly ties to absolutely everything that happens in your community."""
Lakini ujumbe ni lazima upelekwe.	But the message needs to be sent.
Kisha unaweza kuona matokeo ya mwisho ndani ya akaunti yako ya Akaunti ya chombo.	Then you can view the results in your browser.
"""Huenda ulikuwa si mchezo mzuri , lakini tumeona kwamba kulikuwa na hali bora kiasi katika mchezo wetu."	"""It was an experiment that didn't catch on but we do think there's a fun game there."
Nia ni kugawanya watu	The centre aims to bring together people
Tunaamini tuna uwezo wa kukusaidia.	we are confident we will be able to help you.
Kwa kufanya hivyo unajiongezea nafasi ya kupata kazi ya kuajiriwa.	Therefore, you increase your chance to find employment.
Nasema hivi NITAKUWEPO kwenye robo fainali ya Sprite BBall Kings 2018.	I'm now on the third stage of the 2016 Tour de Fleece.
Hata hivyo, aliendelea kuhudumia mtaani pasipo kuwa na kibali.	However, he continued to promote the art without rest.
Tunamsubiri Yesu ili siku moja aje atupeleke kwenye hiyo haki.	Jesus will come one day to fulfill His promise to us.
ASCII - (American Standard Code for Information Interchange) ASCII (Msimbo Sanifu wa Marekani wa Mabadilishano ya Habari)	An acronym derived from American Standard Code for Information Interchange (pronounced as-kee).
Hata hivyo, mtu anawezaje kuzaliwa tena?	HOw is it possible to be born again?
11 wamlete Vashti, malkia, mbele ya mfalme, amevaa taji ya kifalme; ili kuwaonyesha watu na maakida uzuri wake, maana alikuwa mzuri wa uso.	11to bring Queen Vashti before him with the royal diadem on her head, to show her beauty to the people and the officials, for she was very beautiful.
Pamoja na maendeleo ya sayansi na teknolojia, ...	With the advance of science and technology, ...
Natafuta marafiki wa kiroho.	I'm looking for spiritual friends.
Madume yanasifa yakukua haraka kuliko majike.	The weeds are growing as fast as the plants.
"23 Mtu mmoja akamwuliza, ""Bwana, ni watu wachache tu watakaookolewa?"""	"23 And someone said to him, ""Lord, will those who are saved be few?"""
Huduma kwa wateja - Sasa, zaidi ya hapo awali, watumiaji na wafanyabiashara sawa wanatarajia mashirika kujibu maombi yao ya huduma kwa wateja kupitia njia za kijamii.	Now more than ever as companies and organisations look to the future, they are going to look to analytics to help them charter their way.
Na ikifikia hapo basi ujue tu kwamba wanawake huwa wanaadhibu kimyakimya...!	and war being you know, just people going to war...
Nini wateja wetu wanapaswa kusema	What our users have to say.
Mnamo 2001, katika kesi kubwa ya kihistoria, takribani kampuni arobaini za dawa ziliacha kupinga sheria iliyoruhusu dawa za bei nafuu za Ukimwi kuuzwa.	In 2001, in a landmark case, nearly 40 pharmaceutical companies ended their challenge to a law that allowed cheaper versions of AIDS drugs to be sold.
Hilo y contrahilo	This is a contrast between
A ndogo mizabibu kwamba ulianza 1121.	Some have had the code beginning with 2111.
Inatumika kufungia yaliyomo kwenye YouTube.	Is being used to de-block content from Youtube.
Mwingine katika Picha ni Kingunge Ngombale Mwiru.	Another one is wall-hanging stick.
Lishe duni ndio tatizo kuu linalokwaza afya za wanawake katika nchi maskini.	Cervical cancer is an important health problem in women living in developing countries.
Kika Nicolela (BR)	Please Forgive Me (S)
Vipi basi tutajiandaa kwa mwezi huu uliobarikiwa?	Just how are we going to do Thanksgiving this year?
Uchunguzi wa matibabu umethibitisha kuwa Pregabalin hutoa matokeo bora kwa watumiaji wake wote wanaofuata maagizo ya kipimo.	Studies have shown that yoga offers a variety of benefits to those that live with cardiac disease.
Mwanawima: (Kimya anaona aibu hata kuinua kichwa chake.)	Baby Michiko: (he hiccups and stills as if he was in shock himself).
Hivyo ni kawaida sana kushuhudia biashara ya vyakula mtandaoni ikikua pia.	It stands to reason that the number of merchants selling products online is also growing.
Na wala wasiyatilie shaka hayo walio pewa Kitabu na Waumini.	The Scriptures are replete with admonishments for believers to persevere.
Naoki Wako - Wikipedia	Here's your mule - Wikipedia
Nikiwa na mke wangu, Janette	my wife, Janette.
Mimi nitarudi baadae. . . . . .	I will go back . . .
"Wanaume hao wawili ni malaika wenye kuvaa miili ya kibinadamu, wanauliza hivi: ""Wanaume wa Galilaya, sababu gani munasimama na kuangalia katika anga?"	"Two men in white (angels in disguise!) ask them, ""Why are you men from Galilee standing here looking up into the sky?"""
ni wanawake na wana mioyo myepesi sana kusamehe	Men and women with mild to moderate
Usije mtapisha baada ya kumpa maziwa.	And don't let out water after weeding.
Post yoyote itakayo ongezwa yenye link ambayo inatoka nje ya tovuti hiyo itakuwa na matangazo automatically bila mimi kufanya kitu kingine chochote.	There is a news feed at the bottom of the page that's automatically populated by news from Google, but I won't be manually adding anything.
Behind the scenes: muziki ubunifu	Behind the Scenes: The Music of Films
Nini iwapo, baada ya shule	How Are You Doing, After School
Sasa wanatakiwa kupiga 3 goals more vinginevyo wameula wa chuya!	Now they've added three more deadly bats.
Teknolojia mpya zinahitajika kujaza pengo hili, na haraka.	Financial institutions need to find a way to access this new technology and incorporate quickly.
"""Tuna kazi nyingi za kufanya ili kujenga upya uaminifu"" aliwaambia waandishi wa habari."	"""We have a lot of work ahead to rebuild trust,"" Ms Marin told reporters."
Ikumbukwe mama huyu anasema alikuwa na hamu sana na mume wake.	reminding her family that she is proud of her grandfather.
upendo At First Sight (One-Shot)	Love at first sight (hopelessly)
Usikimbie nafasi ya Diploma na Elimu ya Umbali	don't have a diploma in social engineering
Yaani kuna kazi kubwa sana.	That means there is a lot of work.
Baahubali 2 4th Day Hindi Collection: 35 Crore	1st-day collection of Thugs of Hindostan: 52.25 crores
Mfaume Mlawa, Hasa (1)	Sex Thief, The (1)
Amepigana vita ipi hapa nchini?	What kind of battle was fought here?
"Kwa kweli, tulihisi ndani yetu wenyewe kwamba tulikuwa tumeipokea hukumu ya kifo."" - 2 Wakorintho 1:8, 9."	"Indeed, we felt that we had received the sentence of death"" (2 Corinthians 1:8-9, ESV)."
Mwenye Nguvu wa Israeli, asema hivi:	the Mighty One of Israel, says:
Hiyo ndiyo Serikali na hivyo ndivyo tulivyoahidi.	That is what our government promised, and that is what we are going to do.
Mimi siombi kwamba uwatoe katika ulimwengu; bali uwalinde na yule mwovu.	I do not ask you to take them out of the world, but to guard them from the evil one.
Hata hivyo bado hajafanya uteuzi wa mawaziri katika wizara nne ikiwemo wizara ya fedha.	She formerly led four ministries in the Norwegian government.
mimi zaidi.	I is more.
"UTAJIRI WA NENO LA MUNGU ""Mwisho wa Mambo Yote Umekaribia"""	"The Bible says ""The end of all things is near."""
Ni data gani inapatikana katika dashibodi yangu ya mshirika?	What comics are listed in the database?
kwa pamoja katika kutekeleza jukumu hilo kwa pamoja, pamoja na mashirikiano	carry out this priority by collaborating with one another and with
Rais Deby alitwaa madaraka kupitia mapinduzi ya kijeshi mwaka wa 1990.	Déby came to power through a rebellion in 1990.
Kuuweka kwenye mafuta, ni uamuzi mzuri.	Running water is a good choice.
Tutajaribu kumaliza msimu vizuri kadri tutakavyoweza.	We try to keep the heat out as best as we can.
Ikiwa Faatwimah mtoto wa Muhammad ameiba basi nitamkata mkono wake)) [Al-Bukhaariy]	"""should the enemy declare samad is dead! i will put my hand..."
Nilisafiri kotekote nchini, mara nyingi nikitembelea makutaniko yaliyo mashambani.	I have travelled all over the globe, often to exotic places.
My Shisha (@myshishastwendel)	hhhhhhhhhhhhhh:)))) mesh tsadgy
anataka iwasaidie watanzania.	He wants to help the Filipinos.
Hapa sijasema ni kama boflo msije mkanitupia marungu.	I'm not talking about living like a monk.
kila kilichomo duniani, yaani tamaa ya mwili, na tamaa ya macho, na kiburi cha	all that is in the world, the lust of the flesh, the lust of the eyes, and the
Unataka Kupata Habari Mpya?	Do you want to get news?
Nini anatafuta katika hiyo internet?	What they are looking for on the Web?
Tuliwaona wakiliteketeza moto gari.	We saw them set fire to it.
Angalia migahawa yote ya San Jose, CR	See all homes in St. Joseph, WI
Lakini waumini wengine hata nauli hawana, wamechoka ile mbaya!	And even those who believe in Evil must do so for a reason.
Hawa ni wanasiasa katika Landtag kwenye jimbo shirikishi.	These are local parties in the Libertarian Party of Arkansas.
Lakini Yusufu hakufa.	But Joseph wasn't through.
Kwa nini kwa mfano TV isiitwe tu TV na badala yake wanaitwa eti Luninga?	Why don't they just call it something other than Cartoon Network?
Kuhusu Magharibi na sio dhidi ya Magharibi.	were for Eastern Europe and not against the Soviet Union.
Inaweza kuwa chini ya hapo na si vinginevyo.	It can be both and be beyond.
Ninatafuta nafasi ya kazi ihusianayo na sheria au huduma za kisheria (kuanzia mwezi August 2011)	I have good access to community resources or activities (2019)
"Fanyeni hivi, kila mnapokunywa, kwa kunikumbuka."""	Drink of it, all of you in remembrance of me.
Ndio unavyoongea hivyo au unamlegezea nani hapa?	"Who told you about that, or were you there?"""
Yaani Madhambi yoyote ni Mali kwao	Every damn thing amounts to them.
Ewe Roho Mungu ndiwe uliyewapa waumini vipawa vyako kwa kadiri unavyotaka.	God has given you the spiritual gifts you need.
Uchunguzi wa kitaifa kuhusu visa vya ukatili dhidi ya wanawake umeanzishwa kama alivyoamuru rais.	The National Violence Against Women survey found that the user level.
365# Ni Kutamu Sana Kwangu	#366 is a true story
Sote tunapaswa kukumbuka kwamba hatukuzaliwa na ujuzi.	Deep down we all know we were not born to suffer.
Atajaa moyoni na mwazoni mwako kuliko kawaida na wengine.	They see their mind and soul as superior to everyone else.
waende tu. wakimbie. we dont care.	Just walk in and we will get you taken care of.
Nyota huyo wa Ureno pia amepokea ombi kutoka kwa klabu yake ya zamani ya Man United na mchezaji huyo mwenye umri wa miaka 35 anataka kurejesha ufalme wake pale Old Trafford, ingawa inategemea kama United itafuzu ligi ya mabingwa - Diario Gol.	Ronaldo has also received a proposal from former club United and the 35-year-old wants to restore the glory days at Old Trafford, though it depends on UEFA Champions League qualification.
Wengi wanalaumu kila hatua.	Each gives a lot of support to each step.
Ndiyo, Phen375 meli mahali popote duniani.	Yes, 5 HTP ship anywhere in the world.
Unachotakiwa kufanya kupata akaunti inayokufaa	What you need to create a good information
Sehemu nyingi za kukaa San Bartolo District:	Below are the San Marino Village public school districts:
Mungu amenipigania... Kama si mkono wa Mungu nisingefika hata hapa nilipo.	My prayer stopped there - as if I don't even deserve God's help.
"Kwa hiyo ni uhai wako kwa uhai wake, watu wako kwa watu wake.' "" 43 Kwa uchungu na hasira, mfalme wa Israeli akaenda kwenye jumba lake la kifalme huko Samaria."	"your life will be exchanged for his life, and your people for his people.'"" 43 Sullen and angry, the king of Israel went home to Samaria."
"Akamwambia, ""Bwana, kama ungalikuwapo, ndugu yangu hangalikufa."""	"him, ""Lord, if you had been here, my brother would not have died."""
Hakuna anayenunuliwa hata mmoja.	Not one of them was bought.
Kwa hivyo ikiwa unataka kuvuruga kitengo, unafanyaje?	If you want to get jacked, how do you do it?
Waambie waache kugombana.	You ask them to stop fighting.
Mnamo 11 Septemba 2011, al-Saadi alikimbilia nchi hiyo jirani ya Niger, ambapo serikali imeamua kumpeleka kwenye mji mkuu wa Niamey na kumshikilia.	Al-Saadi Qaddafi fled to the neighboring country of Niger in September and the government there has given him refugee status.
Hakikisha kuangalia kwa Michezo ya Michezo ya Kubahatisha kwa Viongozi wetu bora wa Mods kwa wahusika wa 150 + kwenye Galaxy ya Star Wars ya Majeshi ili kuhakikisha kuwa orodha yako imara iwezekanavyo.	Join the legions of players who turn to the AS-50 shuttlecock to maximize their level of play on the court.
Go Juu Lisboa View	View from the top of Lisbon
Mahakamani pia.	Judges as well.
Kwa hivyo yeye kwa nguvu zote juu ya bahari na dunia analia kama kishindo cha simba: akisababisha ngurumo saba kusema.	He placed his right foot on the sea, and the left on the earth, and cried out with a great voice, as a lion roars; and when he cried out, seven thunders uttered voices of their own.
Hivyo, ni vizuri kuacha mara moja kusikiliza wimbo usiofaa.	It is advisable to deal with ending music.
Wojciech Szeczesny amepoa jeraha kama hilo na sasa anatarajiwa kurudi katika goli	Bryzgalov was willing to retire, but he's happy in Anaheim
Siamini kama kuna mtu anapenda ubaya	I don't think anyone is anti-love
Wote mbwa na maskini walikuwa nje ya lango.	Rich and poor were all in the fold.
Jioni, imeshuka 10.68KM.	On the evening, slipped 10.68KM.
Bora zaidi ya mafanikio ..	The most successful..
Skye Alitupa	St. Paul gives us the
kama si kwa Drift aimlessly.	Not to wander around aimlessly.
"Anasema tu kwamba waliitwa ""Wakristo. """	"They were simply called ""Christians."""
Mashambulizi ya Fateh al-Sham yametishia kuyaondoa makundi ya FSA, ambayo yamekuwa yakiungwa mkono na nchi zinazoipinga serikali ya Assad kama vile Uturuki, Marekani na Ghuba ya Kiarabu.	The attack by Fateh al-Sham had threatened to wipe out the FSA groups which have also received backing from countries opposed to Syrian President Bashar Assad such as Gulf Arab states, Turkey and the United States.
Taifa lilipoteza fedha kiasi gani kuagiza mafuta including capacity charges za wamiliki mitambo ya kuzalisha umeme?	What is the contribution of the developed nations to the climate catastrophe, including the burning of the Amazon?
Kabla ya kufunga kamera, unaweza kushangaa maswali kadhaa ya kiadili na ya kisheria.	Before purchase a machine, maybe you have a lot of questions and confusion.
Vikundi na watu hawa mara nyingi huhitaji mikopo ili kuendeleza mitaji ya biashara na shughuli zao.	Organisations often need to procure goods or services to support their business.
Shule ya Starehe yadhihirisha kwa nini utundu shuleni ni nadra	A professor at King's College explains why the terrorism of Nusrah is not that bad
Nimemwona wakati anaingia gesti	I saw him when he toured
"""Baada ya kuelimika kuhusu kuwepo kwa Mwenyezi Mungu, sikijui kitu kingine bora zaidi kuliko Swala."	After enlightenment of God's Essence, I do not know anything better than The Prayer.
mimi nakupenda wewe English	Te amo in english
Simulizi kuhusu watu, simulizi kuhusu maisha.	A story about life, a story about death.
"""kwanini unaongea hivyo sesi?"""	"""Why are you talking like that to me?"""
90% ya malalamiko haya yanahusiana na ziada au yanahusiana na malipoingen.	95 percent of the cases are pertaining to complaints/appeals.
Daktari wao aliwaambia watapata 'ujauzito na Krismasi'	"Doctor says he met the Santas ""last Christmas"")."
Kwani hamjui hapo Korea Kusini kuna ngome za kijeshi za Marekani?	You know that the Northern Mariana Islands are part of the United States?
SERIKALI ya Chama Cha Mapinduzi imebobea katika kufanya maamuzi tata.	The call centre rep was empowered to make decisions.
Naamini katika ahadi.	I believe the promise.
Huenda angeweza kuwa msaada mkubwa kwangu.	He might have been a big help.
Guess ya feel kinda inadequate????	Try to remember the unstressed e
Jitihada za kupambana na kirusi cha corona nchini Iran.	protests against the persecution of the Jews in Russia.
huwezi kufanya ahadi anayependwa unfulfilled.	You can't break a promise to a dead friend.
Mara nyingi mama alisikika akisema kwamba alingoja	My mother had often declared that she would go
Sajenti Arobogast: Siku mbili, tarehe 26 na 27 Machi 2015.	Playing two nights: November 26th and 27th.
Kweli ukioa au kuolewa mnakua kitu kimoja...hii kali	When you're married and you're happy you just ... you gain some weight.
Wakili Kibatala: Alikuuliza chochote kuhusiana na watu kutekwa?	"""Question: Did he ask you a number of questions concerning the application?"
Kwa mfano, hapa Tanzania kuna mambo yaliyodaiwa na Dk.	For example, two of Denmark's political parties are represented in the ALDE group.
MRADI mkubwa wa maji Madaba utakavyomaliza kero ya maji kwa wananchi	An ultimate goal that the discharge of pollutants into Puerto Rico's waters
Nini kinaweza kueleza tofauti hizi?	What may account for these differences?
Je, huyu Roho wa Mungu ni nani?.	What Is God's Spirit?
inaweza kusababisha impasses vilevile.	It may also cause cramps.
Tanzania Hy-Vee Food Stores News	Stoke-on-Trent City Council news Feed
hii kabla hata sijaingia ndani ishakuwa ndoano!	This is before I've even committed to an order!
wawe na uzoefu huo kwa kipindi kisichopungua miaka kumi na tano;	have a Birth Certificate that is not less than a year old;
Teknolojia ya kisasa itafanya iwe rahisi kuunda haraka ofisi inayofanya kazi kikamilifu.	A practice which takes full advantage of modern technology will facilitate prompt service.
Nadhani tulikuwa tunafika watu wanane.	I think we went to about 8 countries.
Mambo ya Furaha Kuhusu Dada	Christmas wishes for little sister
Wafanye wengine wakuone kuwa mtu wanayeweza kumfikia katika hali walizonazo.	Other people perceive them as someone who can take control over the situations.
Hakuna Matata Lion King Ukulele Tutorial Youtube	the lion king i just can't wait to be king lyrics youtube take
Walengwa wakimsikiliza Naibu Waziri kwa furaha	lips were greeted with enthusiasm
Au yatakayo kufanya usisimame imara kwa Mungu.	Or you are longing for God.
How would wewe tell Jacob wewe upendo Edward?	Would you like to know how to translate jack up to German?
Makala inayofuataSekta ya ujenzi Hesabu za Nusu ya kazi hatari zaidi huko Merika	Law Enforcement Among Top 15 Most Dangerous Jobs in the U.S.
Ukitazama picha hii, inabidi ufikirie.	When looking at this map, this is something to consider.
Angalia ukurasa wa shabiki wa Facebook wa YATS!	Take a look at Krishna Kaul's social media posts!
Then am sorry kwa uzi Mrefu i hope mtajifunza kitu!	So that's a fairly big thing to learn, I hope you'll agree!
Kumekuwepo na wasiwasi kuhusu athari ya uraibu huo kwa vijana.	Concern has been expressed about the weight gain among youth.
Aidha katika hotuba yake ya ufunguzi, Mhe.	In his victory speech, hon.
Lakini hata hivyo waliipata na watakuwa wamejifunza na wamepata somo kubwa sana kuliko walivyokuwa wakidhani.	They saw and learned much more than one might have expected.
Na avatar yake itakuwaje?	And what is going to be his fate?
Bi Verdiana Mizengo,akitoa ufafanuzi katika moja ya majukumu ya jinama vijijini.	Hold the Shift key and define a region in one of the images.
Alisha Driver	The alsa driver does.
MT 9:33 Mara tu huyo pepo alipotolewa, mtu huyo aliyekuwa bubu akaanza kuongea tena.	Matthew 9:33 When the demon was cast out, the mute man spoke.
Nini kama unataka kufanya kazi na kampuni inayofaa niche yako lakini haitoi fursa kupitia ushirikiano wako uliopo?	What if you want a good marriage, but your spouse is not cooperating?
Jinsi ya kulisha msichana mdogo kupatikana nyumbani?	How do we make a foster child feel at home?
9:00 PM Habari za Kitaifa	At around 4:00 pm the National
Na walianzisha kujitandaza, kutoka katika jimbo hilo.	So they began moving out to the suburbs.
Wananchi; huo ndiyo ukweli kwamba ilifanywa makusudi kubadilisha mambo.	rights movement; they were people who wanted social change.
Angalaka anao Shyn	Or at least stinky.
thawabu za kuzidia mara nyingi, ni kama hali ya mwenye kuatika punje moja	identity theft are frequently the result of single-factor
20 Na tazama!	20 looked at.
Helikopta za jeshi la Marekani na jeshi la Singapore pamoja na walinzi wa pwani, wanafanya shughuli za uokoaji.	A number of fishing vessels, along with Russian and the United States coast guard helicopters are assisting with rescue operations.
Ni jambo jema kwa chama.	It is suitable for the party.
Labda umeshindwa wakati fulani au mwingine katika maisha yako.	You might have failed at some point or another in your life.
Lakini leo nitatilia mkazo maombi.	But now I feel the pressure.
Nitayasimulia matendo yako yote ya ajabu;	I Will Tell of All Your Wonderful Deeds.
Kufuatia upungufu huo, Serikali kupitia Wizara ya Fedha na Uchumi ililazimika kuomba msaada wa dharura kwa nchi wahisani.	After the flood, the then Congress-National Conference government sought a financial assistance of Rs.
Sisi kama familia, tunaamini Mungu yuko	We are a family who believe in God.
Asante kaka ,umenifungua sana	thank you very much , you saved me
Tumia kila aina ya trafiki unayotaka kukuza.	Use an appropriate planting method for each type of food you're trying to grow.
"""si nilikwambia ukabisha??"	"""Have I not obeyed you?"""
"""Sisi ni ndugu na hapana tofauti baina yetu."	We are not brothers and we are not one.
Kumbuka kutuma namba yako ya simu kwa ajili ya mawasiliano.	Remember, you need to set up your phone for email.
Hakika wewe ni muonyaji tu, na kila kaumu ina Kiongozi.	Say, you are only a warner and for every generation there is a guide.
"""Je, ungependa nimwite daktari?"""	"""You want me to go get a doctor?"""
"Nataka kila mmoja aliye hapa abaki, lakini chochote kinaweza kutokea hadi Agosti 31,."""	"""I want everyone who is here now to stay... but anything can happen right up until Aug. 31. """
Ripoti hiyo inaonyesha idadi ya watu imeongezeka kwa watu milioni saba katika mwongo mmoja uliopita.	The population has hit more than seven million over the past one decade.
Polisi waligundua kuwa mkuu huyo wa IMF alikuwa katika ndege uwanja wa JFK ikiwa tayari kutoka nje ya nchi.	We're told by law enforcement authorities that he was arrested at JFK Airport trying to get out of the country.
Je waweza kuidai ahadi hiyo?	Are you going to be able to keep that promise?
mashabiki wanachagua: Indiana Jones Temple of Doom	The fans pick: Indiana Jones and The Temple Of Doom
"""Punguzo hili litakuwa chachu ya kuwavutia wakuliwa na wadau mbalimbali na litaanza kutumika kuanzia Februari 20, 2020"" amesema Hasunga."	"""At this time, the only confirmed positive cases are staff members and they have been in isolation since September 20, 2020,"" Burt said."
Kampuni nyingi za kimataifa hufanya uzalishaji katika mji wetu.	Many global companies operate in our nation.
Ni methali ambayo inatia matumaini kwa watafutaji na waliokata tamaa.	This film is a hope for those who feel demotivated and dejected.
Naamini kuna figisu na msigano fulani katika halmashauri ya Bukoka.	I do think there are pros and cons to the simulator.
Jambo hilo la Kiislamu linaonekana zuri huko, pia.	The fishing is notable here, too.
Ingekuwa safari ndefu isiyo na sababu yoyote.	It would have been a lot of work for no good reason.
Ni wakati wa kuleta ili nyumba ya wafungwa wa kifalme.	time to build a county jail.
Usikose sehemu ya pili na ya mwisho ya makala hii.	Don't forget first and second step of this article.
Ninakuamini na neno lako.	I trust you and your word.
"Walt Disney karatasi la kupamba ukuta from ""The Little Mermaid"" (1989)"	"Walt Disney Screencapture of Flounder from ""The Little Mermaid"" (1989)"
Watoto wa kiume wa marehemu katika picha ya pamoja.	Young men in group portrait.
Waumini hao walipoulizwa kuhusu sehemu wanapolalala, walijibu kuwa Mungu ndiye anajua wanapolala hata wao hawaelewi.	But if God tells them that He will rescue them, and they believe that, they have chosen what cannot be known over what is certain.
Ecocoast ilianzishwa kwa usahihi kuzuia uharibifu na uchafuzi wa mazingira katika ukanda wa pwani na njia za maji, na kwa miaka kumi iliyopita, sisi, pamoja na tanzu yetu Bolina, tumetengeneza teknolojia anuwai na zinazoongoza kwa tasnia ambazo zimeonyeshwa kupunguza uchafuzi wa maji kutoka shughuli zinazohusiana na ujenzi.	Ecocoast was founded precisely to prevent damage and pollution to our coastlines and waterways, and over the last decade, we, as well as our subsidiary Bolina, have developed a range of innovative and industry-leading technologies that have been demonstrated to reduce water pollution from construction-related activities.
Binadamu hupotoka, huonesha udhaifu,	When removing people, change the passphrases
Vitunguu vinajulikana kwa mali zao za faida.	Carrot is well known for their health benefits.
Tupo hapa kujuzana yale tusio yajua..	Here we become aware of what we don't know.
Ninataka kuamini kuwa watoto wangu wanaweza kukua bila ya kuomba msamaha kwa kuwa weupe.	I would like to think that I can make a change so my sons don't grow up to be whiny bitch excuses for men.
lakini huyu dada ataka nn wakati ana kwake?	Or is it that she's only charming when she wants to be?
"Katika video hiyo, Princess huyo anaonekana akimshitaki baba yake kwa ""kumteka"""	"In the picture, he was looking at his daddy saying ""cheese."""
"24 Kwa hiyo Yoabu akaingia kwa mfalme na kusema: ""Umefanya nini?+ Tazama!"	"v.24 So Joab went to the king and said, ""What have you done?"
Ni ngumu kuikubali hali hiyo lakini ni mapenzi ya mungu.	It is a complicated journey.. but it is God's will.
Hii ni nguvu video converter ambayo ina mbalimbali ya faili compatibilities.	This is a powerful video converter that has a wide range of file compatible.
ni mwokozi wenu.	He's your Provider.
c) Fafanua umuhimu wa msemaji wa kauli hii katika riwaya hii. (alama 8)	(c) provision about the interpretation of this Chapter (see section 598).
Watu wangapi wanaopenda kutaja umri wao waziwazi?	Many people love to talk about their childhood.
kutosha wachezaji wetu hivi sasa ije timu yeyote tuu sisi sawa	Let's keep the free for all going until we really have a winner
12 Basi Hiramu akatoka Tiro kwenda kuyaona majiji ambayo Sulemani alikuwa amempa, nayo hayakuwa sawa machoni pake.+	12So Hiram came out from Tyre to see the cities that Solomon had given him, but he was not pleased with them.
Ninavyofahamu sekretarieti ya utumishi wa umma hawahusiki na ajira za private sector so sidhani kama wanafanya kazi hiyohiyo ya TAESA.	I have no problem with benchmarking against comparable jobs in the private sector if it involves resultant pay reductions.
Ameshinda tuzo nyingi, na amekuwa mmoja wa wasanii wa kulipwa maarufu zaidi.	He has overcome many challenges and has become one of the best batsmen of his time.
Mapigano yaingia siku ya nne nchini Nigeria	Fourth military coup in Nigeria.
"""What ya want, kid?"""	'What do you want, kid?'
Habari ya asubuhi Mwanamafanikio.	morning's successful agreement.
Kuweka nafasi tena ilikuwa ndogo, na kwa sababu ya maumbile ya bidhaa, upepo haukuwa shida kutunza blanketi kwenye kaa.	There were also a lot of mosquitos and keeping the windows closes was not an option because of the heat in summer.
Ilikuwa safari ya masaa kama saba.	It was a journey of 7 hours.
Kisha iache pembeni ipoe.	Then, he moved around to the adjacent side.
3 Yeye alijenga lango la juu+ la nyumba ya Yehova, naye akafanya ujenzi mkubwa katika ukuta wa Ofeli.+	3 It was he who built the upper gate of the house of Jehovah, and on the wall of Ophel he built much.
kweli hasa hiyo picha ya kwanza.	It's actually the first photo.
Nafanya hivi kwa sababu nawajali.	They do it because they care about me.
Na wewe huna pesa ju utaenda jela	Without money you're in prison.
hakuna kilichofanyika katika miaka 54 ya Uhuru.	There has been no hostile action in Korea in 54 years.
Tena bado nguvu yao haijaonekana hasa subiri tu.	Their arrogance isn't even thinly veiled anymore.
Mkuu usikurupuke hao kinadada walijiita wenyewe hilo jina.	night when the policeman said to use it.
Yote haya yamejikita katika hali nzima ya mwanamke kutojiamini na kutojithamini.	The whole thing has been so obnoxious and devaluing of women.
"""Sitaki kuwa kahaba tena, nimefanya biashara hizi kwa miaka saba sasa na siwezi kumbuka ni wanaume wangapi nimeshiriki ngono nao "" Mwanamke huyo alisema."	"""In the past seven years, I can count on one hand, and still have leftover fingers, how many instances I've seen of this"" kind of issue, he says."
News _ Hakuna Casting	• It's non-caustic
"""Unaonekana kuwa na pilikapilika nyingi, kwa nini hujionei huruma mpenzi wangu?"	"""You look like a bum, why are you with my daddy?"
Sioni hata pointi yako hapo...huyo ni Mtoto wa kizungu na analiliwa na Wazungu wenzake kwa matatizo ambayo hajajitakia, nadhani wana haki ya kufanya hivyo.	I think the unborn baby does have some rights but a born living child.....Not sure you can say they are equal.
Muda ulisonga mbele na bado sikuwa nimepata dini inayo onekana kuzungumza na moyo wangu.	Time ticked by and still I had not found the religion that seemed to speak to my heart.
"Mtume (s.a.w.w.) aliwaambia: ""Sikuja kupigana."	The Prophet replied, 'I did not give
Mungu azdi kukutumia na kukuinua.	God wants to heal you and help you.
Mimi si kushoto wewe wakati mimi kuvuta mbali.	I hardly live when I am away from you.
Hester Udani	Hester is ungrateful.
Ningependa kukujiunga Lakini laptop Sina je sitoweza kukuiga?	I would love to purchase your app, but I don't have a smart phone that can use it.
Ni kitunguu tu nikatapo	It's only when I blow
"""Baadhi yenu mnatuambia kuwa,"	A lot of you tell me that:
kama hatutendi dhambi.	Whereas we do not sin.
2) Bima ya afya: Wamiliki wa elimu ya OAD wanahitaji kuwa na bima ya afya ambayo inakubaliwa na mamlaka ya Austria kwa muda wa kukaa yao huko Austria.	Health insurance: OeAD scholarship holders need to have health insurance that is accepted by the Austrian authorities for the duration of their stay in Austria.
Programu ya elimu inalenga watu ...	The educational program encourages ...
Kama inajulikana, ndani ya siku 14	synced in 14 days
Kusoma ni hatua ya kwanza.	In fact, reading is the first step.
"Msikiogope kifo, kwani yeyote yule aogopaye kufa, hupoteza heshima."""	Do not seek to save your lives, for he that is afraid to die for the truth, will lose eternal life....
Neema ya kuwa na njaa kila wakati ya vitu vyako.	Freedom from worrying about food all the time.
Uje huku wewe kibendera Njoo ujibu hii	Get home and trying to get this recipe
Tukirudi kwenye swali lako la msingi.	Let's go back to your original question.
Hatujaambiwa zimefanya nini.	We are not told what they did.
Hatumi Kudo 3some fuck	No can be dumped from a 3DS
Nami hufurahia kusoma vichapo vya Watch Tower Society.	I love to read the JW publications.
hahaha saje je boring la nick tu	-Full House is currently airing on Nick at Nite
"alfajiri: ""Hizo ni bora zaidi kwangu kuliko dunia yote."""	"Many times he told me, ""This is the best country in the world."""
Rais alikuwa Waziri kwa miaka 20, mimi ndiyo kwanza mwaka wa nne...bado najifunza!	She's been working as an aide for the past 20 years, I'm in year 4, but it doesn't matter, I am the teacher.
Lakini tulitaka kuijua Michigan.	We wanted to do it for Michigan.
huo, ni bora kuingia kazini na	It's a matter of going there and working
hizi linaunda Jamhuri ya San Marino.	and encircle the republic of San Marino.
Karibuni...sana..tusherehekee Pasaka ya Bwana...	In ________ number of weeks we will be celebrating the Lord's Supper again.
na mazizi ya kondoo.	through the sheep.
Tunarudishaje ambacho hamjakinunua?	How do you sell what you don't have?
Ni miongoni mwa walioshiriki kwa namna moja au nyingine katika mkutano wa kidunia wa haki za mwanamke, maarufu mkutano wa Beijing mwaka 1995.	She was one of the invited speakers at a All-Women Forum held in Penang recently.
Aidha, tunapenda kuwashukuru	Likewise, we would like to thank
Hii ziara ilikuwa ya MAFANIKIO saana kwangu.	The trip was hugely successful for me.
Watu wamekuwa wakifanya kazi hapa kwa miaka 30 kwa suluhisho.	Consultants have been working on this for 30 years.
Hakuna maana katika kujaribu kuificha.	Not worth trying to figure out.
Ameacha kazi kubwa sana ya kumalizia, h ...	He's lost his dead-end job, ...
China hawakuwa na yoyote kubwa ya mahusiano na dunia mpaka.	Bush didn't have a good relationship with Iran.
Sikiliza Kwa Wahenga Main Title	Voice cast for the main characters
Kubainisha na kuvitumia katika sentensi	arresting and prosecuting them
Upendo na amani vitawale mioyoni mwetu daima!!	Goodness and Peace in Your life forevermore!!!
"LK 13:6 Kisha, Yesu akawaambia mfano huu: ""Mtu mmoja alikuwa na mtini katika shamba lake."	"Jesus told this parable in Luke 13:6-9: ""Then he told them a story: ""A man had an apple tree planted in his front yard."
Umaskini sio mpango wa Mungu.	The suffering that comes through poverty is not God's plan.
Hii sio mara ya kwanza kwamba McGregor ametangaza kustaafu kutoka katika mchezo huo.	This is not the first time that McGregor has announced his retirement.
Nimezingatia siku za zamani, Miaka ya nyakati za zamani.	I have pondered the days of old, The years of ancient times.
Alikuwa hana fedha za kutosha, na alikuwa hana ujasiri wa kutosha.	He had no money, and little backing.
Mimi ninatoka Amsterdam.	I am travelling from Amsterdam.
"""Daktari WST si mjinga kiasi hicho."	"""Maple Leaf doesn't need the money."
Mi najua kuhusu notary public.	I know about public domain.
Menyu ndogo itafunguliwa.	Their little ones will be dragged off.
Unaweza kufikiria jinsi ilivyo chini?	Can you imagine on the above.
Nashukuru mkuu majimoto, nimetoka Brela muda si mrefu!	Thank you for the recipe, I have been craving Pudin for a very long time!
Haiwezi kujitenga wakati YHT itaanza	It's immutable once the JVM starts.
Ni bahati kuwa tunao watu wa aina yake katika blogu.	It is a great opportunity to have people like you in the BlogoSphere.
Ilikuwa mara nyingi shule zinajengwa ovyo ovyo.	Often groups were formed to practice.
si ndio amekuja kujifunza.	It was not to learn.
Huyo rafiki yako anayeomba kuzaa na mumeo si ajabu wana uhusiano wa kisirisiri.	The fact that men want someone with whom they can be free emotionally isn't a surprise.
Mugabe awataka wafanyabiashara kupunguza bei za bidhaa.	He demanded the owners to lower the prices.
Faida za muda mfupi na muda mrefu wa kila maamuzi atakalofanya	Evaluate the short- and long-term implications of every decision
Jawabu: Hukumu ya kutoa Zaka ya nafaka na matunda ni wajibu, kwa kauli ya Mwenyezi Mungu Mtukufu:	Here is a gracious promise for the season of conflict and trial - a promise, oh! how often realized by the children of God.
ukipata wastani kuliko ulivyotarajia, pengine umekuwa ukipata kidogo kuliko	On the other hand, if you earned less than expected, you may have been
Muhammad (amani iwe juu yao wote) Hawa wote walitumwa kwa jamii zao wakiwa na muongozo wakiwafundisha watu yote anayoyataka yeye (Muumba) pia asiyoyataka.	Prophet Muhammad (Pbuh) commanded knowledge upon all Muslims, and urged them to seek knowledge as far they could reach, and also to seek it at all times.
Umekuwa chakula changu nikupe nini?	What you've fed to me?
Muungwana yeye ni mtu wa matumaini siku zote	A girl who's for real all the time
Bahia Hotels Bathinda	azealia banks is back
Nambari ya simu inatakiwa iwe na 10 tarakimu.	Phone numbers must be 10 numbers.
fubuki my waifu	I'll kill my darling
Kwa hivyo tunataka kuwa kliniki ya wataalamu isiyo ya faida - na kutenda ipasavyo.	So we are a non-profit specialist clinic - and act accordingly.
Watu wengi wanakesha usiku kwenye TV au katika mambo mengine.	The one everybody watches on tv or other media.
Marley and Me Kura Za Maoni	Me and Keith and a couple of other people
Somo 15 - Usiyeonekana na uliyo mjuvi	156 Teaching What You Don't Know
Ni huzuni tu	it's only pain
Dah Mwanang unajua.....Nimekuelewa.	Tom Dugan... you know it.
Tatizo ni kwamba watajua kwamba umechukua hatua kama hiyo ambayo sio nzuri sana.	It is enough to say that you aren't yet quite ready to make a decision on such a big step.
Make a Wish _ uNgatawwa	Abridged Version - Wish it wasn't
Asilimia kubwa wanafikiria zaidi kuhusu maisha mazuri yasiyo na mikwaruzano.	The majority of them only wish a better life with no political involvement.
dah wangu mie ni 1st n last lakini hayuko hivyo!	My device is 64-bit but it's not!
Tutafanyaje tufanikishe hilo ni changamoto yetu sote Serikalini.	And this is going to create all sorts of problems for our state.
Nyumba katika Beacon Hill katika Boston.	Houses at Beacon Hill in Boston.
lile ,atapata wapi tena ujasiri wa kusimama	How to Find The Courage to Move On
Engine Comes Alive	The Engine Comes to Life
Sio homerun... hiyo itakuwa wakati tunapokuwa tayari kwa uzalishaji lakini besi hakika zimebeba.	It's not a homerun... that will be when we're production ready but the bases are definitely loaded.
V katika hawezi kuona kuwa sura hii ya Isaya hapo awali utakamilika.	We can not see that this passage from Isaiah ever before have been fulfilled.
Kisha akajilaza kwa kujiegemeza kwenye tumbo la Mwasha huku bado amemkumbatia.	Then she gave up trying to maintain the facade, and she leaned into him.
"""Kunywa sumu yako mwenyewe yaliyotolewa na"""	"""Bring your own soda"""
Mara tu kupona katika kliniki kumalizika, mwanamke huyo hupelekwa nyumbani.	When the trial drugs stopped, she was sent home.
tunakubali OEM & ODM, Kampuni yetu inaweza kukuza na kutoa bidhaa kama wateja mahitaji maalum.	OEM/ODM are welcomed, we can produce products according to your requirements.
Beautiful Images of Anarkali Dress	Close-up view of a beautiful butterfly
Mbio za mwaka huu za Mt.	this year's Mt.
Nimekubali kusoma hadithi yako.	I've read their story.
Si ameomba msamaha kwa picha kushindwa kuupload?	Your problem is that he didn't come out an apologize for having bad information?
Embed mchezo Ambaye anataka Millionaire dunk katika tovuti yako:	who wants to be a millionaire online game says:
"""Wasjifanye wao ndio wanapigana na vita dhidi ya ufisadi."	"""They fight against those who combat corruption."
Na baada ya haya mtakuwa ni watu wema.	And you are, indeed, good people.
Sisi kuwapa nafasi ya kutimiza yako kinks katika dunia virtual ambapo kila kitu ni iwezekanavyo.	The technology allows you to enter a virtual world where everything is possible.
"""Siasa za kisasa za Uropa haziwezi kuwepo bila vyombo vya habari huru na vya uaminifu."	"""Modern education cannot be imagined without the fast and reliable Internet."
wewe umejuaje katumia hizo hela?	How did you learn to use these?
Mwiba acha dini twende kwenye Siasa.	Do not mix religion with politics.
Kwa kupitia hadithi hizi nilipata hisia ya urithi wangu.	It was through these kids that I found my sense of purpose.
Kaimu Rais wake alikuwa John Breckinridge.	His vice president was John Breckinridge.
Aina nyingine mbili za hibiscus ni bustani.	Another type of in-vivo dosimeters are diodes.
Kuimarisha mfumo wa utoaji haki ni jambo la lazima.	The criminal justice system must be strengthened.
Moja ya maarufu zaidi ni ile ambayo tutakuambia hapa chini.	And the best one is what you have pointed out here.
Ni muhimu sana muda wote kulipa mikopo yako.	It's important to always maintain your property.
Hii ndio (ya kupendeza) .......... kitabu ambacho nimewahi kusoma.	"""It""s the [ ði: ] best book I've ever read."""
cha asilimia 0 badala ya asilimia 100 au	Percents Greater Than 100% or Less than 1%
What Is Your inayopendelewa Pokemon Region.	So, what's your favorite Region of Pokémon?
Marekani itajuta kui...	America is going...
Wahimze waumini wende vitani; wakiwepo miongoni mwenu ishirini wanaosubiri, watashinda mia mbili; na kama wakiwa mia moja miongoni mwenu watawashinda elfu moja katika waliokufuru, maana hao ni watu wasiofahamu.	O prophet ! rouse the believers to fight, if there are twenty patient ones of you, they shall overcome two hundred and if there are a hundred of you, they shall overcome a thousand of those who do not believe because they are a people who do not understand.
Hatimaye, mvuke huo hurudi duniani ukiwa theluji au mvua.	Ultimately, the water comes down to the surface in the form of rain or snow.
Kutokana na aya hii ya Qur'ani inaonekana kwamba kubadilika kwa Qiblah hakukufanyika tu kwa sababu za upinzani wa Mayahudi, bali kuna sababu nyingine za mabadiliko haya.	It appears from the verses of the Qur'an that change of qiblah was not due only to the objection of the Jews, but there was also another reason for it.
Watu waliokuwa eneo hilo walishangazwa na tukio hilo, lakini sisi tulijua hiyo ni mojawapo ya kazi za majasusi.	People seemed surprised that we found them, but we knew we found something special.
Mara nyingi inafuata hotuba, halafu ungamo la imani na maombezi kwa ajili ya watu wote.	This often leads to conversations about faith and opportunities to pray for people.
Au ndio tutakula nyasi au kupiga mbizi?	Should we eat them raw or cooked?
Mheshimiwa Naibu Spika, baada ya kuyasema hayo naomba niwasilishe.	Sir, sporyshev and then urged them to know.
Tafadhali kumbuka kwa kila mtu ataweza kupiga kura mara 10 kwa siku kwa kila akaunti aliyoisajili.	3) You need to let everyone know a minimum of 10 times per day that you are on a diet.
Baba, kwa jina la Yesu, enesha enzi kuu ya haki na usawa huko Gambia ili kupata hatima yake tukufu. - Daniel.	Father, in the name of Jesus, enthrone the reign of justice and equity in Mauritius so as to secure her glorious destiny. - Daniel.
Bado ina joto, na inatoa gesi.	It still energizes, and it is still explosive.
Paradiso ikapotea, na hakuna mtu ambaye amefanikiwa kuirudisha.	Paradise was lost and there was no way back.
Nadhani kuna mambo mawili yanayoweza kuwa sababu:	I think there are 2 possible reasons:
Social phobia ni tatizo kubwa sana.	Poverty is an enormous social problem.
Hakika sisi tumemsikia mwenye kuita akiitia Imani kwamba:	We've heard the Force called:
Padre Edward akamweleza yaliyomsibu.	Daner told the investigator that he had borrowed it.
"Ikiwa kwa kweli hawezi kupata ushindi juu yake, basi wakati ule mufalme mwingine angali mbali, yeye anatuma baraza la mabalozi na kuomba amani."""	32 If he can't, then while the other king is still far away, he will send some people to speak to him and ask for peace.
11 Septemba Waongozaji wa filamu wa Uhispania	19th Days of Croatian Film
Kwa hiyo Mbinguni ni nchi iliyopo katika ulimwengu wa roho na utawala wake ni wa kifalme ndiyo maana Mungu ni mfalme wala siyo Raisi.	In the Kingdom one enjoys the presence of God and His heavenly beings, and past sins are forgiven.
Vitakuwa ni virus hivyo	it's the Virus
Akasema: Nikasema: Ewe Mtume wa Allah, mimi hakika naweza kufanya vizuri zaidi ya hivyo.	He said: (then) I'm the most miserable one, O Messenger of Allah.
Unakumbuka Wakati Wale Waombolezaji Wanampeleka Kumzika Mwana Wa Pekee Wa Yule Mjane?	Do you remember the new guy who just moved into the family of ladies?
Mtengano ndani ya Dayosisi ya Kilutheri ya Kaskazini mwa Tanzania - Inventaires et archives en ligne	Art with the South Shore Art Center - Pen & Ink
Serikali ya Korea Kusini inaangalia undani kwa taarifa zilizoripotiwa na Vyombo vya Habari vya Marekani kuwa Kiongozi wa Korea Kaskazini, Kim Jong Un ana hali mbaya baada ya kufanyiwa upasuaji.	The United States is looking at intelligence reports that suggest North Korean dictator Kim Jong Un is in serious danger after undergoing a surgery.
Ila ungetupia na picha ingependeza zaidi	Put a picture, it will be better
a link iliongezwa: BB to be inducted into the Rock and Roll Hall of Fame! zaidi ya mwaka mmoja uliopita by ediebutt	a link was added: BB to be inducted into the Rock and Roll Hall of Fame! over a year ago by ediebutt
sababu lilikhiari njia ya baat'ili, nayo ni ukafiri na uasi!	The way of untruth and lies and falsehood is the way down into it.
Kuna mikono mingi kila mahala.	It is very hands free.
Mama Mia Methodologia	A mother of Methodism
Beers won't hurt ya	The Shoshones won't hurt
Na kwa kuwa bei ya poda ya Lycopene sio juu sana, kwa nini usitumie?	Since the additional cost of a Party Pass is so small, why not go for it?
Watakuelewa basi?	Will they be able to know?
Na ndoa hiyo si nyingine Zaidi ya ile ya ADAMU.	This isn't just another case for Adam.
Hata hivyo, hayakuwa haya ni malengo makuu yaliyokuwa yakiaminika kuwa na athari kwa wenye kuonewa.	They were not the major targets of the Stingers.
Nitumie maoni au mapendekezo yako kuhusu kampeni hii hapa	Share your ideas and suggestions about the game here.
Je, Wewe Ni Muumini wa Kweli wa Mungu?	Are you a true God?
Atlético Madrid ina ulinzi bora katika michuano hiyo ikiwa na mabao 16 yaliyofungwa (pamoja na 7 yaliyofungwa nyumbani) tangu kuanza kwa msimu.	Atlético Madrid have the best defense in the championship with 16 goals conceded (including 7 conceded at home) since the start of the season.
Je eneo liko upande gani wa main road.	located where there is the main road.
Watu wengi wanaoamini Utatu wanasema kama fundisho hilo ni fumbo, yaani, haliwezi kufasiriwa.	Defenders of the doctrine of the Trinity often claim that it is a mystery which cannot be properly understood.
Jolie na Thornton walikuwa mkali pamoja.	Smith and Thorson were very close.
Tyta hata ww waweza kuwa na majibu au idea!	You will be able to get answers and even ideas.
Minimiza tu impacto	solely on the impact
mlango, lakini yote ilikuwa imefungwa.	The door was open, but everything was gone.
Timu yetu ya uhandisi ilifanya mengi kushinda ...	Our development team has put a lot...
Good Riddance watu wa Nyamagana.	A good representation of rock genres.
Garaj Mahal - Live at Kuumbwa	Camembert - Living in the Fields
KW - wake detection	KW - spin dephasing
Tulitumia kwa kutumia betri ya WPA2 ya CMOS kwenye bajeti ndogo.	We made use of the Provençal BBQ on a couple of the nights.
"""Huyu wa kwangu kwa kweli yuko vizuri."	"""My health is really well."
"11 Kwa hiyo niliapa kwa hasira yangu, 'Hawataingia+ katika pumziko langu.' ""+"	"11 So I swore in My anger, ""They will not enter My rest."" a"
Lakini pia kupungua kwa idadi ya wanaopimwa, kuna maanisha kwamba vigumu kupata picha kamili ya jinsi ilivyo.	Also, given the different opinions of fans, it is very difficult to have a perfect list.
Msaada kwa anayefahamu sociology!	favored a society under the control of sociologists!
Ndutu Migration Safari	The Migratory Route
Inakuwa sawa na kuramba matapishi yetu.	This is the same with maintaining our appliances.
This time mtaeleza kila kitu.	This story describes everything.
Barua ya Mark Kuomba Msamaha Kwenye Kurasa nzima ya Gazeti	Title page from An Apology for the Life of Mrs.
Ikiwa uko nje kwa mwangaza mkali, unaweza kutumia jua kama nuru yako muhimu.	If you're outdoors in bright light, you can use the sun as your key light.
AJIRA: Nafasi za kazi Geita Gold Mining Jobs in Tanzania	Comptoirs: the political geography of small-scale gold mining labour in Burkina Faso
So inategemea wewe unahitaji kipi hapo	So it depends on what you want
Siku zile, mitume na ndugu waliokuwako katika Uyahudi wakapata habari ya kwamba watu wa Mataifa nao wamelipokea neno la Mungu.	1 The Apostles and the brothers who were in Judea heard that the Gentiles too had accepted the word of God.
Hivyo, Shetani alidai kwamba utawala wake ungekuwa bora kuliko utawala wa Mungu.	In effect, Satan claimed that his rule would be better than that of the Creator.
Na mt'iini Mwenyezi Mungu katika hukumu	stand in judgment of God.
Hii inapaswa kusambazwa kila wakati pamoja na dhana ya waendeshaji.	This must always be arranged according to the mandate of the victim.
Anadiriki hata kuapa uongo kwa jina la Swaumu!	He's even trying to feed himself with a spoonful!
Hapo mnadanganyana.	In the meantime, you tell falsehoods.
Basi mtu mzima nilijiona mwepesi mwenyewe utadhani nilikuwa najua hata nilichokuwa nakifanya.	By the time I got old enough to do it myself, I knew what I was doing.
Mji ulio neemeshwa lakini hauna fadhila,	The withered towns are empty, but not uninhabited.
Mzee ES na choveki, nashukuru kwa challenging questions.	As someone who has classes, I am grateful for the weekly challenges.
"Kutoka kwa Mtume Muhammad Mustafa (s.a.w.w.) amesema: ""Hakuna Muumini (yeyote) isipokuwa mimi ni bora kwake zaidi kuliko watu (wote) katika dunia na akhera."""	"As an example, the Noble Prophet Muhammad (p.b.u.h.) said: ""Nothing will weigh more heavily in the balance of the believing servant on the Day of Resurrection than a good attitude (towards others)."
Kuwa Bet On hila yako ya Mkono And Win Tele Cash!!	put your name on the list and win prizes!!
"Halikujitokeza wiki chache zilizopita bali lipo tangu mwaka 2000"""	"He hadn't passed away yesterday but two years ago in September 2017."""
Wao ni furaha tu.	But they're just happy.
tusipoziba ufa...	when we stop to die...
Vipeperushi laki moja vilitawanywa jijini London.	One of the ducks was banded in Maryland.
Tatizo la vijana kutumia na kuathirika kwa dawa za kulevya ni njanga la kijamii katika ngazi ya kitaifa na kimataifa.	Prescription drug abuse and misuse is a national and local problem.
Aliacha kijikaratasi chenye ujumbe pamoja na mizigo yake akisema anataka kubaki Japan na kufanya kazi.	He had left behind his luggage and a note saying he wanted to stay in Japan and work.
Alinitambulisha kwa wadogo zake wawili wa kiume, na ndio nilikuwa nawaona.	I've met his two sisters, and I know of him.
English: Kujitha	American English: self-inflicted
Kuna mtu yeyote anayetaka chakula.	Some people want food.
Nilisisimuka kama nini kurudi tena Betheli tulipohudhuria shule na kukutana na watu wengi ambao nilikuwa nimewapenda na kuwaheshimu!	How magical it is to come back to a world I love and to visit characters I've come to know and enjoy seeing them again.
"""Tutaangalia, naona muda hauniruhusu"""	"I'm coming along and I suggest that there's no time to lose."""
"""Ni vigumu kuwafungia wauzaji chakula biashara zao."	"""It's very difficult to get supplies from farmers."
jinging the blues	Stringing the blues.
Hata kama mtoto wako atarudiarudia, au	Also If someone does take his place, or if he does come back...
Omba Msaada Na Fedha	and ask for help or money.
"""Mungu wangu mpaka saa hizi?"	"God this is so long"""
Hata kama ni kulala kwa sekunde chache.	Just two hours for a little sleep.
Leo tunashuhudia historia.	Today, we're witnessing history.
umesahau kipenzi cha wengi kiroba	Don't forget the wild animal lover
Timu zitakazoshika nafasi nne za mwanzo katika kila kundi zitaingia katika hatua inayofuata ya mtoano.	The top four teams from each group will move on to the next round.
Pia Mia's Website	The McDonald's website also
Upatikanaji wa Papo hapo!	Here's immediate help!
"18:36 Aliposikia umati wa watu ukipita aliuliza, ""Kuna nini?"""	18:36-38 When he heard the crowd going by, he asked what was happening.
Nadhani hapo wewe ni jirani yangu!	I see you are a neighbor to me!
uzalishaji wa kibiashara unapoanza.	Concept of business start up.
Kutokana na mazungumzo haya, kulikuwa na msaada kamili kwa serikali ya Iraq.	These same rebels are fully backed by Israel's government.
Unaweza kwa urahisi:	You can easily:
aidha uende, au ukubali kuwa mnyonge,	Move towards or away,
Mwanafunzi mmoja raia wa Misri anakabiliwa na makosa ya kurudishwa nyumbani kutoka Marekani baada ya kuchapisha katika mtandao wake wa Facebook kwamba yuko tayari kumuua mgombea wa urais kwa tiketi ya chama cha Republican Donald Trump na dunia itamshukuru,kulingana na chombo cha habari cha AP.	An Egyptian flight student is facing deportation from the United States after posting on Facebook that he would not have a problem serving a life sentence for killing Donald Trump and the world would thank him.
Wewe ni mtu mzuri, Bwana Doug.	You're a good person, sheepdog.
"3 Yoabu akajibu, ""BWANA na aongeze jeshi lake mara mia na zaidi."	"3 And Joab answered, ""The LORD make His people a hundred times more than they are."
[36.33] Na Ishara hiyo kwao - ardhi iliyo kufa, nasitukaifufua, na tukatoa ndani yake nafaka, wakawawanazila!	[36:33] And a sign to them is the dead earth: We give life to it and bring forth from it grain so they eat of it.
Nimependezwa pia na staili yako ya kuja na kitabu ulichoandika.	I'm also amazed at the precision of your artwork and writing.
Nilidhani nitavumilia na maisha yatasonga mbele	I knew I'd heal and life would go on.
Dakika ya 3 kipindi cha pili.	Two minutes, three seconds.
(+) New kipengele: Nini Habari kulisha: habari kulisha muda halisi, iliyoangaliwa na Wall Street Journal ya kushinda tuzo-waandishi wa habari-akishirikiana lazima-kujua habari duniani kote biashara, fedha, siasa na uchumi siku nzima.	(+) New feature: What's News feed: A real-time news feed, curated by The Wall Street Journal's award-winning journalists--featuring the must-know global news across business, finance, politics and the economy throughout the day.
Ikiwa mgonjwa yuko hatarini kwa ugonjwa wa sukari, basi anapaswa kukaguliwa mara kwa mara.	If the patient is in serious danger, he will be monitored continuously.
Aina keje kat maner?'	"what sort of man is Mr. Kennedy?"""
Mpira wa kisasa unahitaji hela.	Modern slavery must come to an end.
"""Mtoto wangu ana miaka mitano tu, ana tatizo katika mfumo wa upumuaji, hivyo siwezi kurudi nyumbani kumuweka katika mazingira ya hatari kupata virusi hivyo."""	"""I've just had a son, my son is five months old, he had breathing difficulties, so I don't want to come home to put him in more danger."
Alafu kwa bahati mbaya sina ninaye muogopa hapa jf...	overgrownhobbit on Don't Fear The Wu-F...
Hii pia huchochea utendaji wa mwili huu.	It also stimulates the physical activity of the body.
Pia, tumekuwa tukiangalia soko linaloongezeka kwa huduma za wingu kama eneo ambalo lina uwezo mkubwa kwetu tunapanga kuchunguza zaidi.	We are also looking at the shoulder seasons as areas that we can expand our growth.
Niko tayari kuolewa na Wizkid - Lulu la Diva	I am married to Davy Crockett - king of the wild frontier
Asante kwa kunikaribisha, Mkuu.	Thanks for having me, Grant.
Tag: Nchi za Ulaya na Zilizoendelea Uchunguzi wa Kliniki Ubia	in Germany and other European countries visit European Centre for Disease Prevention and Control
Mnaokufa huku mkiishi.	You are dead while you live.
wanyonge, ni wazi kwamba	Get-up, it is clear
Hiki ni kiasi cha watu 6 takriban.	This is the story of 6 people.
Sisi mbele za Mungu ni watoto wa Mungu na Mungu hutenda sawa na vile vile unavyoamini, ukiamini nikimfunga shetani anafungika na inakuwa hivyo hivyo ulivyoamini.	However, as God's children, we have the assurance that Satan is a defeated enemy.
Ukisikia mguu wa bia ndio kama huu	If you hear a propeller-like
Nilipokuwa naingia form I yeye alinipokea akiwa Form III.	The second I walked in he said I was a Type 1.
*smiles* You, and your attitude. zaidi ya mwaka mmoja uliopita	1990: You... and your sense of touch (1990).
Wanawake, mna matatizo gani?	What's your problem women?
"""Kama kuna mwenye kinyongo na mimi tusameheane"" - DIMPOZ"	"""If art is a crime, may God forgive me."" - Ramo"
lowassa alivyowasili mbele ya maelfu ya watanzania	Brazilian Samba in front of thousands of Latin
[16.11] Kwa hayo Yeye anaizalisha kwa ajili yenu mimea, namizaituni, na mitende, na mizabibu, na kila namna yamatunda.	There are plants, trees, herbs, fruits and vegetables for all kinds of ailments.
Kisha akataka kuadhini akamwambia: ((Subiri papoe)) mara mbili hivi au tatu mpaka tukaona kivuli cha vilima.	"He said: ""There were two or three little iffy starts there [from the rest of the field] but we got there in the end."
katika kusoma kwake, kuanzia shule ya msingi hadi chuo kikuu.	It is taught from elementary school up to university.
Kwa mara ya kwanza washitakiwa hao walifikishwa mahakamani hapo mwaka 2008.	The accused were first arraigned in 2008.
Dawa ni kitu muhimu sana kwa wananchi wetu wa Tanzania.	Medical research is vital to the populous of the USA.
16 Kwa kweli kabisa ninawaambia ninyi, Mtumwa si mkuu kuliko bwana wake, wala yule aliyetumwa si mkuu kuliko yule aliyemtuma.+	16Truly, truly I say to you, a slave is not greater than his master, nor a messenger greater than the one who sent him.
Alikuwa mwanafalsafa Mjerumani ambaye ...	He was a German philosopher and...
Huo uwekezaji wa NICOL nayo ilikuwa kama upatu.	Nimoy's voice was a hook as well.
Hata hivyo nami nimefungua gazeti tando jipya la picha.	Lastly, I added a new photoshoot.
Kifaransa cha Kale	the Old French
Video: Ajali ya kutisha iliyotokea Arusha mwezi Januari 2009	The Blog That Dripped Blood: January 2009
MBT Womens kisumu Shoes Details:	Peeping Tom details:
Kifo cha kusimama kina soko kubwa katika sekta yote ya simu za mkononi!	The front porch is across the entire length of the cabin!
t:oa kuwa nsaada wetu wa kuongoza ka kaikama hizo atake shauri kwetu -	Q: I would like to do the verbal introduction to our customers...
OKEx ni ubadilishanaji mkubwa wa fedha wa Hong Kong.	Media is an important agent of change in Bhutan.
Title: Meseji ya kumwambia mpenzi wako kuwa hutamuacha	Definition: a person who does not stop talking
"Tumeamua kulivalia njuga swala hili hadi mwisho ,"" alisema msemaji wa polisi wa Fort Portal Tumushabe."	"We have agreed to sign him until the end of the season,"" the Town boss told Ipswich Player HD."
Yes technologia ni muhimu sana.	Yes, civility is important.
Tume ya uchaguzi iwe huru..	Choose to be FREE.
Translation:Hawaji nyumbani leo.	Translation: They are not suitable to have at home.
Best huielewi hii TV?	The best thing about this TV?
Akipenda atakurehemuni, na akipenda atakuadhibuni.	"""If He will, He can be rid of you and bring (instead of you)."
Utaanzisha blogu yako lini?	Say, when are you going to start your blog?
Wengine walidai kuwa wawili hao walikuwa na kitu walichokuwa wakiendeleza ikizingatiwa kuwa hushinda pamoja nje ya kazi.	It was speculated that one of the two men were going to have to leave as they were struggling to work with one another.
Mwanamke ni ngumu kupata bwana mpya?	Is it difficult for her to find a man?
Rafiki yangu sio kweli, kumbuka...	My name is, help, remember....
Lakini umeshawahi kuwa miongoni mwa abiria wanaojaribu kufanya hilo?	Are you one of the runners trying out?
Kisa cha kumchungulia mwanamke mwenzio?	sacrifice of a virgin?
Usivunjike moyo wewe na Chama Chako endeleeni na jipangeni na mwishowe mtafika.	Don't be fooled and remember that you and your affections come first.
Jamaani, msikonde, visa zitapatikana.	Keep them, don't toss them, time will tell the condition.
Hakuna biashara ambayo itaweza kujiendesha bila ya kuwa na wateja.	After all, no business could be able to run without customers.
Basi uko mahali pazuri kwa msaada.	Then there's a good chance for help.
Lakini Uislamu ni jumla ya hakika zinazo weka nyanja sahihi baina ya watu na Mola Muumba wao, kisha baina ya watu wote, wao kwa wao.	God created the creatures of the sea and the birds of the air and every living species.
Trudi Shortis.	shorty drop.
Wayahudi wanataka wenyewe hati miliki kutoka.	Jews to strike coins of their own.
"Kwa maana ni nani awezaye kutawala watu wako hawa walio wengi?"""	For who is able to govern this great people of yours?...
Lakini kabla ya kununua, unahitaji kufikiria na kupima kila kitu vizuri.	However, despite this, before deciding to purchase it is necessary to weigh everything and be careful.
Hiyo sio 'style' ya Mungu wetu.	That's not the example of our Lord.
Oxandrolone inaweza kuwa shujaa kwa watu ambao hunyonya uzito mkubwa baada ya aina yoyote ya utaratibu wa upasuaji, kuumia au aina yoyote ya shida kali ya kliniki.	Oxandrolone can be the hero for people that shed remarkable weight after any type of surgical treatment, injury or any serious medical condition.
"Na tena katika hiyo sura ya tano tunasoma kuwa , ""Mungu ametupa uzima wa milele na uzima huo u ndani ya Mwanawe."""	The Bible clearly states: God has given us eternal life, and this life is in His Son.
NYCkid69 ametoa maoni...	The Nuvi 1690 has a suggested...
• Ukuaji wa kiuchumi nchini Ecuador imekuwa umoja, ambayo ina moja kwa moja kupunguza umaskini na kukosekana kwa usawa ngazi na kuongezeka kwa tabaka la kati.	• Spread wealth, through interventions that directly reduce the concentration of wealth and power.
Wanawake Pemba wasema sasa basi	women but now it's speaking
Mkurugenzi huyo alisema asilimia 85 ya wananchi walisema rushwa imepungua kulinganisha na miaka mitano iliyopita.	85% of respondents believed journalists had become less safe in the past five years.
Lakini ni mwanamke ambaye hawezi kuuwa nyoka akafa.	She was a young lady who should not have died.
Kufanya mazoezi ya usimamizi mzuri wa pesa hujumuisha mbinu na ufundi mwingi, uliofungamana na hoja ya mfanyabiashara.	Practicing smart money management encompasses many techniques and skills, intertwined with the trader's reasoning.
Siongei jambo ambalo silijui siku zote.	We don't always remember what we know.
Tunatuma Au Pair kwenda Ujerumani.	We pack and ship to Germany.
nchi kwa ajili ya matibabu.	country for medical care.
Nchi igawanywe.	The Land Divided.
Hizi ni sheria za wapi zinazofuatwa hapa!	Here are the Current Rules!
Kwahiyo jiweke utaratibu wa kunywa maji ya kutosha kila siku!	Get the correct quantity of drinking water on a daily basis!
Wake up folks! sijui wewe unayesoma hapa huko unajiweka fungu gani?	Whatever, listen kid, I don't know what kind of game you're playing here...
"Natamani barabara hiyo iwe nzuri kwa Alaçam na Kestel. """	"I want Alaric and Keeley to be happy."""
welcome to samvande.blogspot.com: Suala la Mtwara ni zaidi ya Gesi asilia - Kutumia nguvu ya dola sio njia pekee ya Amani - Zitto Kabwe	Bone broth: It's soup, but it's more than just soup - SooToday.com
Hakika ni kuwa kama tunavyokariri mara kwa mara katika masuala ya kijamii ni kuwa matatizo haya yanatokea kwa sababu ya ukosefu wa maadili mema.	It is these social causes that must be considered because they occur in an atmosphere of moral despair.
kwa jina la watu hawa watatu.	name three of them.
hatutajuta maishani.	We don't miss out on life.
Serikali kuwa tayari kusikiliza na	government are compelled to listen to the
"Lakini hajawahi kufanya hivyo."""	"But it has never done so."""
African child day - Siku ya mtoto wa Africa June 16th, 2016	International Day of the African Child - June 16, 2009
awwww ya folks? aka the fat man...two.	The Chosen One -- watch The Family folks....lol.
Kiswahili ni lugha ya Kibantu yenye misamiati mingi ya Kiarabu (30%), lakini sasa ya Kiingereza pia (10%), ...	IsiXhosa is the first language of 25% of the population, while English is the first language of 20%.:25 .....
Babu yangu mzaa Baba yangu alikuja katika nchi yetu hii kabla haijaitwa Tanganyika.	My ancestors lived in this area prior to leaving for Dayton Ohio.
Je, sisi sote hatupaswi kukubali na kufuata himizo hilo tunaposhughulika na wengine?	Shouldn't we all speak, and act, and make our decisions with the same in mind?
Basi yo yote myatakayo mtendewe na watu, nanyi watendeeni vivyo hivyo; maana hiyo ndiyo torati na manabii.	All things, therefore, whatsoever you would that men should do to you, do you also to them; for this is the law and the prophets.
kwa mpango wao na watapata taarifa,	part thereof, and will be declared
Wengi wa lugha inapatikana kwa Avibase walikuwa ukarimu Tafsiri kwa kujitolea.	Many of Capote's stories were semi-autobiographical in nature.
Usipoteze, kwa sababu misuli ya nyuma imechoka, na huwezi kufanya kazi kwa muda mrefu.	You don't need to re-sharpen the teeth, as they are durable and don't lose the quality for a long time.
Huyu ni mmoja wa washiriki wa vita vya majimaji.	He is one of the Civil War Veterans.
"""Rudi wewe na watu wa nyumba yako, na wasikubabaishe watu wa Al-Kuufah."	Make sure you and your household do not neglect the assembly of worshipers.
Je hawa watoto wanajua lolote kuhusu baba yao?	Do your children know anything about it?
Sikiliza wengine lakini chukua maamuzi yako.	Listen to others, but make your own decisions.
"Kama taa iliyoko ndani yako ikibadilika kuwa giza,giza hilo litakuwa kubwa sana! """	"""If the light which is in you be darkness, how great it is."""
Ninashukuru sana kwamba niliweza kuwasaidia.	I am very grateful that I can help.
Itoshe kusema tupo duniani kusurvive	keep us with the developments on Earth in order to be
"Mara nyingi inajulikana kama ""Sheria ya Kimataifa ya Kibinadamu (IHL),"" lakini hujulikana pia kama ""Sheria ya Vita"" au ""Sheria ya Mgogoro wa Silaha."""	"Many usually called ""Charlotte's internet,"" it's also known as ""Realm Oil"" or ""Alepsia."""
Kwa mwenye nia anaweza kuni PM tutawasiliana zaidi.	I will send you a PM and we can have more detailed discussions.
Split moja kuwa upande mmoja Sleeveless Skirt	Close Back Unrounded Vowel
Upeo wa Mfuko huo ni pamoja na msaada kwa watu waliohamishwa ndani ya Iraq na kusaidia katika Balkan za Magharibi kwa nchi zisizo za EU zilizoathiriwa na mgogoro wa wakimbizi.	The scope of the Fund includes support to internally displaced persons in Iraq and support in the Western Balkans to non-EU countries affected by the refugee crisis.
"Alibatizwa na familia yake. """	"his wife was baptized."""
Visit the Waunakee Public Library	Visit the John Rylands library
porn kizlini aliyor..	Pornography is meant to arouse.
"""Kuwa makini na kuna walinzi wangapi?"""	"""How many security guards and bodyguards do we have?"""
Shiriki Shiriki 1 Kwa Nini Tusali?	Chapter 1: Why Pray?
Msidanganyike kusema msichokijua!	"""Do not speak of what you know not!"""
Mkikutana na jeshi, basi kueni imara, na mkumbukeni Mwenyezi Mungu sana ili mpate kufanikiwa. ***	"If you are overwhelmed in your struggle with sin, read it to be reminded of God's grace and goodness."""
Inagharimu karibu $ 700- $ 800.	All of it worth about $700-$800.
Pili matango gani, ya kisasa au ya kienyeji?	Which parts are past, present or future?
25 ya Mwaka 1972 kama ilivyorekebishwa mara kadhaa.	Published in 1972, it has been revised seven times.
Itakusaidia kujua kama biashara yako inatengeneza faida.	This will help you to decide whether your business will be viable.
Mtilie mume yeyote haya mafuta kabla ya tendo umkomeshe.	Give each of them a shot before settling on your favorite.
Kama umeharibu jua kwamba Chadema haitakuacha tutakuumbua	With Rexona you know your deodorant won't let you down.
