Water supports all your body's functions.	حقیقت میں پانی جسم كے ہر کام سر انجام دیتا ہے .
"on top of it!"""	"سے اوپر ہے!"""
Belle: No, no, I'm just helping out.	نہیں کوئی نہیں، بس سپروائز کرتی ہوں۔
Queen of the Damned 2:41Â	دیسی بیوی شوہر 02:41
In our liberal Western societies, it is - fortunately - impossible to keep people locked up at home.	مغربی معاشرے میں اپنے ثقافتی لباس پہننا شرمندہ تعل .ی کی کوئی بات نہیں۔ تاہم ، بدقسمتی سے کبھی کبھار ، کچھ لوگوں کے لئے ، یہ رکاوٹ پیش کرسکتا ہے۔
Deep-seated doubts about	سنگ سنگ شکن جو
I am wearing...I think I should take this question out of this template..always so boring.	کہیں نہیں...میں سوچ رہی تھی یہ سوٹ ویلیمے میں پہن لوں گی...اتنا بھاری ہے-
Welcome to Ukrainian Wikiversity.	بروشسکی ویکیـپـیڈ یا میں خوش آمدید.
I am and i shall be to the end	میں ہے اور أَثَام
It is thought that in Italy on Saturday, the disease resulted in 793 deaths, the highest in any country in a single day, compared to 651 on Sunday.	خیال رہے کہ اٹلی میں ہفتے کو 793 ہلاکتیں اس بیماری کے نتیجے میں ہوئیں جو کسی بھی ملک میں ایک دن میں سب سے زیادہ ہلاکتیں تھیں، جبکہ اتوار کو یہ تعداد 651 تھی۔
This was followed by a Spectacular Audio Launch of the film on the 7th of December .	1۔ یہ آڈیو واقعی 7 دسمبر کو تباہ ہونے والے طیارے کی تھی
Virtual Private Network.Do you want to come to Canada?	ڈبلیو ٹی جی پی: نجی جانا چاہتے ہو؟ (ایک نجی چیٹ روم میں منتقل کرنے کی درخواست۔).
"""This is NOT the United States"""	'کہیں یہ امریکہ تو نہیں'
Thank you for now!	شکریہ ، ابھیجیت!
I don't feel safe: Binayak's wife	پولیس تعاون نہیں کر رہی:زینب کی والدہ
You're thinking of his brother	كيونكہ آپ اپنے خاوند كے بھائيوں كے
This year, many magazines Galicia wrote about being in the future heir Yaremche Karl Franz Joseph of Habsburg, who later became the Austro-Hungarian Emperor Charles I (1916 - 1918).	اس سال کئی رسالے Galicia کے بارے میں Yaremche کارل فرانز جوزف Habsburg ، جو بعد میں آسٹریا بن کے مستقبل کے وارث کے میں رہ لکھا تھا -- ہنگری Cisar اور چارلس (1916 -- 1918).
The water will be dry.	پانی خشک ہوجائے.
They all have to go back	سبھی کو لوٹ جانا ہے
"""So... will you do it with me?"""	ھممم۔۔۔ تو آپ بھی میرے ساتھ یہ کرنے والی ہیں؟!:00002:
I think we should keep that in mind and move forward.	ہم سمجھتے ہیں کہ اسی احتساب کو چلتے رہنا چاہیے اور چلتے چلتے اس میں بہتری لائی جائے .
Wrist. supports.	عوسیہ ۔ حمایت ۔ مددگار ۔
The Government of Canada did not go to the Supreme Court.	حکومت کو سپریم کورٹ جانا ہی نہیں چاہیے تھا
I am the nation's weeping dead	میں رو رہا ہوں قوم کے مرجھائے پھول پر
7) For those who sleep, sleep at night, and those who get drunk are drunk at night.	تے جدوں داء لگدا جان بجھ کے دادی دی کوئی شے خراب کردیندا تے فیر راتیں کُٹ پینی لازمی ہو جاندا سی۔
"A Euro 2020 spokesperson added, ""Players are offered water, alongside Coca-Cola and Coca-Cola Zero Sugar, on arrival at our press conferences."""	دوسری جانب یورو فٹبال کپ کے ترجمان نے کہا کہ 'کھلاڑیوں کو پریس کانفرنس کے دوران پانی کے ساتھ ساتھ کوکا کولا اور کوکا کولا زیرو بھی پیش کی جاتی ہے۔
"In September 1950, MacArthur said in his public report to the United Nations, ""The problem of avoiding the killing of innocent civilians and damages to the civilian economy is continually present and given my personal attention.""[319]"	"ستمبر 1950 میں ، میک آرتھر نے اقوام متحدہ کو اپنی عوامی رپورٹ میں کہا ، ""بے گناہ شہریوں کے قتل اور شہری معیشت کو پہنچنے والے نقصانات سے گریز کا مسئلہ مستقل طور پر موجود ہے اور میری ذاتی توجہ دی جارہی ہے۔"""
"""Thats two words."""	"کوئی چھوٹا "" سا دو لفظی """
I don't know how I could travel without it.	میں سوچتا رہا، کرائے کے بغیر سفر کیسے کروں۔
She never want you get it is going to the events.	اور آپ اسے کبھی بھی ایسی کوئی چیز نہیں بھیجنا چاہتے جو رجحانات میں ہے۔
people of the United States lost their beloved	امریکی شہریوں نے اپنے پیاروں کی میتیں وصول کرنے سے انکار کردیا
"""Look at the regimes in the region or in Latin America."	جمہوری نظام میں دیکھو یا پھر آمریت میں دیکھو۔
modern-day royals.	دور جدید مبارک باد .
In remoteness from one another, many peoples live here.	پھر آہستہ آہستہ یہاں کے بہت سے لوگوں کی محبت۔۔ جن میں بہت سے ممبرز شامل ہیں۔
To start the process, it is always good	آغاز ہمیشہ فع سے ہوتی ہے یہ دھن
"I said, ""I think so, Pam can get kind of squirmy sometimes."""	"میں نے کہا""ہو تو سکتے ہیں بلکہ بعض اوقات پارٹی بازی میں یہ چنڈال چمچے بن جاتے ہیں۔"""
Firstly, the opportunity to earn money online.	سب سے پہلے، آن لائن رقم کمانے کا موقع.
The contest was postponed due to rain and thunderstorms.	طیارہ بارش اور موسم کی خرابی کے باعث حادثے کا شکار ہوا
And there came a man from the furthest part of the city, running; he said, 'My people, follow the messengers.' (36:20)	اچانک اس بیابان میں ایک آواز سنائی دی، اے صحرائے بیدا اس ظالم قوم کو اپنے اندر نگل لو۔ (5)
In addition, reinvestments of the principal payments from maturing securities purchased under the APP will continue, in full, for an extended period of time past the date on which the Governing Council begins to raise the key ECB interest rates, and in any case for as long as necessary to maintain favorable liquidity conditions and an ample degree of monetary accommodation.	()) اے پی پی کے تحت خریدی گئی سیکیورٹیز کی اصل ادائیگیوں کی دوبارہ انوسٹمنٹ پوری تاریخ میں جاری رہے گی ، جب گورننگ کونسل اہم ای سی بی سود کی شرحوں میں اضافہ کرنا شروع کرے گی ، اور کسی بھی صورت میں جب تک سازگار رطوبت کے حالات اور معاشی رہائش کی کافی حد تک برقرار رکھنے کے لئے ضروری ہے۔
The Prime Minister of Hungary Viktor Orban	ہنگری کے وزير اعظم وکٹور اوربان
reduced price of £19.99.	باقاعدہ قیمت £ 19.99 بک گیا
"""What are you occupied about now?"""	"""ریٹائرمنٹ کے بعد اب آپ کی کیا مصروفیات ہیں؟"""
HIV/AIDS - people living with HIV/AIDS: fewer than 600 (2007 est.)	ایڈز/ایچ آئی وی کا شکار لوگ: 500 سے کم (2016ء تخمینہ۔)
Thank you for putting my thoughts in black and white	رنگین دور میں بلیک اینڈ وائٹ باتیں دہرانے کا شکریہ
I do want to have a good relationship with you	میں آپ کے ساتھ اچھے تعلقات میں کرنا چاہتے ہیں
What to do about the bread?	مگر روٹی سے گدھے کا واسطہ؟
Pakistan has consistently supported all regional and international efforts to combat terrorism and extremism.	پاکستان نے عسکریت پسندی، انتہا پسندی اور دہشتگردی کی روک تھام کیلئے ہمیشہ تمام علاقائی اور عالمی کوششوں کی حمایت کی۔
Heavy rains continue in Tamil Nadu, 12 people have died so far; water on...	تمل ناڈو میں بارش کے بعد حالات بگڑے ، اب تک ۱۵ افراد کی موت ، سیلاب کا الرٹ
And if Allah touches you with misfortune, there is no one who can remove it but He; and if He touches you with good fortune, it is He who has power over all things.	ترجمہ: اگر اللہ تمہیں کسی قسم کا نقصان پہنچائے تو اس کے سوا کوئی نہیں جو تمہیں اس نقصان سے بچا سکے اور اگر وہ تمہیں کسی بھلائی سے بہرہ مند کرے تو وہ ہر چیز پر قادر ہے۔
(v) A similar warning can also be read in the following ahadith:	(١) مذکورہ حدیث حسب ذیل کتاب میں بھی نقل کی گئی ہے:
Considers the recommendation of a Committee on a law to regulate the stock exchange.	ا اسٹاک پنج کو باضابطہ بنانے کے لیے قانون پر ایک کمیٹی کی سفارشات پر غور کرے۔ و دوریاستی.
If it doesn't, create the directory.	اگر یہ موجود نہیں ہے تو ڈائریکٹری بنائیں۔
Today, there is quite...	نہیں، موجودہ پالیسی کافی...
Completion of at least one year's study at a higher educational programme in an EU/EEA country or Switzerland: ۵ points	کم از کم تین سال کی تکمیل' یورپی یونین / EEA ملک یا سوئزرلینڈ میں ایک اعلی تعلیمی پروگرام میں اسٹڈی: 10 پوائنٹس
and this is a good feeling.	تو یہ ایک اچھا احساس ہے .
A max of 2 trillion coins will be issued, and the aim is a single coin will be worth $1.	کی ایک زیادہ سے زیادہ 2 ٹریلین سککوں جاری کیا جائے گا, اور اس کا مقصد ایک واحد سکوں کے قابل ہو جائے گا ہے $1.
Oh Heero, you're such a fag...	ہائے میری جانی مہر۔۔۔تم اتنی سیریس۔۔۔
For example, we would want to create.	مثال کے طور پرہم نے تشکیل دیا ہے.
The most common tools are considered to be stop-loss and take-profit.	سب سے زیادہ عام انسٹرومنٹ ایک سٹاپ نقصان ہو جائے اور لے منافع بخش سمجھا جاتا ہے.
"I say), or you're thinking, ""I really don't care about that stuff."""	"میں کہتا ہوں) ، یا آپ کے بارے میں سوچ رہے ہیں, ""مجھے سچ میں نہیں دیکھ بھال کے بارے میں ہے کہ چیزیں."""
What are the benefits of green tea?...	سبز چائے کا یہ فائدہ جانتے ہیں؟...
One of the main problems associated with traditional	روایت سے مستنبط اہم مسائل
Take time to sleep in.	اندرا کے لئے سونے کا وقت لے لو.
Encourage players to get up and down the field and transition quickly.	اور فوری طور پر میدان اور منتقلی کے نیچے حاصل کرنے کے لئے کھلاڑیوں کی حوصلہ افزائی کریں.
If the Greek and Turkish sides reach an agreement, Greek Cypriots will gain access to Varosha and Turkish ports and airports, and Turkish Cypriots will be able to engage in direct trade via Famagusta port.	اگر یونانی اور ترک کسی معاہدے تک پہنچتے ہیں تور یونانی قبرص ترک بندرگاہوں اور ہوائی اڈوں کے ساتھ واروشا تک بھی رسائی حاصل کرے گا اور ترک قبرص غازی مغاسا کی بندرگاہ سے براہ راست تجارت کر پائے گا۔
Indian music company removes Atif Aslam's song from YouTube	بھارتی میوزک کمپنی کو عاطف اسلم کا گانا ہٹانا مہنگا پڑگیا
Mist everywhere, and a small glacier tongue.	کہاں بھینس اور کہاں بکری کی چھوٹی ذات۔
Try weaning yourself off of cannabis instead of going cold turkey.	سرد ترکی چھوڑنے کے بجائے الکحل کے استعمال کو کیسے کنٹرول کریں۔
Do you guys!.	ارے آپ guyz !!!
In fact, they may even be directly competing with you.	اصل میں، وہ آپ سے بھی براہ راست رابطہ کر سکتے ہیں.
Now, the smartphone can be officially sold in Brazil.	یہ فون اب سرکاری طور پر اسپین میں خریدا جاسکتا ہے.
President Erdogan's son-in-law resigns as Turkish finance minister	ایردوآن کے داماد ترکی کے وزیر خزانہ کے عہدے سے مستعفی
We know that not every student will meet every goal.	ہم جانتے ہیں کہ تمام طالب علموں کو اپنی پیش گوئی کی گریڈ حاصل نہیں ہوتی.
"Upon seeing him in this situation, his companion Bilal, who is about to recite the call to prayer for the pre-dawn, asks him ""O Allah's messenger!"	اپنے نام کے ساتھ اپنے نبی کا نام ملا لیا جبکہ پانچویں وقت اشھد کہتا ہے آپ کی عزت و جلال کے اظہار کے لیے اپنے نام میں سے آپ کا نام نکالا دیکھو وہ عرش والامحمود ہے اور آپ محمد صلى الله عليه وسلمہیں
OMG, oh my god.	OMFG اوہ میرے خدایا
Don't be turned off because this whiskey was distilled in Canada.	لیکن خبردار جو پینے پلانے کی بات کی؟ گردن اتار دی جاتی ہے یہاں پر ...کینیڈا نہیں ہے یہ
It was the coldest and wetest in 30 years.	تین سالوں میں بدترین نااہلی اور کرپشن کی گئی ہے
(3) as a figure of things in the heavens Hebrews 9:23; Hebrews 9:24.	I. آئیے دیکھتے ہیں آسمان میں کیا ہوگا، عبرانیوں12:22۔24؛
Are you returning to the Church?	رپورٹر:کیا آپ دوبارہ مسجد جائیں گی؟
And, of course, we install fire pits and fireplaces.	(4) یقیناً ہم نے کافروں کے لیے زنجیریں اور طوق اور شعلوں والی آگ تیار کر رکھی ہے.
Les said: This book is not for dummies.	دوہڑے بیت کہے اس چنگے نہیں کتابیں کھُلاّ
The primary target of this blow was the Palestinian nation and secondarily all the other nations in the region.	اس ضرب کی زد پر سب سے پہلے فلسطین قوم اور اس کے بعد علاقے کی تمام اقوام تھیں۔
At age 58 she had never heard of this guy.	ایک 17 سالہ عمر کے طور پر، اس نے اس بیماری کے بارے میں کبھی بھی سنا نہیں تھا.
He won as Best Supporting Actor for the 2017 film 'Moonlight'.	انھوں نے سنہ 2017 میں فلم 'مون لائٹ' کے لیے بھی بہترین معاون اداکار کا ایوارڈ ملا تھا۔
"""Why India's Metro and suburban railways should merge."""	پھر بھی حکومت کی ترجیح میٹروبس اور اورنج لائن ٹرین کیوں ؟
It may be that the initial setup process was corrupted or interrupted.	شاید اس کا اصل مصدر حذف ہوگیا یا کردیا گیا.
The captain will win.	کپتان جیت کے دیکھائے گا
Alternative dispute resolution in accordance with art.	آرٹ کے مطابق تنازعات کا متبادل حل.
It might be a new employee.	شاید کسی نئے کو کام آ سکے۔
The attack triggered grief and anger across the country.	اس حملے کے بعد ملک بھر میں شدید صدمے اور غم و غصے کا اظہار کیا گیا۔
Your veneers are not loose.	جناب انکی شوخیاں نہیں ختم ہونے والیں۔
No prayer will be offered only in the condition of the prayer.	صلی اللہ علیہ وسلم دعا استسقاء کے سوا اور کسی دعا میں (زیادہ اونچا) ہاتھ نہیں اٹھاتے تھے۔ اس دعا میں آپ صلی اللہ علیہ وسلم اتنا اونچا ہاتھ اٹھاتے کہ بغل مبارک کی سفیدی دکھائی دیتی تھی۔
He's either having trouble breathing, coughing, or breathing quickly.	اسے گھرگھراہٹ ہے، غراہٹ ہے، یا جلدی جلدی سانس لے رہا ہے
Four decades later, Singapore had become an Asian tiger.	بھارت دس سال بعد ہاکی کپ ایشیا کا ہیرو بن گیا
What's the Cost of a Townhouse?	ایک ہاؤس سیٹر پر کتنا خرچ آئے گا؟
there's peace!	تو ہی سلامتی ہے!
It does, however, feel very stable.	اس کے باوجود، وہ کافی مستحکم ہے.
Look at the three circles in the above picture.	نشان زد تصویر کو دیکھو 3 مندرجہ بالا تصویر میں.
the Federal Capital Territory of nigeria	وفاقی دارالحکومت علاقہ، نائجیریا
A whole 9 days old.	نیا 100 دن، پرانا 9 دن۔
U.S. provides weapons to Kurds in fight against Islamic militants	امریکا نے داعش سے لڑنے کیلئے کرد جنگجوؤں کو اسلحہ فراہمی کی منظوری دیدی
I'm still convinced he's a human.	میں اب بھی اصرار کرتا ہوں کہ یہ انسان کاتیار کردہ ہے
"right of action."""	"حقوق اداری"""
The Old Town square is a glorious mix of architectural styles, there's a beautiful gothic church and a lot of Jewish heritage - though the community was more or less wiped out during the Second World War.	اولڈ ٹاؤن اسکوائر تعمیراتی طرزوں کا شاندار امتزاج ہے، یہاں ایک خوبصورت گوتھک چرچ اور بہت سارے یہودی ورثے ہیں - حالانکہ دوسری عالمی جنگ کے دوران کمیونٹی کم و بیش مٹ گئی تھی۔
There's nothing greater than my dick, these sluts work best....	اپنی نسبت سے میں کچھ نہیں ہوں اِس کرم کی بدولت بڑا ہوں اُن ٹکڑوں...
Assembling a site may be accomplished hundreds of various ways.	میرا مطلب یہ ہے کہ ویب سائٹ کی تعمیر کا عمل تقریبا ایک سو مختلف طریقوں سے ممکن ہوسکتا ہے.
Tuess, the se.	پرچم، درفش.
"lines of national identity."""	'قومی شناختی کارڈ کی شرط برقرار'
I've had a few worship my feet and long legs	میری طویل ٹانگوں اور ٹنی انگلیوں کی ضرورت ہے کرنے کے لئے ہو پوجا
The established, Shi'ite Islamist-dominated ruling elite, whose most powerful parties have armed wings, is expected to sweep the vote, with the movement led by populist Shi'ite cleric Moqtada al-Sadr, who opposes all foreign interference and whose main rivals are Iran-allied Shi'ite groups, seen emerging as parliament's biggest faction.	قائم شدہ حکمران طبقہ جس کی طاقتور ترین جماعتوں کے مسلح ونگ ہیں توقع کی جاتی ہے کہ وہ ووٹ حاصل کرے ، مولوی مقتدا الصدر کی قیادت میں تحریک ، جو تمام غیر ملکی مداخلت کی مخالفت کرتی ہے اور جس کے اہم حریف ایران سے وابستہ گروہ ہیں ، پارلیمنٹ کے سب سے بڑے دھڑے کے طور پر ابھرتے ہوئے .
"""The networked system, capable of even shooting around buildings, will take care of 9/11-like and other close-in threats,"" said the source."	"ذریعہ نے کہا ""نیٹ ورک سسٹم، عمارتوں کے ارد گرد شوٹنگ بھی کرنے کے قابل، 9/11 کی طرح اور دیگر قریبی خطرات کی دیکھ بھال کرے گی."""
"Muhsin Khan: And they say: ""When we are (dead and become) lost in the earth, shall we indeed be recreated anew?"""	Maulana Shah Imam Ahmed Raza Khan تو بولے کیا ہم اپنے میں کے ایک آدمی کی تابعداری کریں (ف۳۴) جب تو ہم ضرور گمراہ اور دیوانے ہیں (ف۳۵)
When my hair has dried, it's a dream.	میرے دوست نے اپنی بالیاں توڑ دیا، کہ یہ کیا ہے ایک خواب دیکھا؟
Just looking for the guy that used to live here.	بس جو رہتا تها وہ اک تلاش.
for the first time in June of last year.	ملک میں پچھلے سال جون کے بعد پہلی بار ایک...
The quiet lake is stretching away before your eyes.	تیری جھیل سی آنکھوں میں ڈوب جانے کو دل کرتا ھے
personal version for $40.00 USD	کم سے کم ذاتی ورژن $ 245.00
It is set in the 1980s, and it involves kids making their own video adventure movie.	یہ 1960s میں شروع ہوا تھا، اور میں سوچتا ہوں کہ ایک چھوٹا پینٹنگ ایک بچہ رکھتا ہے جسے بچے کے لے جانے کے لئے اپنی آرٹ کا انتخاب کرنا ہوگا.
In the name of your Rabb Who created.)	کینا سوہنا مینوں رب نے بنایا،جی کرے ویکھدا رہواں
A zero-logs policy means only you know what you're doing online.	"""ہماری سخت نو لاگز پالیسی اس بات کی ضمانت دیتی ہے کہ آپ صرف یہ جانیں گے کہ آپ آن لائن کیا کرتے ہیں۔"""
We get it religion is bad...unless it's islam then we're Islamophobes.	ہم تو کافر ہوں ۔۔۔۔اگر بندے نہ ہوں اسلام کے
According to DW, Pakistan's young...	جیو نیوز کے مطابق پاکستان پیپلز ...
More serious side effects requiring medical assistance include:	مزید سنگین ضمنی اثرات جو طبی توجہ کی ضرورت ہوتی ہیں وہ شامل ہیں:
I mean, all my friends are uni students, so they refuse to pay for a subscription for anything.	بچپن کا دوست تو ایسا نہیں لیکن میرے تمام دوست میرے لیے سرمایہ ہیں لہذا کسی ایک کے بارے میں لکھ کر ناانصافی نہیں کرنا چاہتا.
The Clerk of Court is an eight year term.	کورٹ میرج کے لئے عمر کی حد8 1سال ہے
He has been on a hunger strike for a few days.	وہ 55 دن تک بھوک ہڑتال پر رہے تھے۔
Other reviewers have commented on the cow smell.	کچھ صارفین نے چائے کے مہنگے کپ سے متعلق دوبارہ تبصرے کیے۔
کتاب Forced Migration in Central and Eastern Europe, 1939 -1950	وسطی اور مشرقی یورپ میں زبردستی ہجرت ، 1939-1950
He was possibly the last living link to such founders of modernism as Bauhaus stalwarts Walter Gropius and Marcel Breuer, all of whom he met.	وہ ممکنہ طور پر جدیدیت کے ایسے بانیوں کے لۓ آخری زندہ رہنما تھا جیسے لی کوربسیر اور بروہس والٹر گروپیس اور مارسل برور نے ان تمام سارے واقعات سے ملاقات کی.
Talking to the other one?	نـع کی گفته ؟
Russia also plans to expel British diplomats in the near future.	'روس بھی برطانوی سفارت کاروں کو جلد ملک بدر کرے گا'
We Have No Idea What We're Doing _ Unturned	سمجھ میں کچھ نہیں آتا کہ ہم کیا کررہے ہیں _ سخن سرا
Songs for the wedding party introduction at the reception.	استقبال میں شادی کی تقریب کو متعارف کروانے کے لئے گانے ، نغمے
I should add... that I truly wanted this company to be good...	'میں آپ لوگوں کو یہ بتانا چاہتی ہوں کہ دراصل میں۔۔۔' مقابلہ حسن میں شریک اس ...
I failed to find.	مجھے ڈھونڈنے سے نہیں ملا
A decade of the law	قانون بلحاظ دہائی
"don't remember my life before clay."""	مجھ کو میرے وجود کی تک نہ جانئیے - Shaur
My neighbors knew everything that was going on in our house, and no one told them.	سبھی اندین کو پتا تھا کہ میرے ملک کی ایجنسی مجھے ٹریس رہی مگر کسی نے بتایا نہیں۔
Primero, because it's personalised to your child's name, following on from publisher Lost My Name's first book The Little Boy/Girl Who Lost His/Her Name.	پہلا, یہ آپ کے بچے کا نام کیلئے ذاتی کیونکہ, ناشر سے پر مندرجہ ذیل میرے نام کی پہلی کتاب کھو گیا چھوٹا لڑکا / لڑکی کون اس کی / اس کا نام گمشدہ.
2. favorable or propitious.	ج) مفید یا مضر و ارثی
The slum dwellers had broken the barrier	Next شرپسندوں نے دیوارِ قبرستان توڑی
"""What are modifications?"	تبدیلیاں کیا ہیں؟
"It definitely means everything."""	"بے معنی ہے اس کیلئے تو سب کچھ۔"""
The camel or the cow can be shared by seven people.	اونٹ اور گائے سات افراد کی طرف سے کفایت کرجاتی ہے
was trying to work with it.	میں نے کہا کہ میں نے آپ کو اس کے ساتھ مل کر کام کرنے کی کوشش کی ہے.
"""I haven't told anyone else this information..."""	"""یہ خبر شائع کرنے کے لیے مجھ سے کسی نے نہیں کہا تھا...."
Wiped, end of party.	بخینی ۔ کسی حصے کا مکمل خاتمہ ۔
The main focus of the lab is to understand the molecular basis for	سب سے پہلے, یلئڈی فلیٹ پینل ہم سب سے پہلے روشنی کی بنیادی ساخت سمجھنے روشنی ساخت ذریعہ:
Networking is an essential part of finding a job.	نیٹ ورکنگ ایک کام کی تلاش کا ایک لازمی جزو ہے.
Northern Ireland, plagued by a history of sectarian violence, is still divided by identity politics, with peacemakers concerned that the EU-UK spat might create a space for those grievances to breathe.	فرقہ وارانہ تشدد کی تاریخ سے دوچار شمالی آئرلینڈ اب بھی شناخت کی سیاست سے منقسم ہے متعلقہ امن پسند تاکہ یورپی یونین اور برطانیہ میں تیزی سے ان شکایات کو سانس لینے کے ل.
Noe writes:	نہیں نے لکھا:
"""Sanju, look who is here."""	"""دیکھیں امو جان کون آیا ہے""۔"
because the issue is the same whichever it is.	ہم بھی ہیں وہی، مسئلۂ جاں بھی وہی ہے
Whatever we'll see.	چل جو بھی ہو دیکھا جائے گا۔
What to expect when you're expecting 618.9285 B896	ہمیں بھلا ان سے واسطہ کیا جو تجھ سے ناآشنا رہے ہیں 189 189 162 176 بانگ درا
The PSNI3 canine unit will also be patrolling the area.	پی ایس ایل کا ترانہحدیقہ کیانی بھی میدان میں آگئیں
If you wake up at a different time, in a different place,	اگر آپ ایک مختلف وقت میں جاگ تو، ایک مختلف جگہ میں،
So you had to walk all the time.	لیکن تمام عمر ہی چلنا پڑا تجھے!
Third party links may be present on our website.	تیسری پارٹی ہماری ویب سائٹ پر اشتہار دے سکتی ہے.
I didn't have the courage to tell you then, but you ruined me.	لیکن مجھے تو وقت کا پتا ہی نہ چلا کم از کم تم کو مجھے بتانا چاہیئے تھا۔۔وہ واقعی شرمندہ ہورہی تھی.
Toprak: There is no hope for us anymore.	ڈھاکہ:'زندہ ملنے کی اب کوئی امید نہیں
"The Site may contain links to other websites, applications, and platforms (hereinafter the""Linked Sites"")."	"اس سائٹ پر دوسری سائٹس، ایپلی کیشنز اور پلیٹ فارمز کے لنکس شامل ہیں (یہاں "" لنک کردہ سائٹس "" کے بعد)."
Have a look at the two charts below.	دونوں قیمتوں پر ایک نگاہ ڈالیں چارٹس ذیل میں.
Hours: 7 days a week 9am - 5pm August 16 - October 31, 2019	گھنٹے: 7 دن ایک ہفتے 9AM - ایکس این ایکس ایکس اگست اگست 5 - اکتوبر 16، 31
It cannot, think about it.	نہ ممکن تھا کہ وہ اس کو بناسکتے۔ آئیے ہم ذرا اس بارے میں سوچتے ہیں۔
They will turn soft and sweet in a few days.	اس سے ہونٹ کچھ ہی دنوں میں نرم اور چمکدار دکھائی دینے لگیں گے.
The vast populations of India or China?	دنیا کا سب سے بڑا خاندان: بھارت یا یوکرین میں؟
"""Something has happened, Mr."	4) کچھ ایسا ہو گیا ہے یار اپنا
The saga of clogging the arteries, continued	جوفرا آرچر پر جرمانہ، وارننگ لیٹر جاری
I'm constantly dying.	مسلسل مر رہی ہوں میں
Abdus Salam was a Ahmadiyya Muslim.	مرحوم ایک معروف احمدی مسلمان تھے.
Using a large number of currency pairs and small lots, absolutely safe Forex trading is achieved.	کرنسی کے جوڑوں اور چھوٹے لاتوں کی بڑی تعداد کا استعمال کرتے وقت، غیر ملکی کرنسی مارکیٹ میں بالکل محفوظ ٹریڈنگ حاصل کرنا ممکن ہے.
Right now I'm sending you texts with one hand because the other hand is busy with something else.	فی الحال ، میں آپ کو ایک ہاتھ کا استعمال کرتے ہوئے متن بھیج رہا ہوں کیونکہ دوسرا حصہ کہیں اور مصروف ہے۔ لگتا ہے کہاں ہے؟
How to Build a Successful influencer Marketing Program	ایک کامیاب اثر و رسوخ کی مارکیٹنگ کے پروگرام کو تشکیل دینے کا طریقہ.
Who's our hero?	ہمارے ہیرو کون؟
It is in most of the photos.	یہ زیادہ تر فوٹو گرافی سے کیا جاتا ہے.
If you doubt that, just look at the other reviews.	اگر آپ شک میں رہیں تو، باقی امتحانات کے جائزے کو ملاحظہ کریں.
What more do you want to know about my products?	تو آپ کی مصنوعات کے بارے میں اور کیا جاننا چاہئے؟
Mind over matter, though (or so they say).	پھر کیا فرما یا انہوں نے
Alternatively, take part in a hands-on cooking class, during which you will learn how to make Shanghai dumplings.	اپنے کتے کو کتے کے تربیتی کلاس میں داخل کرنے پر غور کریں ، جہاں آپ کا کتا تفریح   کے دوران ضروری مہارتیں سیکھ سکتا ہے۔
The United States, which provides the bulk of the force, has 2,500 troops left in Iraq, down from 5,200 a year ago.	ریاستہائے متحدہ ، جو زیادہ تر فوج فراہم کرتی ہے ، کے پاس عراق میں 2500 فوجی باقی ہیں - جو ایک سال پہلے 5،200 تھے۔
And China is the country with the highest death toll because of air pollution.	ترکمانستان وہ ملک ہے جہاں فضائی آلودگی کے باعث ہونے والی اموات کی شرح سب سے زیادہ ہے۔
in operations research	کارروائی،سرچ آپریشن
VPN will be one of the best solutions for this.	A VFR اس طرح کی چیز کے لئے ایک بہترین انتخاب ہو جائے گا.
In any case, there is always an essential ambiguity in the nature of this god of the stone pile.	اس ماحول میں مولانا ثناء اللہ صاحب کی شخصیت اور اصول کے اس پہلو کو عام کرنے کی اشد ضرورت ہے۔
what he knew over the telephone.	سب کچھ وہ موبائل فون پر کیا معلوم
He dared Indian Air Force to remain in Pakistani airspace for 21 minutes and see what happens.	انہوں نے کہا کہ اس کے میڈیا کا دعویٰ ہے کہ بھارتی طیارے 21 منٹ تک پاکستان کی فضائی حدود میں رہے ان میں ہمت ہے تو ایسا کرکے دکھائیں۔
made by: Nooooooooooooooo	اسٹوڈیو: Noovo
This is a big year for the game.	سالہ ایک عظیم فٹ بال ہے.
Or at least cut back on your cable television service.	نہیں تو کم از کم مرکزی کمیٹی کا ٹی وی پر آنا بند کردیں
I'm Kurdish in Iraq..	عراق میں داعش نے دوب...
You must be aware of this fact to buy the right equipment.	آپ کو اس علاج کی خریداری کے لۓ اس سے آگاہ ہونا ضروری ہے:
Americans were going to kill them.	اسے مارنے والے امریکی تھے؟ نہیں!
The calendar for the 2020-21 school year has been set.	2020-21 اسکول سال کے کیلنڈر کو اپنایا گیا
It should be fermented a few days ago.	یہ چند دن قبل خشک ہونا چاہئے.
of them is the way of death.	تمہاری موت لوگوں کو تتر بتر کرنے کا ایک طریقہ ہے
I am interested and have more questions.	میں دلچسپ ہوں اور مزید معلومات کے ل questions سوالات پوچھنا چاہتا ہوں۔
From what we have determined, these number less than 10.	ہماری حالت کی جانچ پڑتال کر رہا ہے یہ 10 سے کم ہے کہ.
Maybe he's not a daddy.	شاید ہے یہ کوئی باپ
Street poster with anti-Communist message.	کمیونزم کے خلاف شائع کیا گیا ایک پراپیگنڈہ پوسٹر
We ship Hope II all over the world.	ہم دنیا بھر کے لئے جہاز 2.
"That reminds me of a fast-food ad in which an elderly lady yells out, ""Where's the beef?"""	"دو مریل کتوں کے بھونکنے کے شور میں، میں ایک بوڑھی، کمان بنی عورت سے پوچھتا ہوں "" ماسی عمر دراز کا گھر کہاں ہے ؟"""
The word does get around.	لفظ کے ارد گرد ہو جاتا ہے.
"""And He said, Abba Father..."	وہ شخص كہنے لگا: اے ابو عبدالرحمن
The price will eventually goes down.	قیمت آخر میں سپورٹ کو توڑتی ہے.
DA Katz said video surveillance footage shows Stokes exiting a parked car around 2:45 p.m. on February 7, 2021.	ڈی اے کاٹز نے کہا کہ ویڈیو نگرانی کی فوٹیج میں دکھایا گیا ہے کہ 7 فروری 2021 کو شام 2 بجکر 45 منٹ پر اسٹوکس ایک کھڑی گاڑی سے باہر نکل رہے تھے۔
Check-stops will be set up throughout the month and into January.	احتیاطی پابندیاں فروری کا پورا مہینہ نافذالعمل رہیں گے:پب اور بار بند رہیں گے۔
And get out of this town	چلو، اس شہر سے
a meat cleaver is a large, most often rectangular knife that is used for splitting or 'cleaving' meat and bone. a cleaver may be distinguished from a kitchen knife of similar shape by the fact that it has a heavy blade that is thick from the spine to quite near the edge. the edge is sharply beveled and the bevel is typically convex. the knife .	مسئلہ۔ مردار کی کھال کو جب ڈھول میں سکھا ڈالیں یا کچھ دوا وغیرہ لگا کر درست کر لیں کہ پانی مر جاوے اور رکھنے سے خراب نہ ہو تو پاک ہو جاتی ہے اس پر نماز پڑھنا درست ہے۔ اور مشک وغیرہ بنا کر اس میں پانی رکھنا بھی درست ہے۔ لیکن سور کی کھال پاک نہیں ہوتی اور سب کالیں پاک ہو جاتی ہیں مگر آدمی کی کھال سے کوئی کام لینا اور برتنا بہت گناہ ہے۔
Every inch of the boat is fiber-glassed.	بٹوار پر مکے مار کر کے ہر ٹکڑا ہے viewfinder ہے.
He made quite a lot of money from it.	انہوں نے کہا کہ اس سے دور بہت پیسہ بنایا.
And then Christmas shortly after.	جلد ہی کرسمس کی ، تو کیا!
wise designated.	نامزد من ک نیس.
I love the Monaco.	""" مجھے مونونخ سے محبت ہے."
These include that games are played in the best temperatures.	اس کا مطلب ہے لائیو گیمز بہترین معیار میں دکھایا گیا ہے کہ.
Working with Peruvian-American Binational Centers, which promote educational opportunities, the embassy recently introduced a State Department-sponsored online business development program focused on helping women entrepreneurs in emerging markets.	تعلیمی مواقعوں کو فروغ دینے والے پیرو اور امریکہ کے دو ملکی مراکز کے ساتھ مل کر سفارت خانے نے حال ہی میں محکمہ خارجہ کا کاروبار کے لیے تیاری کرانے کا ایک ایسا آن لائن پروگرام متعارف کرایا جس میں توجہ ابھرتی ہوئی منڈیوں میں خواتین کاروباری نطامت کاروں کی مدد کرنے پر مرکوز کی جاتی ہے۔
The middle class is completely extinct.	یہ کورس / کلاس پہلے ہی مکمل طور پر بک ہیں
There is actually a ferry that allows you to cut across and save some time.	عملی - عملی طور پر ایک داڑھی کا کٹر ہے، جو دھوکہ ہے اور آپ کو وقت بچاتا ہے.
The biggest question for me seems to be in a disconnect between the laws and the on-the-ground culture of Japan.	اس حادثے کی بنیادی وجہ جاپانی ثقافت میں موجود تابعداری اور حکام کے خلاف سوال اٹھانے میں جھجھک کا ہونا ہے۔
The entire Christian community should feel the responsibility of educating new generations.	آنے والی نسلوں کو مقام زہرہ کے آداب سیکھانا پوری امت مسلمہ کی ذمہ داری ہے
"""Know this, that he that is a friend to himself, is a friend to all men."""	"""زُبین ،تمہیں پتہ ہے ؟ وہ ضرور ایک چھوٹے گھر کی لڑکی ہے لیکن وہ بھی تو انسان ہی ہے اور ہم سب جیسے دوست ہیں وہ بھی ہماری دوست ہے نا""۔"
The Boy That Got Away (Rock)	The Boy Who Ran Away (لڑکے والے کو بھاگ گئے ۔)
All the books of history mention this.	تاریخ کی تمام مستند کتابوں میں ان باتوں کا ثبوت موجود ہے.
"""The whole history of science has been the gradual realization that events do not happen in an arbitrary manner, but they reflect a certain underlying order which may or may not be divinely inspired."""	"""سائنس کی پوری تاریخ بتدریج یہ سمجھی گئی ہے کہ واقعات منمانے والے انداز میں نہیں ہوتے ہیں ، بلکہ یہ کہ وہ ایک خاص بنیادی ترتیب کی عکاسی کرتے ہیں ، جس سے خدائی الہام ہوسکتا ہے یا نہیں۔ """
Writing the name of the town.	شہر کا نام لکھیں.
Proponents of same-sex marriage will no longer have to wait for the legislative process to catch up with public opinion.	شعبہ صحت سے وابستہ افراد کو ترقی کے حصول کے لئے انتظار کی سولی پر نہیں لٹکنا نہیں پڑے گا' مشیر صحت
I love it & I love them.	وہ مجھے عزیز ہے اور میں اُن کا مطالعہ کروں گا۔
Rain in big city.	دادو شہر میں بارش ہويٴی۔
Rs100 billion for the development of underprivileged areas	پسماندہ علاقوں کی ترقی کے لئے 100 ارب مختص
Pigment dispersions are not suitable for Oil based products	پٹرولیم مصنوعات کی مصنوعی قلت کسی صورت قبول نہیں
Something in Korean.	کورسیرا پر کچھ مل سکتا ہے۔
I hold in my hand today's	میرے ہاتھوں پہ آج ظالم نے
According to Dr Dhawan, timing is very important.	ڈاکٹرمسرت امین سمجھتی ہیں کہ اس فیصلے کی ٹائمنگ بہت اہم ہے۔
So, dear friends, here's the tip.	تو دوستو ، تحریرکچھ یوں تھی۔
it blooms... but soon it dies.	پھولوں سے۔۔۔۔۔۔ مگر یہ جلد مرجھا جاتے ہیں۔
"John 8:32 famously stated, ""And ye shall know the truth, and the truth will set you free."""	John 8:32 اور سَچّائی سے واقِف ہوگے اور سَچّائی تُم کو آزاد کرے گی۔ یُوحنّا 32:8
I have tongue as well.	میں بھی منہ زبان رکھتا ہوں
Kinematics, in Chapters 2 and 3	پیدائش 3باب 2اور 3آیات:
Don't use old vehicles	لوگ ایسی پرانی گاڑیاں بھی نہیں چلاتے
"1, July 1, 2007, the Ministry of Construction to develop the street design standards ""urban road lighting design standards"" (CJJ45-2006) began to implement."	"یکم فروری کو ، ماحولیاتی تحفظ کی وزارت نے ""ماحولیاتی لیبلنگ مصنوعات کے فرنیچر کی تکنیکی ضروریات (HJ 2547-2016) "" کو سرکاری طور پر نافذ کیا ، اور ""ماحولیاتی لیبلنگ مصنوعات کے لئے تکنیکی ضروریات کا فرنیچر"" (HJ / T 303-2006) ختم کردیا گیا ."
[Pakistan's] biggest province Baluchistan, which comprises almost half its territory, is in a state of open revolt.	پاکستان کا رقبے کے لحاظ سے سب سے بڑا صوبہ بلوچستان جسکا کل رقبہ تقریباً آدھے پاکستان کے برابر ہے حالت جنگ میں ہے۔
Germans and Russians reports	جرمن اور روسی میڈیا کی رپورٹس
Socrates, The Way of the Peaceful Warrior.	از راہ چنارو ،کہ سلامت نا کنند .
You spent 17 years in prison under Enver Hoxha's regime.	آپ نے ۱۴سال ہارون الرشید کے قید خانہ میں گزارے.
got up and pled guilty.	اٹھیں لیکن اٹھیں وہ مجرمانہ
The Free-Form Effect	مفت نمونہ اثر
I don't think people are generally stupid enough to waste their time.	میرا خیال ہے کہ وہ ہماری طرح بے وقوف نہیں ہیں بلکہ سمجھدار لوگ ہیں جو اپنا قیمتی وقت برباد کرنا نہیں کرنا چاہتے۔
As a result, the American Registry for Internet Numbers (ARIN) was established as in December 1997, as an independent, not-for-profit corporation by direction of the National Science Foundation and became the third Regional Internet Registry.[174]	اس کے نتیجے میں ، امریکن رجسٹری برائے انٹرنیٹ نمبر (اے آر آئین) دسمبر 1997 میں قائم ہوا تھا ، نیشنل سائنس فاؤنڈیشن کی ہدایت پر ایک غیر منفعتی ، غیر منافع بخش کارپوریشن کے طور پر اور تیسری علاقائی انٹرنیٹ رجسٹری بن گیا۔ [143]
This is our Bombay.	یہ ممبئی ہے
"""Does man think that he will be left neglected (without being punished or rewarded for the obligatory du-ties enjoined by his Lord Allâh on him)?"""	Urdu 3: کیا انسان سمجھتا ہے کہ ہم اس کی ہڈیاں جمع نہ کریں گے
If you would like to opt-out of data collection by Google Analytics, you can find out more information here.	اگر آپ Google Analytics کو ضم کرنے کا فیصلہ کرتے ہیں، تو مزید معلومات دستیاب ہو گی.
Notable news items/price action moves over the past twenty-four hours.	Home / کاروبار / گزشتہ 24 گھنٹوں میں سونے کی قیمتوں کے حوالے سے ناقابل یقین تفصیلات آ گئیں
The supervisory body dedicated to ensuring that SAP provisions are fully implemented by all parties throughout the Black Sea region	گلگت بلتستان ایپکس کمیٹی کا اجلاس، نیشنل ایکشن پلان کے تمام نکات پر مکمل عمل درآمد کو یقینی بنانے کے لیے تمام اداروں کو بلا امتیاز کاروائی کی ہدایت
For example, lion and tiger.	پلیز سبسکرائب لائک اینڈ شیر
He said that it will also be his policy to provide facilities to the press clubs.	انہوں نے کہا کہ پریس کلب کو سہولتیں دینا بھی میری پالیسی ہو گی، ڈیجیٹل میڈیا کو مکمل سپورٹ دیں گے۔
Nigeria's problems are more than 50 years old!	شام کا مسئلہ تو تازہ ہے جب کہ فلسطین کا مسئلہ تو ٦٠ سال سے بھی پرانا ہے!!!!
Five protesters killed in Iraq's capital: Rights commission	افغانستان میں 5 پاکستانیوں کا قتل: دفتر خارجہ کا احتجاج، وزیر اعظم کا اظہار مذمت
Flip-flops needed at all times!	غم حسینؑ ضرورت ہے ہر زمانے کی!
But who has no knowledge of this?	اس کو کیا پہچانیے جس کا کوئی چہرا نہ ہو
Does not require any special software	ضرورت کوئی خصوصی سرور سوفٹ ویئر
I installed to the default.	ناکامیوں کی دار پہ لٹکا دیا مجھے
He said the finance ministry only obtained the information a few days ago.	ان کا مزید کہنا تھا کہ چند روز قبل وزارت ماحولیات نے خصوصی آڈٹ کروانے کا فیصلہ کیا ہے۔
It must clean up quickly.	جلد کو صاف رکھنا چاہیے .
"""Mo fella, see who will save you from me today..."""	"""اے محمد (صلی اللہ علیہ وسلم) اب بتاؤ میری تلوار سے آج تجھے کون بچا سکتا ہے ؟"""
We can choose our friends, but not our ancestors.	ہم دوستوں کا انتخاب کر سکتے ہیں مگر ہمسایوں کا نہیں۔
JavaScript known as JS is a lightweight, cross-platform, object oriented scripting language.	JS زبان کی خصوصیات: اسکرپٹ ، عملدرآمد ، آبجیکٹ پر مبنی ، سادہ ، متحرک ، کراس پلیٹ فارم کی وضاحت کریں۔
There exists a secre...	ایک سائبان موجود ہے...
Ang 3 is the fourth smartphone from OnePlus - a small Chinese startup aiming to provide the best experience possible product for significantly less money than rivals - and is a big step in all directions over last year's OnePlus 2.	The 3 OnePlus سے چوتھی اسمارٹ فون ہے - ایک چھوٹا سا چینی ابتدائیہ حریفوں کے مقابلے میں نمایاں طور پر کم پیسے کے لئے بہترین تجربہ ممکن مصنوعات فراہم کرنے کے مقصد - اور تمام سمتوں میں ایک بڑا قدم ہے گزشتہ سال کی OnePlus زائد 2.
Enter the desired channel number.	.7 مطلوبہ نمبر داخل کریں۔
This ensures your safety at all times.	نیز یہی ہاتھ ہی انھیں ہر موقع پر تحفظ فراہم کرتا تھا.
Statement of Work: A detailed statement of what activity or work is to be done.	۳۔ استفہام:کسی فعل یا سرگرمی کے بارے میں استفسار کیا جاتاہے ۔
This is further proof of his faith?	کیا ڈو ثبوت اپنی وفا کا اس سے بڑا
Boredom is integral to the process of taking one's time	انٹیگریٹڈ اصل وقت آلہ مطابقت کرنے کے لئے گھڑی
6.5 You can only rent referrals when they are available and within the limits of your current membership.	جب آپ دستیاب ہیں اور آپ کی موجودہ رکنیت کی حدود کے اندر ہی آپ صرف ریفرل کرایہ کر سکتے ہیں.
"I woke up and I went ..."""""	"گھر سے بھگایا ہے میں نے... ""اٹھتے ہوئے.."
Students in France won't be allowed to wear any garments	یو ای ٹی میں طالبات جینز نہیں پہنے گی
Today and Tomorrow8.	8: آج، گزشتہ کل، آئندہ کل، اور آئندہ کل کے بعد؟
the language alive.	Idiom زندہ رہنا ۔
"""But it is the Law."""	"""مگر یہ قانون ہے"""
The art is rich.	آرٹسٹ ہی تو امیر ہوتا ہے۔
"The Honored Qur'an expresses the importance of the revelations given to Moses: ""It was We who revealed the law (to Moses): therein was guidance and light...."	تاریخ سے آگاہ رہو؛ہم جناب نے موسیٰ (علیہ السلام) کو نو عدد آیات عنایت کی تھیں جو اپنے آپ میں حقیقت کی جانب رہنمائی کرنے والے بےنظیر مشاہدات پر مبنی تھیں ۔ (حوالہ الاسراء۔101)
Opening a small company doesn't need to involve a lot of money, but it is going to involve a few investment.	ایک چھوٹا سا کاروبار کھولنے میں بہت سے پیسہ شامل نہیں ہے، لیکن اس میں کچھ سرمایہ کاری شامل ہوگی.
The Dark Ages: an age of light	上傳者: عمر نور
Text features will be added as well.	اشعار بھی شامل تحریر کیے جائیں.
Thank you Chris, again a very well written, easy to understand, article.	شکریہ منتظم ، میں نے ایک بہت ہی پر جوش مضمون ، مختصر ، سمجھنے میں آسان ، قاری کی ضرورت کے مطابق ، لکھا ہے
With latex, though, you're not at risk.	ہم محفوظ لنکس کے ساتھ، آپ بالکل خطرہ نہیں اٹھا رہے ہیں.
mountains through that pass, the Byzantine army was ambushed and	گا ---- اس سے پہلے کہ یہ پشین فتنہ پوری طرح سر اٹھاۓ فوج اور
Is Torcello flooded, do you know?	لہو لہو زہر گھل چکا ہے ، بتاؤ تو تمہیں کیا پتا ہے؟
Where were the protests during the previous eight years of former President George W. Bush's administration, when they were in control?	مذکورہ معاہدوں پر مذاکرات کا آغاز چار سال قبل سابق صدر جارج ڈبلیو بش کے دور میں ہوا تھا جبکہ امریکی کانگریس نے حال ہی میں ان کی توثیق کی تھی۔
Although in later periods the leadership of Azad Kashmir made several attempts to bring Gilgit-Baltistan under its control again, for example in 1972 the Azad Kashmir Legislative Assembly passed a resolution in this regard while the independent state of Jammu and Kashmir Gilgit-Baltistan has also been declared a part of Azad Kashmir in the 1974 Interim Constitution.	اگرچہ بعد کے ادوار میں آزاد کشمیر کی قیادت نے گلگت بلتستان کو دوبارہ اپنے زیر کنٹرول لانے کی کئی بار کوششیں کی، مثال کے طور پر سال 1972 میں آزاد کشمیر قانون ساز اسمبلی نے اس بابت ایک قرارداد بھی پاس کی جبکہ آزاد ریاست جموں و کشمیر کے عبوری دستور 1974 میں بھی گلگت بلتستان کو آزاد کشمیر کا حصہ قرار دیا گیا ہے۔
A wallet benicar fda approval is a small personal database that is stored on a computer drive, smartphone, tablet, or in the cloud.	بٹکوئنز کا کاروبار ایک ذاتی پرس سے دوسرے پر ہوتا ہے۔ پرس ایک چھوٹا سا ذاتی ڈیٹا بیس ہے جو کمپیوٹر ڈرائیو ، اسمارٹ فون ، ٹیبلٹ ، یا کلاؤڈ میں محفوظ ہوتا ہے۔
PCIT consists of weekly sessions.	پیر کو شامل ہوتا ہے ہفتہ وار سلسلہ بزنس۔
There are a few groups with a strong emphasis on Latino literature:	مولانا سے انتہائی ادب کے ساتھ چند سوالات ہیں:
In no particular order: Go on an African safari	Next: شاہد آفریدی کے لیے الوداعی میچ نہیں تقریب
Minister of Petroleum and Natural Gas is sitting here.	اس موقع پر مرکزی وزیر پٹرولیم اور قدرتیگیس موجود ہوں گے۔
It was a very memorable program.	یہ ایک بے حد خوبصورت یادگار پروگرام تھا۔
Then again, who doesn't??	سرفراز نہیں تو پھر کون ؟؟
that's a lot of fish.	واہ ، یہ بہت سی مچھلی ہے۔
Pastor Monte preached on Romans 10:17.	ڈاکٹر میگی Dr. McGee نے رومیوں10:17 کے بارے میں کہا،
I want to walk with the wind	ہوا کے ساتھ چلنا چاہتا ہے
I would like to deposit money into my account.	میں اپنے اکاونٹ میں پیسے جمع کروانا چاہتا ہوں-
Stand up and shut up!, page 1	کھڑے ہو جائیں اور اِسے گائیں - دوسرا بند!
Actions to meet the Paris Agreement goals would cost around one per cent of global GDP.	پیرس کے اہداف کو پورا کرنے کے اقدامات عالمی جی ڈی پی کے 1 فیصد کے ارد گرد لاگت آئے گی.
One teacher, many students.	١ - طالب علم، بہت سے شاگرد۔
Now I'm fine thanks to my doctor.	اور ظاہر ہے میرے ڈاکٹر کے پاس بہت شکریہ مجھے بچایا!
1981: Launch of the .	۱۹۸۱: پرنسس دیانا
Sonia put down the phone.	یہ کہہ کر تھانیدار نے فون بند کر دیا۔
But the country was economically very weak.	ملک معاشی طور پر بڑا کمزور ہے.
the Qur'an several times.	اس کا بیان کرتا ہے قرآن بار بار
Press and hold the on/off button till you hear the drum sounds.	"بجلی بند: ایم ایف کے بٹن کو دبائیں اور پکڑو جب تک کہ آپ ""پاور آف"" نہ سنیں۔"
Cobb thought how best to put it into words.	فارب سوچ رہا تھا کن الفاظ میں اسے تسلی دے ۔
37:7 eccu, I will send a spirit to him, and he will hear a message, and he will return to his own land.	37:7 دیکھو, میں نے اس سے ایک روح بھیج دیا جائے گا, اور اس نے ایک پیغام سن لیں گے, اور وہ اپنے ملک کو واپس آ جائیں گے.
"""The tens of thousands of Americans who rest in Europe's cemeteries are a silent testament to just how intertwined our prosperity and security truly are, and the path you choose now will echo in the prospects of today's generation of Americans as well."""	انہوں نے لکھا ہے: 'دسیوں ہزار امریکی جو یورپ کے قبرستانوں میں ابدی نیند سورہے ہیں وہ اس بات کے خاموش گواہ ہیں کہ حقیقی معنوں میں ہماری خوشحالی اور سکیورٹی ایک دوسرے کے ساتھ کس قدر مربوط ہے۔ اور جس راستے کا آپ اب انتخاب کریں گے اس کی بازگشت امریکہ کی موجودہ نسل کے مستقبل کے امکانات میں بھی سنی جائے گی۔'
Mexican Film.	میکسیکن فلمیں
"""Become my servants."	تو میرا دل ہے میری جان منڈیراں والے
Northern American Canada is in North America.	کینیڈا شمالی امریکا میں ہے-
It has been on the market for 15 days.	بڑی بات یہ کہ یہ کتاب پندرہ دن پہلے مارکٹ میں آئی ہے.
Are you thinking about trading on the foreign exchange market?	کیا آپ غیر ملکی کرنسی مارکیٹ میں سنجیدگی سے سرمایہ کاری کے بارے میں سوچ رہے ہیں؟ آپ کو ہونا چاہئے.
Tell your doctor if you have ever had an allergic reaction to anothe...	ڈاکٹر کو مطلع کریں اگر آپ کے استعمال کے ساتھ الرج ردعمل کی کوئی تاریخ ہے
Peace in your time, Mr. Senate President.	سلام آپم وقت کردی سر بزن.
What's more new?	اس سے زیادہ نیا اور کیا؟ - ہم سب
Can't say much about the drinkability.	شراب کے بارے میں اور نہیں بول سکتا ہے - بالکل ممکن ہے.
Who was the leader in Israel in 1948?	اور کون تھا اسرائیل کے پیچھے ۱۹۴۸ میں؟
What is the scientific name for the lion?	شیر کا سائنسی نام کیا ہے؟
The 2011 LG ICC Awards were held on 12 September 2011 in London in England.	آئی سی سی ایوارڈز 2011ء کی پرشکوہ تقریب 12 ستمبر کو انگلستان کے دارالحکومت لندن میں منعقد ہوگی۔
My Great Granddaughter is going to love it.	میری بڑی بیٹی اس سے محبت کرے گی
Or can i use a arduino.	شكل آئرودینامیكی دیسك
Nothing screams summer like The 4th of July.	ہماری کتاب میں ، موسم گرما کی طرح کچھ بھی نہیں کہتے ہیں جولائی کا چوتھا .
Part of the site was also set on fire.	عمارت کے ایک حصے کو آگ بھی لگائی گئی۔
Elbit will supply kits to upgrade and operate the Greek T-6 aircraft, as well as provide training, simulators and logistical support.	ایلبٹ یونان کے T-6 ہوائی جہاز کو اپ گریڈ کرنے اور چلانے کے لئے کٹس فراہم کرے گا اور اس کے ساتھ تربیت ، سیمولیٹرز اور لاجسٹک سپورٹ بھی فراہم کرے گا۔
Do you believe that the person who commits suicide will go to hell?	شوہر کویہ جملہ بولنے والی عورت ضرور جہنم میں جائیگی؟
Kai-Fu basically said that in ten years half of the jobs will be replaced by robots.	فواد چوہدری کا کہنا تھا کہ دس سالوں میں ٹرانسپورٹ کا چالیس فیصد الیکٹرک پر چلے جائیں گے، ہمیں اندازہ کرنا ہو گا کہ کون سی نوکریاں کم ہو رہی ہیں، اس ٹیکنالوجی کا شہریوں کو فائدہ ہوگا۔
the John Hancock tower and nearby buildings	رنکو گيټ ټاور بلډنگ - ويکيپېډيا
The US Treasury still owns 8,133 tonnes of gold.	امریکی حکومت کے پاس 8133 ٹن سونا ہے۔
So you know that that's what we ended up with.	اور دانستہ۔ یہ دَر باز کیا ہے ہم نے
contacts in 2005 are now in prison.	۲۰۰۱ میں ڈھیر ہونے والا کتا اب جیل میں ڈھیر ہے۔
"""You should not walk around at night on your own."""	"""آپ کو خود ہی رات کے اوقات گھومنا نہیں چاہئے۔"""
14 Wherefore do I take my flesh in my teeth, and put my life in mine hand.	14 میں خود کو خطرے میں ڈال رہا ہوں اور میں اپنی زندگی اپنے ہاتھوں میں لے رہا ہوں۔
roles in reducing the body's water content.	جسم سے پانی کا وزن کم کرنے کے ٹوٹکے.
Ah, but you know that it can be.	با ت یہ جاناں تمھاری ہوبھی سکتی ہے
Penguins - Children's	Kids Mag - بچوں کے میگزینز
With his past and his job and his [...]	اپنے کام اور اپنے امور و معاملات کو اس [...]
Is it essential to solve this issue?	یہ ضروری ہے حل کرنا؟
This is happening all over the country	پورے ملک میں یہی حال ہے جناب
A house in Australia.	آسٹریلیا میں ایک حام...
The students get there at 8:00.	میرے شاگرد سات بجے سے تھوڑا پہلے وہاں پہنچتے ہیں
Most people cannot get these at any price.	... لیکن زیادہ تر لوگ ، ہر قیمت پر اس نتیجہ سے بچنا چاہتے ہیں۔
During the years in which I worked on	جہاں میں کام کرتا ہوں وہاں پر سال یعنی
Phase 3 then tests the safety and efficacy of the vaccine in a larger group of people.	فیز 3 کا مطالعہ لوگوں کی وسیع آبادی میں ویکسین کی حفاظت اور تاثیر کی جانچ کرے گا۔
April 30 Student Services office.	گورنمنٹ سکولزسینئر سٹاف ایسوسی ایشن کے انتخابات30مارچ
"""For my child, this is a dream come true."	میرے بیٹے کو مائی لے لو یہ ایک خواب سچ ہو گا.
"""If any do deeds of righteousness - be they male or female - and have faith, they will enter Heaven, not the least injustice will be done to them"" (4:124)."	ترجمہ:جو بھی نیک کام کرے گا، چاہے وہ مرد ہو یا عورت، اگر صاحب ایمان بھی ہو تو ان سب کو جنت میں داخل کیا جائے گا۔
A baby in the car was uninjured, again TBTG.	کم سن ملتانی بچہ ایک مرتبہ پھرسے گاڑی لے کر نکل گیا، ویڈیو وائرل
Hawai'i: prelude to a journey.	Prague: سفر کا انتخاب کریں
Now in its 28th year, ATM 2021 will go-ahead at the Dubai World Trade Centre (DWTC) on Sunday 16 to Wednesday 19 May, as final preparations are being put in place	اب اپنے 28 ویں سال میں ، اے ٹی ایم 2021 اتوار ، 16 مئی سے بدھ ، 19 مئی کو دبئی ورلڈ ٹریڈ سینٹر (ڈی ڈبلیو ٹی سی) میں آگے بڑھے گا ، کیونکہ حتمی تیاریوں کا سلسلہ جاری ہے۔
In such a case, you should consider removing one or two layers off the baby and relaxing them.	اس صورت میں، آپ کو دشواری سائٹ میں ایک یا دو ڈراپ منشیات کو چھوڑنے کے لئے اور اسے جذب چھوڑنا ہوگا.
Tomate at 30.	کیک پخت 30 دقیقه.
There's going to be 99% of people who fail.	واقعی؟ 99 فیصد لوگ ناکام ہو جائیں گے؟
It's not a lie...Uggla is streaky.	نہیں یہ سب جھوٹ ہے...بکواس ہے
Dude i'm not complaining.	ہے ُشکر کی جگہ کہ شکایت نہیں مجھے
The new synopsis adds a little more to what we already know.	نئے تجاوز کو مزید معلومات فراہم کرتا ہے جو ہم پہلے ہی جانتے ہیں.
Get down off your horse....	"""یہ گھونگھٹ نکالو اپنے اپنے۔۔۔۔"""
Let's talk about regional stats.	اب سٹیٹس سکوں خود کے بارے میں بات کریں.
I hope I have a unique voice.	میں نے لوگوں کو ایک منفرد آواز حاصل کیا یقین ہے.
This letter is from you to the company.	""" یہ فلیٹ آپکو کمپنی کی طرف سے دیا جا رہا ہے """
He also gained 50 pounds.	اور وہ بھی 120 پاؤنڈ مل گئے.
I had NO idea how much my life would change.	میرے پاس کوئی اندازہ نہیں تھا تو اس بات کا اندازہ کتنا ہی زیادہ ہے کہ میری زندگی بدل جائے گی.
India to host Kabaddi World Cup in October 2016.	انڈیا کبڈی ورلڈ کپ 2016ء کا میزبان ، اکٹوبر میں انعقاد
I've been a motorcyclist for a LONG time..	میں طویل عرصے سے موٹر سائیکل کی سواری پر انحصار کرنے ...
She gives me a great perspective on life.	اور مجھے زندگی کا ایک بڑا ٹکڑا دیتا ہے۔
Christians have to start allowing the Word of God to be the foundation for their thinking.	قادیانیوں کو چاہئےکہ مرزاقادیانی نے جوخدا کا تصور پیش کیا اس کو ملاحظہ فرمالیں تاکہ کچھ سوچنے کا موقع مل سکے،
When a company looks for competitiveness, it means that it is considering new methods of business and market strategies that offer you a positive and transcendent, and thus evolution to adapt to the current economic model.	جب کوئی کمپنی مسابقت کی تلاش کرتی ہے ، تو اس کا مطلب یہ ہے کہ اس میں اضافہ ہو رہا ہے کاروبار کے نئے طریقے اور مارکیٹ کی حکمت عملی جو اسے ایک مثبت اور مافوق ارتقاء بخشتی ہے ، اور اس طرح موجودہ معاشی نمونے کو اپناتی ہے۔
Immerse you in the world of the night.	عالم میں نشے کے شب مہتاب نے تیرے
"Oates, ""Where Are You Going, Where Have You Been"""	"صاعقہ: "" کیا کر رہی ہو، کہاں جا رہی ہو، کون آ رہا ہے...."""
I felt like it was all getting on top of me.	مجھے لگا جیسے سب نے بھاگ کر اپنے اپنے گٹھڑ اٹھا لیے ہوں.
"""Everyone here is terrified."	یہاں سب خوف میں ہیں سانس لیتے
"""He recognized the car."	وہ شاید اس کار کو پہچان گیا تھا....
Becky didn't attend this year.	مولا اس سال آپ کے پاس نہ آسکے
Because of this, he was unable to finish his education.	اور یہ کس مجبوری کی وجہ سے اپنی تعلیم مکمل نہ کر سکیں.
AADB is a nonprofit 501 (c) (3) organization governed by a board of directors, the majority of whom are deaf-blind.	کوسانس فاؤنڈیشن ایک غیر منفعتی ، 501 (c) (3) مخیر تنظیم ہے۔ صفر کے اوور ہیڈ کے ساتھ ، 100٪ آپ کا چندہ ہیتی لوگوں کو جاتا ہے۔
10. on the contrary	کے برعکس میں
minutes later.Immediately after the	عصآهہ بعد آن يبصر ♡
helped us achieve this goal.	انہوں نے ہمیں اہداف پر ہمارے شاٹ لینے میں مدد؛
"They don't understand "" just looking""!"	"صرفا"" احساسشاטּ در هماטּ لحظہ است!"
It was the key play of the game.	وہ میچ کا اہم موڑ تھا.
the applause of his	اما سندس فرحت ❤️
and the winners...	اور اب فاتحین -
Home / Decoration / This bike rack is so easy and quick to make that it is ideal for the whole family on a weekend.	Home / اہم خبریں / روزانہ اس فروٹ کا جوس پی لیں یہ اس قدر طاقتور ہے کہ صرف ایک ہفتے میں جگر ، معدے کاتمام گند صاف کر دیگا
They occurred over a period of 10 months in 1952-1953, though there was also vicious fighting both before and after these engagements.	انہوں نے 1952-1953 میں 10 ماہ کے عرصے تک واقع ہوا، تاہم ان مصروفیات سے پہلے اور بعد میں بھی اس کے خلاف جنگجوئی لڑائی ہوئی تھی.
Funding your account can be made using the most popular payment systems.	الیکٹرانک ادائیگی کے سب سے مشہور سسٹموں کا استعمال کرتے ہوئے کھلاڑی اپنے اکاؤنٹ میں جمع کراسکتے ہیں:
Cheri saw it in his eyes.	بریرہ نے اسکی آنکھوں میں دیکھا.
You've gotta get out of this place!	یہاں سے چلے جائو، تمہیں یہ ملک چھوڑنا ہو گا۔
Information generated within the organization including computer programs, is the property of Din Textile, and should not be disclosed without proper authority and authentication unless legally required.	کمپیوٹر پروگرام سمیت تنظیم کے اندر پیدا کی معلومات، دین ٹیکسٹائل کی ملکیت ہے، اور مناسب اتھارٹی اور تصدیق کے بغیر انکشاف نہیں کیا جانا چاہئے قانونی طور پر ضرورت ہے جب تک.
So embarrassing for his family.	اور اس کے خاندان کو شرمندہ کرنا کتنا سہل ؟
who is the best dressed	کون اس سے بہتر پہنتے تھے
We are needing support.	حمایت کی ضرورت ہے.
I'd get him out of my life.	اسے اپنی ذندگیوں سے نکال دوں گا
We'll kill the pain	کہاں جائیں ہم دردِ فرقت کے مارے
In Other Words: Yes, we utilize Google Maps for the function of providing better service.	مختصراً: ہاں، ہم Google Maps کا استعمال بہتر خدمات فراہم کرنے کے مقصدسے استعمال کرتے ہیں.
Are We Punished for the Wrongs of Others?	کیا ہم پر کسی کی بد دعا ہے
Main article: Mobile operating system	زمرہ:موبائل آپریٹنگ سسٹم
(Who is that soembody?)	(یہ قطار سوی کس جا ہے؟)
And if he has time at his disposal, even to offer one Rak'at of prayers, he should offer short prayers.	اور اگر ان دنوں کے درمیان میں کسی بھی وقت مخصوص جگہ مکمل طور خشک ہو جائے ، چاہے چند گھنٹوں کیلئے ہی کیوں نہ ہو، تو اس خشکی کو طہر شمار کیا جائے گا، چنانچہ عورت غسل کر کے نمازیں ادا کرے گی۔
I thought they were just legally separated.	میں سمجھا تھا کہ بس رسمی تعلق ہے مرا اُن سے
Listen to the audio:.	آڈیو سنیئے:
Learn in five minutes.	اسے 5 منٹ میں سیکھیں
for resettlement throughout the United States was not a sudden, spur-of-the-moment decision.	برطانوی عوام کا فیصلہ کوئی اچانک یا غیریقینی بات نہیں ہے، اور نہ ہی یہ کوئی انہونی ہے.
Isolate the disobedient	گندگی ڈسپوزل کو ہٹا دیں
"""They all struggle."	'لیکن وہ لڑائیاں تو سب کی لڑتے ہیں '
Thank you, Paul did a good job.	شکریہ پابلو ، اس نے عمدہ کام کیا ہے۔
He heard the sounds of the party coming from inside.	اس نے غور کیا آواز اس کے اندر سے آ رہی تھی
Call Girls Yalding are waiting for you.	Omegle کی لڑکیاں چیٹ کریں ہمیشہ آپ کے لئے انتظار کریں گے.
In my own experience, I have suffered many of these injuries.	ابتدائی میری زندگی میں، میں نے ان تجربات میں سے بہت سے تبرکشیت کیا گیا تھا.
I have been so busy with French.	میں فرانسیسی کے ساتھ ایک طویل وقت گزارا.
"In Matthew 7 Jesus says, ""Do not judge, or you too will be judged."	"میتھیو میں 7 یسوع کہتا ہے, ""فیصلہ نہ کرو, یا آپ بھی فیصلہ کیا جائے گا."
More than 45 lakh people across the world have recovered from the infection.	دنیا بھر میں اس وبا سے اب تک پچپن لاکھ سے زائد افراد صحت یاب ہوئے ہیں۔
Not trying to come off mean at all.	کوئی نہ کوئی معنی دینے کی کوشش میں پاگل ہے
(628) Why didn't you send me to him in the first place?	٦ - بھلا اس نے تمہیں یتیم پا کر جگہ نہیں دی؟ (بےشک دی)
Egypt game (3)	◄ مصر کھیل سانچے  (3 ز)
we are recommending to you.	ہم آپ کو اس کی سفارش کرتے ہیں.
You can give access to other people without giving them a key	آپ اپنی بات دوسروں کو گالی دئیے بغیر بی کر سکتے ہیں
"""Perhaps its time for us to move on."""	شاید ابھی تمہارا وقت نہیں آیا، خواھش کے راستے پر چلنے کا.'
I'm also going to make this adorable dress:	میں تمہیں بتاؤں ' میرا بھی دل کرتا ہے کے میں وہ خوبصورت لباس...
5: tells us that Christ prayed unto Him that was able to save Him out of death	II۔ دوسری بات، تلاوت ہمیں بتاتی ہے کہ مسیح نے خُداوند سے دعا مانگی تھی، جو گتسمنی میں اُسے موت سے بچانے کے قابل تھا۔
He put her in a room.	اس کو اہنے ایک کمرے میں لے گیا
Lyrics to 'Fuckin' Perfect' by P!nk.	چنیں پرستار: 'F**kin' Perfect' سے طرف کی P!nk
He provides exposition.	وہ دیتا ہے کسی بھی پریزنٹیشن کی طرف لاتا ہے.
the names of the few constellations	محض چیزوں کی مشابہت کا نام
You will be required to go through a security screening with bags going through a scanner.	کرنے ہوتے ہیں۔ سیکیورٹی کے لئے آپ کو دستی سامان سمیت سکینر سے گزرنا
The one who conceived and bore you	وہ جُنوں ، چھین لیا، حِرص و ہوس نے تجھ سے
When I broke down the door, he disappeared.	میں نے دروازے کو دھکیلا تو وہ کھلتا چلا گیا .
We got that and so a lot more.	ایک کو مل گیا اور اس کی طرح بہت زیادہ.
It is a real association.	یہ ایک حقیقی یونین ہے.
And that's a tradition we'll never stop.	یہ ہمارے مشن ہے، ہم کبھی نہیں روکیں گے.
London's biggest fashion shows, with their	لندن فیشن ویک اپنی رعنائیوں کے ساتھ جاری
"""My grandfather used to breed birds."	دادا کا اوڑھنا بچھونا کتابیں تھیں۔
Yes, it looks just like you think it looks.	ہاں بھئی جیسے وہ تم لوگوں پے نظر رکھتی ہے لگتا تو ایسا ہی ہے..
Yeah, you have quite a long list there.	ارے واہ آپ کے پاس تو کافی لمبی لسٹ موجود ہے۔
Cherokee are a Native American people historically settled in the Southeastern United States (principally Georgia, the Carolinas and Eastern Tennessee).	چروکی (Cherokee) ایک مقامی امریکی قوم ہے جو تاریخی طور پر جنوب مشرقی امریکا میں آباد رہے ہیں (بنیادی طور پر جارجیا، شمالی کیرولائنا، جنوبی کیرولائنا اور مشرقی ٹینیسی) ۔
HWP: Litany of Our Lady of Fatima	اردو: فاطمہ کی ہماری خاتون
Libya: A drone operated by the United Arab Emirates was reportedly responsible for the deaths of 26 unarmed cadets at a military academy in the capital Tripoli in January of this year.	بی بی سی کو اس حوالے سے نئے ثبوت دستیاب ہوئے ہیں کہ متحدہ عرب امارات کے ایک ڈرون نے جنوری 2020 میں لیبیا کے دارالحکومت طرابلس کی ایک ملٹری اکیڈمی میں 26 غیر مسلح کیڈٹس کو ہلاک کر دیا تھا۔
understand what I've written;)	جو کچھ سمجھ چکے ہیں وہ لکھیے 🙂 😉
This game is fundamental for both teams: Man.	یہ میچ دونوں ٹیموں کے لیے انتہائی اہمیت کا حامل ہے - فوٹو: اے ایف پی
I will miss you kind heart.	آپ کی قیمتی ٹپس کے ساتھ آپ کی کمی بھی محسوس ہو رہی ہے
(Ancient answers for modern issues).	(مالی معاملات سے متعلق جدید مسائل کے شرعی احکام)
b: a chapter of a book	Tag: ایک کتاب کی آپ بیتی
I'm from North.	میں شمال سے ہوں۔
We have both been trying hard.	ہم دونوں نے بہت کوشش کی.
You have really gone over the edge.	واقعی آپ نے تو حد ہی کر دی ۔
Literary fiction tends to be a small, indie-press thing.	تحریری اسلوب لازما کسی ہندوستانی لہجے والا ادبی یا نیم ادبی ہوجاتا ہے.
A year earlier, Alvin's personnel	پہلے زیادہ سے سال ایک by alvinoh
In Saudi Arabia for the first time in the history of the executed Prince _ News from Ukraine	ملکی تاریخ میں پہلی بار سعودی ولی عہد کی پاکستان آمد ۔۔۔کب آرہے ہیں ؟اعلان ہو گیا - Pak Online News
Life doesn't stop for people that go slow.	کسی کے چلے جانے سے زندگی رک نہیں جاتی ہاں سست ضرور ہوجاتی ہے .
That is why I asked the state to expedite the utilisation of vaccines.	ہے اور حکومت سے اپیل کی ہے کہ ویکسین لگانے کا سلسلہ بھی تیز کیا جائے۔
When you're not ready	کو تیار نہیں۔ جب ہم
This multi-sport Games is larger than the Olympics.	اس موقع پرحفاظتی انتظامات اولمپک کھيلوں سے بھی زيادہ ہيں
These were the divisions of the doorkeepers; of the sons of the Korahites, and of the sons of Merari.	اللہ معاف ہی رکھے ایسی سیٹوں اور نوکریوں سے۔: (کالم ضرور شیئر کیجئے گا اور زرداری کے بچوں والا کیا معاملہ ہے؟
The V Drive-In Theatre, on the Vestal Parkway, was one of several drive-in facilities.	ہم بی-لائن موٹر سائیکل پارک میں تھے، جن میں سے ایک کیلگری کے تفریحی سہولیات میں سے ایک ہے.
The day will have 10 hours, not 24.	مسقبل میں دن 24 گھنٹے کا نہیں بلکہ 25 گھنٹے کا ہو گا،
Lye, Oatmeal.	لائمہ ۔ ملامت کرنے والی ۔
"""Why?,"" I wrinkled my nose."	"""کیوں ؟""میرے مونہوں نکلیا۔"
Randomblings from Rich: There are certain foods....	لندن: ماہرینِ غذائیت کا خیال ہے کہ بعض غذائیں ...
Lama Sönam: Yes, jealousy, and pride, and sadness.	تصنيف اڷـآنميے: درآمآ ، مغآمرآت ، خيآڷ عڷميے
The question, which divides us, is whether it is crazy enough to have a chance of being correct.	سوال یہ ہے کہ جو ہمیں تقسیم کیا یہ درست ہونے کا ایک موقع ہے کے لئے کافی پاگل ہے.
VVD (People Party for Freedom and Democracy).	Mark Rutte (آزادی اور جمہوریت کے لیے پیپلز پارٹی)
In more than 100 languages.	100 سے زیادہ زبانوں میں
Why, if God loves, is there so much pain and suffering in the world?	سوال نمبر1۔ بعض اوقات میَں حیران ہوتا ہوں کہ کیا خُدا مُجھ سے محبت رکھتا ہے۔ اگر وہ محبت کرنے والا خُدا ہے، پھر کیوں دُنیا میں اِتنا غم اور تکلیفیں ہیں؟
To set the date and time on an iPhone photo	کسی آئی فون کی تصویر پر تاریخ اور وقت مقرر کرنا
It's by far not the most important thing in life.	واقعی زندگی میں اہم ترین اسکے سوا کچھ بھی نہیں لگتا...
Brave or Crazy...	ضرورت یا پاگل پن؟ ....
A few days later, Nadia phoned.	ٹھیک کچھ سیکنڈ بعد نایاب نے اسے پکارا تھا
Directions to HPD.	ZIP کے لیے ہدایات۔
What happened at the 1968 Democratic Convention in Chicago?	1968 کے جمہوری کنونشن میں کیا ہوا؟
Romans 11:4 But what is the divine response to him?	11:4 لیکن اس کے پاس الہی ردعمل کیا ہے?
I blame it on being an artist.	میں اس کے لئے ہٹانا چاہتا ہوں کیونکہ وہ ایک فنکار ہے.
It is popularly said that there is no permanent enemy or permanent friend in politics.	کہ سیاست میں کوئی کسی کا مستقل دوست یا دشمن نہیں ہوتا.
We move from darkness into the LIGHT.	ہم اندھیروں سے نکل کر روشنی کی طرف سفر کرنا ہی نہیں چاہتے.
best dishwashing machine under 500.	Matt 500 کے تحت بہترین توشک
Don't waste Mads in shit like this.	تم نے میرٹ کی بنیاد پر اس طرح گندگی فیصلہ نہیں کرتے.
Contract workers are encouraged to spend more time at the office.	زرائع کے مطابق دفتر میں اوقات کار سے زائد وقت دینے پر ملازمین کو اوور ٹائم دینے کی تجویز بھی زیر غور ہے۔
But it will come, one day, and change the world!	لیکن ایسا ہو ا تھا۔۔۔ یہی ایک منٹ ، دنیا بدل دیتا ہے۔
Commission of the European Union (5)	یونین علاقہ (5)
Thank you again from the bottom for my heart.	میرے دل کے نیچے سے ایک بار پھر آپ کا شکریہ.
"""The stone is heavy,"""	"""دیکھا کہ یہ پتھر بھاری ہے"""
I'm a full-stack software developer	میں ایک مکمل اسٹیک سافٹ ویئر ڈویلپر ہوں۔
The USA has two major parties.	برطانیہ کی دو بڑی پارٹیاں ہیں.
*Affiliate links are used in this post to help you find items that are mentioned.	* اشعار میں مختلف جگہوں پراضافت کا استعمال ہوا ہے، ایسے الفاظ تلاش کر کے لکھے ۔
Is it more important for children to play or to study?	ریسٹورنٹ اور مالز میں بچوں کو بھیجنا زیادہ ضروری ہے یا اسکول میں ؟
Here are a few simple options that you and your friends can try.	یہاں پر کچھ آسان طریقہ ہے جو تم اور یا تمہارے دوست تبدیلی لانے کے لیئے کر سکتے ہیں۔
In the aftermaths, Sri Lanka announces an end to the forced cremations, marking a win for the island nation's minority Muslims.	سری لنکا نے جزیرے کے اقلیتی مسلمانوں کے لئے فتح کا جشن مناتے ہوئے زبردستی قبرستان ختم کرنے کا اعلان کیا۔
come on.... are u for real?	آ ہم آ ہم کیا تم واقعی سیر یس ہو ؟
Pig (disambiguation) - A pig is an animal.	سيبل (ڈس ایمبی گو ایشن) - ایک ممالیہ جانور ہے
A limited warranty of 10 years	● 10 سال محدود وارنٹی
he was in the garden	یہاں تھا وہ باغ
I'm learning how not to feed the lies.	سیکھ نہیں پا رہا ہوں میٹھے جھوٹ بولنے کا ہنر
time and all the ages by its distance from the present?	ہر فاصلہ اور وقت کیا آپ نے تسخیر- تھی دیدنی بندے کی بڑائی شبِ معراج
Are you already in a position to sell?	اور تم، کیا آپ پہلے ہی انسٹاگرام پر بیچنا جانتے ہیں؟
There are no speed limits on the German Autobahns.	جرمن موٹر ویز پر رفتار کی حد مقرر نہیں کی جا رہی
In India, executions are rarely carried out here, with just three recorded in the last decade.	انڈیا میں بہت کم ہی سزائے موت پر عمل درآمد ہوتا ہے۔ گذشتہ دہائی میں ایسا صرف تین بار ہی ہوا ہے۔
B. Please come tomorrow.	(C) براہ مہربانی کل ضرور آئیں
How they can be used in small business loans?	چھوٹے کاروباری قرضے کیسے استعمال کیے جاسکتے ہیں؟
Despite the fact that the human body can naturally produce hgh.	کیونکہ HGH انسانی جسم میں قدرتی طور پر پیدا کیا جاتا ہے کیونکہ، HGH کے ضمنی اثرات نایاب ہیں.
If the source of whole grain is not listed as the first ingredient, then it probably contains very little.	اگر پورے اجزاء کا ذریعہ پہلی اجزاء کے طور پر درج نہیں کیا جاتا ہے، تو شاید یہ شاید بہت کم ہے.
"""Perhaps he has merely run away."""	'یہ بھی تو ہوسکتا ہے کہ وہ محض گھومنے آیا ہو - '
"""The United States is exploring all avenues to advance a peace process in close consultation with the Afghan government,"" a State Department official had said."	"اسٹیٹ ڈپارٹمنٹ کے ترجمان نے ایک بیان میں کہا ہے کہ ""امریکہ افغان حکومت کی مشاورت سے امن عمل کو آگے بڑھانے کے لیے تمام ممکنہ راہیں تلاش کر رہا ہے۔"""
I'd say the money is yours.	وزیر اعظم کا کہنا تھا کہ یہ رقم آپ کی ہی رہے گی۔
(e) the period during which the course is to be	(م) مصروفِ تبسم جو کہیں ہو گا اُسی کو
million people of California.	کیلیفورنیا سے 2 لاکھ افراد کا تخلیہ
You can start or stop it using the middle button.	"آپ کو ""کھیل"" بٹن دباؤ سے روکنے یا شروع کر سکتے ہیں."
You've bruised someone else's face?	عاجز یہ کسی اور کا چہرا ہے کہ تم ہو؟
Something is a heart.	دل (قلب) ایک چیز ہے۔
"Pakistan holds the right to self-defence and proper response."""	"پاکستان اس کے مطابق جواب دینے کا حق محفوظ رکھتا ہے اور خود کو دفاع کرنے کا حق برقرار رکھتا ہے."""
Scarborough Fair: For the love of pink....	زینب الرٹ بل:حکومت کے لیے ...
there was a terribly natural phenomenon that changed the river to a lake, which is now	کی حالت بد سے بدتر ہوتی جارہی ہے،اس وقت جھیل کے راستے میں گھنے درختوں کا ایک جھنڈ آتا تھا،اب وہ
Q. Are you in the employ of any association ?-A.	Q کیا ہر تعلق برقرار رکھنے کے ل you آپ کی خدمت کرسکتا ہے؟ A
The United Nations declared the airstrikes a violation federal legislation right after a number of hundred civilians had been killed in the initial month in the airstrikes .	اقوام متحدہ نے فضائی حملوں کے خلاف ورزی کی وفاقی قانون کا اعلان کیا ہے جس کے نتیجے میں فضائی حملوں کے پہلے مہینے میں کئی سو شہری ہلاک ہوئے ہیں.
knife from 0.5 mm plywood. the first year.	Naomily! spongebob5 0 732 پہلے زیادہ سے سال ایک
It was a long time ago:D	ابھی کچھ دیر پہلے۔:ڈی
I am here at Saudi Arabia and it's very difficult to talk to the	میں تو سعودی عرب میں ہوں، میرے لیے بجھوانا کچھ مشکل ہے
It would focus on the development,...	ترقی و پیشرفت کی طرف اشارہ کرتے ہوئے کہا کہ...
It is believed that the Tokyo Olympics are almost two weeks away, but the administration has declared a state of emergency across the city to prevent the spread of the corona virus.	خیال رہے کہ ٹوکیو اولمپکس کے انعقاد کو تقریباً دو ہفتے رہ گئے ہیں لیکن کورونا وائرس کا پھیلاؤ روکنے کیلئے انتظامیہ کی جانب سے پورے شہر میں ایمرجنسی نافذ کر دی گئی ہے۔
"""You need to give up on Sakurai."""	"سب سے پہلے تمہیں ثنا اختر سے ثنا پروین بننا ہو گا۔"""
He tells his son ...	تمہیں اپنا بیٹا کہتے ہوئے ....
Her car is very nice.	آپ کی کار بہت خوبصورت ہے۔
This feature is currently unavailable on Internet Explorer 11.	اگرچہ اب اس کی تائید نہیں ہوئی ہےڈاؤن لوڈ کرسکتے ہیںاور انسٹال کریںانٹرنیٹ ایکسپلورر 11.
4th, Germany	4 نویں جرمن
tennis player	ٹینس کھلاڑی
This is just the beginning of a wonderful life.	یہ صرف ایک خوبصورت زندگی کا آغاز ہے!
The application was judged at the state level and we were ranked 6th in the state.	مطالبہ نمبر۶ کے متعلق کمیشن بیٹھ چکا ہے اور اس کے لئے ہم ریاست کے ممنون ہیں-
And it is the player at precisely the same moment.	"""یہ کردار خود کو ایک ہی موقع پر بھی ڈھونڈتا ہے."
SCP-173: I'm going to	"< start=""4197.092"" dur=""2.903""> وائس پریذیڈنٹ پینس: میں چلوں گا >"
I'm thinking it's basically the same penalty for me if he gets pulled over?	← جرم جتنا ہے بس اُتنی ہی سزا دیں مجھ کو وہ اگر ٹُوٹ کے بِکھرا ہو گا →
"""I have to say I respect Roger for coming out tonight."""	"""یہ چھوڑو۔ مام میرا مطلب ہے مسز ہاجرہ کو کہہ دینا کہ میں آج باہر ہی لنچ کروں گا""۔"
This Agreement prohibits all hacking.	تنظیم ایسے تمام ہتھکنڈوں کو رد کرتی ہے.
'I didn't steal it.'	'جی میں نے چوری نہیں کیا.'
Don't rule out the bus	قتل نہ کرو بس
In this case we will be trading for Bitcoin (BTC).	اس مثال میں ہم KCS (Kucoin سکین) کے لئے اپنے Bitcoin تجارت کرنا چاہتے ہیں.
I am a marriage advocate.	نہیں ،میں طلاق دلانے والا وکیل بن جاتا ہوں ۔
The president remains in Saudi Arabia where he is recovering from injuries sustained in a June attack on his presidential compound.	صدر سعودی عرب میں ہیں جہاں وہ صحتیاب ہو رہے ہیں۔ اُنھیں جون میں اپنےصدارتی محل کے احاطے پر ہونے والے حملے میں زخم آئے تھے۔
But Let me tell you from the start.	اوہ اچھا میں شروع سے بتانا شروع کرتا ہوں.
As we explain further below, the root of the problem is the prosecutor's	مزید پڑھیں۔ ہمارے مسائل کی بنیادی وجہ کرپشن ہے ، چیئرمین نیب
I left my coat on the train	ٹرین میں میری ڈک چھوئیں
By draw something on top of it.	اوپر سے کوئی چیز پھینکنا
It is safe to use on humans and pets.	لہذا یہ انسانوں یا پالتو جانوروں پر استعمال کرنا محفوظ ہے۔
Harry Potter has twenty-seven of twenty-nine.	لورین فرانس دے 27 تھانواں چوں اک اے۔
"The caller said that ""everyone saw the terrorist attack on the Karachi Stock Exchange, now the 26/11 attack in the Taj Hotel will happen once again."""	فون کرنے والے شخص نے کہا کہ کراچی اسٹاک ایکسچینج میں ہوا دہشت گردانہ حملہ پوری دنیا نے دیکھا ہے۔ اب ہندستان کے تاج ہوٹل میں 26/11 جیسا حملہ ایک بار پھر ہو گا۔
In other words, there's no there there!	یہاں نہیں تو وہاں!!
May be, I'll try my hand at playing football.	Previous: کوشش کروں گا جب تک فٹ ہوں کھیلتا رہوں
Richard died almost a year ago on March 15, 2010.	یہ تقریبا ایک سال پہلے تھا، 17 جنوری، 2005 کو، ہنس مر گیا!
It makes me happy to think of it.	اس لیے بس سوچ کر بھی خوشی ہوتی ہے..
"""What d'you mean, shut up,"" screamed his mother."	"""ارے بس کرو، کیا دروازہ توڑ دو گے۔"" ممی جی نے چیخ کر کہا۔"
support for traditional e-mail can also be used to rescue issues and problems.	روایتی ای میل کے لئے حمایت بھی بچاؤ کے مسائل اور مسائل کے لئے استعمال کیا جا سکتا.
"""Flying is the closest thing to God,"" she beams."	"""الله"" کی قربت کا ""بہترین"" راستہ ""عاجزی"" ھے."
Wake up before it's late.	جاگو اس سے پہلے کہ دیر ہوجائے۔
But sometimes, the scenario is devoid of honesty.	گڈ!کبھی کبھی بے اختیار منہ سے سچ نکل جاتاہے،۔
He has written more than 12 books on different subjects.	انہوں نے مختلف موضوعات پر 12 سے زائد کتب تحریر کیں
the invitation of the event	واقعہ کی دعوتیں
The pillow covers are even worse than the seat covers.	سنٹروک اپنی نشست کھونے سے کہیں زیادہ خراب ہے.
The neocon bloodlust will not be denied.	برہان وانی کا خون ضائع نہیں جائے گا۔
Far from the intended target.	اس سے کوسوں دور ہے، مقصد کی تکمیل
"How old are you, Matthew?"""	"""ان کی عمر کتنی ہے، آنٹی؟"""
The country chose to remain part of the four-nation United Kingdom in a 2014 referendum on the issue.	اس مسئلے پر سنہ 2014 میں ہونے والے ریفرنڈم میں اس ملک نے چار ممالک برطانیہ کا حصہ بننے کا انتخاب کیا تھا۔
A. At first, he was stoical.	I۔ پہلی بات، اُس شخص کو کوڑھ تھا۔
Oh Professor, one more thing.	جی استاد ہے نا، ایک اور سوال بھی ہے۔ وہ کیا۔؟
Noia, Spain.	سپین ، نری کب.
Armies of Exigo is a real-time strategy video game for Microsoft Windows.	ایکگو کے لشکر ایکگو کے لشکر کے لئے آرمی آف ایکسگو ایک حقیقی وقتی حکمت عملی والا ویڈیو گیم ہے۔
The Treaty of Bucharest was a peace treaty between Romania on one side and the Central Powers on the other, following the stalemate reached after the campaign of 1916-17 and Romania's isolation after Russia's unilateral exit from World War I (see Treaty of Brest-Litovsk).	معاہدہ بخارسٹ کے ایک طرف سے رومانیہ اور دوسری طرف سے مرکزی طاقتوں کے درمیان امن معاہدہ کیا گیا تھا ایک تعطل کے بعد 1917 رومانیہ کے لئے پہلی عالمی جنگ سے روس کی یکطرفہ طور پر علیحدگی کے بعد الگ تھلگ چھوڑ دیا تھا فوسٹانی اور معاہدہ بریسٹ لیتھوسک کرنے کے لئے).
he was given the U.S.	انہیں امریکی فیض کو دیا گیا تھا.
He received his early education in.	مشکلات کے باوجود انہوں نے ابتدائی تعلیم وہیں سے حاصل کی۔
I have no idea who this little girl was, but she was completely engaging.	پتا نہیں کون تھی وہ لڑکی لیکن کافی آزاد خیال تھی
Undergraduate FAQ Department of History Dive into your interests and develop your passions at U of T. We offer over 700 undergraduate and 200 graduate programs across three campuses in the Greater Toronto Area.	آپ کی دلچسپیوں میں کودو اور یو پر اپنے جذبات T. کی ہم سے زیادہ گریٹر ٹورنٹو ایریا میں تین کیمپس بھر میں 700 انڈر گریجویٹ اور 200 گریجویٹ پروگرامز پیش کی ترقی.
Love the search engine.	تلاش انجن محبت سے محبت کرتا ہوں.
I wish all of you a Happy Basant Panchami.	بسنت پنچمی کی آپ سبھی کو، پورے ملک کو بہت بہت نیک خواہشات!!
Others are wondering why a mother would kill her young daughter.	میں بہت حیران تھی کہ کوئی اپنی ماں کی بہن کو گندی عورت کی اولاد کیوں کہے گا؟۔
that are trying to put their economic houses in order for	اپنی سیاسی دوکان چمکانے کے لیے چیختے ہی رہتے ہیں لہذا ان
Some of my accent reduction clients have complained that the new voice recognition technology doesn't understand their heavy accent.	صارفین کی جانب سے واٹس ایپ انتظامیہ کو شکایت موصول ہوئی تھی کہ نوٹیفکیشن کا یہ نیا رنگ صحیح طور پر نظر نہیں آرہا جس کے باعث انہیں مشکلات کا سامنا ہے۔
Stay here in this fully furnished.	رہنا اس انجمن میں بہم اتفاق سے
Surfers paradise says:	دیوار پردیس says:
What happens in the brain when we lose someone?	جب ہم ہار جاتے ہیں تو دماغ میں کیا ہوتا ہے؟
In accordance with Software:	مائیکرو سافٹ کے مطابق:
100% of brand new	نام 100% برانڈ نیا
I don't like liar or fake people.	مجھے پسند نہیں کرتے جو لوگوں کے جھوٹ یا دھوکہ.
the door of work is closed.	نوکرانی کمرے کا دروازہ بند کرکے چلی جاتی ہے.
When do you think an approved vaccine will be available for general public use in Canada/the United States?	1۔ ایک ویکسین کب تک امریکا اور کینیڈا کے عام افراد کے لیے دستیاب ہوسکے گی؟تحریر جاری ہے
Real-time processing with FPGAs	جی پی پی کے ذریعے حقیقی وقت کی ٹرینیں
And they were floating in the ocean like the mountains.	میر بالاچ مری پہاڑوں پر چلے گئے تھے اور چی گویرا کی مانند پہاڑوں میں گوریلوں سے جاملے تھے
Some studies showed that drinking a half liter (17 oz) of water about a half an hour before meals helped dieters eat fewer calories and lose 44% more weight (3).	ایک تحقیق میں بتایا گیا ہے کہ کھانے سے آدھا گھنٹہ قبل آدھا لیٹر (17 اونس) پانی پینے سے ڈائیٹرز کو کم کیلوری کھانے میں مدد ملتی ہے اور ان لوگوں کے مقابلے میں جو 44.
"""He's got that you've insulted me smile."" ~ J"	'اس نے تو ابھی مسکرنا ہی سیکھا تھا' _ جی نیوز
They Would Not Call Him Father.	انہوں نے کہا ، وہ اسے والد نہیں کہتے ہیں۔
Beef, poultry, and fish (3 oz)	فلاسیسیڈ ، پییکن ، اور مچھلی _ اومیگا 3s
"She says, quietly, ""I won't make them mad."	"وہ ہٹ دھرمی سے بولی۔""مجھے تمھاری بکواس نہیں سننا۔"""
"He said: ""We knew it would be a difficult night, we knew they could get the away goal, but credit to the lads."	"ان کا کہنا تھا کہ ""سوال یہ ہے کہ جس شام کو ہم جانتے تھے، اُس دوبارہ بننے میں کتنی اور جانیں ضائع ہوں گی، اور کتنی تباہی ہوگی۔"""
Most of the dead were students at the Kharkiv national air force University.	ہلاک ہونے والوں میں سے اکثریت طالب علموں کی تھی جو خرکیو نیشنل ایئر فورس یونیورسٹی میں زیر تعلیم تھے۔
Baby & Co. - epaper	برند:ایپی اور - EPEVER
Oh god, why do they let me on the internets?	سرور بعض اوقات مجھے مرکزی صفحہ پر کیوں بھیجتے ہیں؟
Which means, I'm not shy.	جس کا مطلب بولوں: میں شرمندہ نہ ہوں گا
The answer is: Pakistan.	جواب: پاکستان۔
there will be some hardship.	اور دردناک مسئلے پیدا ہوجائنگے۔
"A nuclear explosion has occurred."""	"اعلانیہ ایٹمی قوت بن چکا ہے"" ۔"
When riding for a long time, you will be tired.	آرام کرنے کے لئے ایک موسم بہار میں دورے کے دوران، آپ کو بہت تھکے ہوۓ ہو جائے گا ۔
I have seen a doctor for three months.	مجھے ڈاکٹر کی بات یاد آگيٴ ایک سے تین مہینے ہیں
008:041 Shakir And know that whatever thing you gain, a fifth of it is for Allah and for the Messenger and for the near of kin and the orphans and the needy and the wayfarer, if you believe in Allah and in that which We revealed to Our servant, on the day of distinction, the day on which the two parties met; and Allah has power over all things.	"""  اور يہ جان لو کہ تمھيں جس چيز سے بھي فائدہ حاصل ھو اس کا پانچواں حصہ اللہ ،رسول ،رسول کے قرابتدار ، ايتام ،مساکين اور مسافران غربت زدہ کے لئے ھے اگر تمھارا ايمان اللہ پر ھے اور اس نصرت پر ھے جو ھم نے اپنے بندے پر حق و باطل کے فيصلہ کے دن جب دو جماعتيں آپس ميں ٹکرا رھي تھيں نازل کي تھي ، اور اللہ ھي ھر شئي پر قادر ھے "" -"
Several were built in the 19th century.	گھروں میں سے کچھ 19th صدی میں تعمیر کر رہے ہیں.
"I'm scared, please!"""	""" مجھے بہت ڈر لگ رہا ہے ، پلیز !"
In the 80s the brand started introducing itself in the ski market.	1980 کے دہائی تک، سپرسسر ڈیزائن نے مارکیٹ کی جگہ داخل کرنے کا آغاز کیا.
She doesn't mess around with the dancing.	وہ رقص کرتی موسموں کی شوخیاں نہیں رہیں .
Replying to Paul C.	LUIS C کو جواب دیں
"""Because it was not the person that she wanted for me... And I don't blame her... I said, 'Mum, I really love him."	"'کیونکہ یہ وہ شخص نہیں تھا جو وہ میرے ل wanted چاہتی تھی... اور میں اس پر الزام نہیں عائد کرتا... میں نے کہا ،' ماں ، میں واقعتا him اس سے محبت کرتا ہوں۔ اس کے اندر تکلیف ہے ، "" سیلائن نے 'پروجیکٹ' پر وضاحت کی۔"
She's the girl I met last night.	یہ وہ لڑکی ہے جس سے میں کل ملا تھا۔
God is with you and will be with you.	پوری قوم آپ کے ساتھ ہے .اگر آپ سچے ہو تو الله آپ کی مدد کرے گا .
Huram said moreover, Blessed be the LORD God of Israel, that made heaven and earth, who has given to David the king a wise son, endued with prudence and understanding, that might build a house for the LORD, and a house for his kingdom.	12 اور حوُرام نے یہ بھی کہا خُداوند اسرائیل کا خُدا جس نے زمین اور آسمان کو پیدا کیا مُبارک ہو کہ اُس نے داؤد بادشاہ کو ایک دانا بیٹا فہم و معرفت سے معمور بخشا تاکہ وہ خُداوند کے لیئے ایک گھر اور اپنی سلطنت کے لیئے ایک گھر بنائے۔
Fluffy & Cuddly (1)	ہار & بالیاں & چوڈی (1)
They had been on the road a month.	انہوں نے مہینے کے مہینے سڑک پر کام کرنے کی کوشش کی.
She was used to acknowledging pain.	وہ جان گئی تھی ہمیں درد میں مسکرانے کی عادت ھے
The GDPR applies whether your organisation is located in the EU or not.	مختصر میں، جی ڈی پی آر آپ کی تنظیم پر لاگو ہوتا ہے کہ آیا آپ یورپی یونین میں موجود ہیں یا نہیں.
32:3 And the eyes of those who see will not be shut, and those who have hearing will give ear to the word.	32:3 دیکھنے والوں کی آنکھیں غیر واضح نہیں کیا جائے گا, اور سن ان لوگوں کا جو کانوں قریب سے سن گے.
So deal with the facts, Jack.....	چـــشـمک عشق - جک..
India is a major source of terrorism in Pakistan.	پاکستان میں کی جانے والی دہشت گردی میں بھارت سر فہرست ملوث ہے.
Which is why the teens suffer from depression.	ایسا کیوں ھو رھا کہ نوجوان بھی ڈپریشن کا شکار ھو رھے ھیں ۔۔۔
What you mean you got it?	'کیا مطلب، تم ملے ہو اس سے؟'
More about Quincunx.	NGINX کے بارے میں مزید
It was sold in 1 month.	وقت 1 ماہ کے اندر فروخت ہو گیا
we are very different.. we have different circumstances, we all often live in different places, both physically and spiritually...	ہم غیر معمولی اوقات میں رہ رہے ہیں۔ بہت سے لوگوں کی طرح ، میں ذاتی اور...
He did not at all care for the fact that his wife was the daughter of the emperor of his time.	آپ نے اس کی مطلق پروا نھیں کی کہ آپ کی بیوی ایک شھنشاہ وقت کی بیٹی ھیں .
But it is said that smoking a cigarette right after your meal is equivalent to smoking 10 cigarettes, thus increasing the risk of cancer.	ماہرین کا کہنا ہے کہ مختلف تجربات نے یہ ثابت کیا ہے کہ کھانے کے فوراً بعد ایک سگریٹ پینا 10 سگریٹ پینے کے برابر ہوتا ہے- اور اس طرح کینسر جیسے مہلک مرض کے لاحق ہونے کا خطرہ بھی بڑھ جاتا ہے-
"""I'm about to give it to you, Pamie!"	یہ گیند، میں تم کو دینے آیا ہوں، امی!
GABRIELA, formed in 1984, is the General Assembly Binding Women for Reforms, Integrity, Equality, Leadership and Action.	GABRIELA جنرل اسمبلی لازم خواتین اصلاحات، دیانت داری، مساوات، قیادت اور عمل کے لئے
Capitalizing on the internet to capture the attention of potential buyers	آن لائن فروخت: آپ کے امکان کے خریدنے والے محرکات کا پتہ لگانا
Look for detailed meaning in the language:	ایک مقام پر تفصیل سے زبان کی اہمیت پر گفتگو فرمائی:
Thomas's new car	کار کے آخری الفاظ ٹامس
Please help raise funds.	برائے مہربانی دوبارہ تعمیر کرنے کے لئے رقم بڑھانے میں مدد کریں.
Great powers and the First World War: 1870-1918 10	عظیم طاقتیں اور پہلی جنگ عظیم: 1870-1918[ترمیم]
Stand out from those people.	ایسے لوگوں کی دانش سے بچ کے رہیے.
Physicalism, the idea that only physical entities comprised of matter and energy exist.	اولاً: حواس خمسہ ظاہری صرف طبیعی دُنیا (physical world) کی اشیاء کا اِدراک کر سکتے ہیں، جس میں مادّہ اور توانائی دونوں شامل ہیں۔
He was too tired, and now he is sick.	وہ تھک چکا تھا اور حد سے زیادہ تھک چکا تھا۔۔۔اور اب وہ تھک کر گر رہا تھا۔۔۔۔۔۔۔۔
9:27 then God thereafter turns towards whom He will; God is All-forgiving, All-compassionate.	""" ثم یتوب اللہ من بعد ذلک علی من یشاء واللہ غور رحیم: پھر اس کے بعد اللہ جس کی چاہے توبہ قبول فرما لیتا ہے، اور اللہ بہت بخشنے والا، بےحد رحم فرمانے والا ہے "" (التوبہ:27) (جامع البیان جز 9، ص 267 ۔ 268، مطبوعہ دار الفکر بیروت، 1415 ھ)"
mind develops and unfolds in this direction.	اس سمت میں سمجھا اور آگے بڑھ رہا ہے.
Below that, select Yes or No to indicate whether or not you are a US citizen.	اگر اتفاق سے آپ کا جواب ہاں میں ہو تو یہ بتائیں کہ کیا امریکہ حملہ آور کافر ہے یا نہیں
The studio is waiting for you!!	یہ کائنات آپ کی منتظر ہے!!!!
Ahhh you understand me!	سمجھتے ہو مجھے تم۔ آہ !
A beautiful poem and message.	بہت عمدہ لڑی اور پیغام۔
love yourself (6 months ago)	Ha Ha Love آپ Too:) Xx پہلے زیادہ سے سال ایک
Join us, together we can make a change.	ہمارے ساتھ رہو، ایک ساتھ مل کر ہم ایک بڑامعاہدے بنا سکتے ہیں!
Become a leading provider in this market.	ہم اس میدان میں ایک اہم فراہم کنندہ بننے کے لئے جاری رکھیں.
Assures high-speed data transmission and Supports USB 2.0 for a maximum transfer rate	ہائی سپیڈ ڈیٹا منتقل کرنے کی ضمانت دی اور زیادہ سے زیادہ کی منتقلی کی شرح کے لئے USB 2.0 کی حمایت کرتا
Hundreds of people die every day in this city.	مجھے اس شہر میں دن بھر ہزاروں لوگ ملتے ہیں
Who's Baking the Bread?	کون کس کی روٹیاں چلا دیتا ہے.
"""Surprisingly enough, Father said so as well."	ہوں!یہ بھی کوئی کا م ہوا بھلا۔ بابا نے حیرت سے پوچھا۔
I'm an experienced character animator.	[مرد] میں ایک حوصلہ افزائی نیچرسٹ ہوں
I've always loved rainbows.	ہاں مجھے ہمیشہ سے ریت گھڑیاں بہت پسند ہیں.
So here's a fair warning.	اور يہاں ايك امر قابل تنبيہ ہے وہ
I knew i found you when i met you	میں تو بے فیض رہا تجھ سے ملاقات کے بعد
Table 8: Share of Benefits...	شیئر کریں: منافع شیئرنگ کا تناسب
by Say Hello To The Angels	"لیکن وہ فرشتوں سے ""اعلی"" ہیں."
instructions won't kill you.	احکام تیرے مرنے نہیں دیتے
Some day I will get gold medal here...	لڑکا نمبر 1: یہاں تے تلوار مالوں گا۔۔۔
Sponsored by Capital & Regional	دارالحکومت اور علاقائی فائدہ کا مجموعہ
Sport is part of the solution to ending sexual violence.	نیلاگ جنسی تشدد کے خاتمے کے حل کا ایک حصہ ہے۔
Re-do home page with new content [...]	"ہوم پیج (-) "" ریزورٹ نیوز "" نئے نظر کے ساتھ ریناسینس کراوس بڑھا ہوا ریسارٹ"
In any case, such usurpation by Israelis is rare.	اسرائیل کی جانب سے ایسی کارروائیوں کے بارے میں شاذ و ناذر ہی تسلیم کیا جاتا ہے۔
The method is the same as shiny breeding.	طریقہ کار بال ورنجن کے طور پر ایک ہی ہے.
This is a great looking mask.	یہ ایک شاندار چہرے ماسک ہے.
He achieved this prestigious award when he was 23 months of age.	انھوں نے 23 سال 153 دن کی عمر میں یہ اعزاز حاصل کیا۔
Nauert, 48, came to the State Department as spokesperson in April 2017 after a stint at Fox News as an anchor and correspondent.	اڑتالیس سالہ نوئرٹ نے اپریل 2017ء میں امریکی محکمہٴ خارجہ کی ترجمان کے طور پر فرائض سنبھالے، جس سے قبل وہ 'فوکس نیوز' کی اینکر اور اخباری نمائندے کے طور پر کام کر چکی ہیں۔
The FC officials told them that the gate would not be opened until shifting of the protesters from the site.	ایف سی حکام نے انہیں بتایا تھا کہ مظاہرین کی منتقلی تک گیٹ نہیں کھولا جائے گا۔
I graduated the year before	I graduated پہلے زیادہ سے سال ایک
British Home Secretary Priti Patel announced that in the long run, asylum seekers entering the country through illegal routes will be given less rights than others.	برطانوی وزیر داخلہ پریتی پٹیل کا کہنا ہے کہ ملک کے داخلی نظام پر پناہ لینے والوں کا بہت دباؤ ہے، جن میں بڑی تعداد غیر قانونی طور پر ملک میں داخل ہونے والوں کی ہے، نئے قانون کے تحت قانونی طور پر ملک میں داخل ہونے والوں کو ترجیح دی جائے گی اور تمام متبادل رستوں کو روکا جائے گا۔
To him, this will always be home.	اگر میں ان کے ساتھ ہوں، تو یہ ہمیشہ گھریلو گھر میں ہے.
Being far from home has always been hard, but if I feel that something is worth fighting for, then I do my best to succeed and achieve my goals.	پروین:سر جہاں مجھے خود یہ محسوس ہوتا تھا کہ یہ تھوڑا مشکل ہے اس وقت میں یہی سوچتا تھا کہ ابھی تک میں نےجو کچھ بھی کیا اگر میں ابھی شکست تسلیم کر لوں گا تو سب کچھ ختم ہوجائے گا۔ میرے لئے بہتر یہ تھا کہ محنت اور جستجو میں لگا رہوں اور کامیاب بننے کی کوشش کروں۔
Another major contributor is the burgeoning museum industry (700 new museums per year) which has become a significant economic reality throughout the world in the 21st century.	آرٹ مارکیٹ کا ایک اور اہم محرک نئے دور کی عجائب گھر صنعت ہے (700 نئے عجائب گھر سالانہ) جو 21 ویں صدی میں ایک اہم اقتصادی حقیقت بن چکے ہیں۔ 2000ء سے 2014ء کے دوران گزشتہ دو صدیوں سے زیادہ عجائب گھر بنے۔
The Lakers will save millions.	الشفاٹرسٹ کی خدمات سے لاکھوں لوگوں کی بینائی بچائی جاسکے گی
Police forces are struggling.	آواز افواج - جنگ چل رہی ہے۔
JOHANNESBURG: Scientists in South Africa have revealed that another type of corona has emerged in their country.	ویب ڈیسک: جنوبی افریقہ کے سائنسی ماہرین نے انکشاف کیا ہے کہ اُن کے ملک میں کورونا کی ایک اور قسم سامنے آئی ہے۔
Eleven-year-old Maverik Lowe was severely hurt.	گلشن راوی ،پانچ سالہ بچی سیڑھیوں سے گر کر شدید زخمی ہوگئی
arrests were related to the London	لندن حملہ میں شریک افراد کی گرفتاریاں شروع
I'm the sucker, don't count on me	ساجن میں مجبور ہوں، دے نہ مجھے آواز
"""giving this Belt."""	"""سریہ بٹن ٹانک دے۔"""
Now it has started to affect his social life.	رفتہ رفتہ وہ اپنی سوشل زندگی سے کٹنے لگا تھا
"Isaac asks him, ""who art thou, my son?"""	"عیلی نے پوچھا ، ""کیا ہوا اے میرے بیٹے ؟ """
The messenger returned four days later.	رسول اللہ صلی اللہ علیہ وسلم نے فرمایا: چار دن کے بعد بیچنے والا ذمہ دار نہیں ۔
Never go to bed with your make-up on because it infections.	کبھی بھی اپنے گندے کپڑے اُتارنے کے بعد انہیں بستر پر نہ رکھیں کیونکہ ان میں۔۔۔ سائنسدانوں نے وارننگ
Fly high, Chester.	اووچو گزر،سین دورار.
In the Download, God made exhilaration and sent.	اس کے بعد آپ صلی االله تعالیٰ علیہ وسلم مکہ تشریف لائے اور طوافِ زیارت فرمایا ۔
The man went to work, too.	اسکے علاوہ ایوبیہ بھی گئے.
I'm really curious as to where this comes from haha.	میں محوِ حیرت تھا کہ یہ حسینہ کہاں سے آئی ہے
The government must look at their salaries.	حکومت کو اس کی قیمتوں کا تعین کرنا ہوگا.
The medic is here.	جی ڈاکٹر صاحب مریض حاضر ہے۔
10:10 Y otra vez, en la casa, his disciples questioned him about the same thing.	10:10 اور پھر, گھر میں, اس کے شاگرد ایک ہی چیز کے بارے میں اس سے پوچھ گچھ.
But we DON'T trust you.	نہیں محترم ہمیں آپ پر اعتبار ھے۔
The History of the IRA:..	Topic: عمران کا ان...
The UK-based Syrian Observatory for Human Rights said on Sunday there were still IS fighters in the eastern parts of the town, but that they were withdrawing	برطانیہ میں قائم انسانی حقوق کے ادارے سِیرین آبزرویٹری فار ہیومن رائٹس نے اتوار کو کہا ہے کہ شہر کے مشرقی حصوں میں دولت اسلامیہ کے جنگجو موجود ہیں تاہم وہ اب پیچھے ہٹ رہے ہیں۔
Many modern styles and attractive designs to choose from.	وہاں مختلف ڈیزائن کے سپر حیرت انگیز اور جدید ڈیزائن ہیں جو آپ سے منتخب کرسکتے ہیں.
under protection by an inert gas.	خشک اندرونی گیس کے تحت اسٹور.
I was afraid of what would happen today had.	مجھے تو بڑا خوف آرہا ہے، کبھی بھی ایسا نہیں ہوا تھا جو آج ان کی کیفیت تھی ...........
Recalling the unprecedented rise in the demand for the medical oxygen during the second wave during the months of April and May, Modi said that the challenge was met at the war footing deploying all the systems of the government.	اپریل اور مئی میں دوسری لہر کے دوران طبی آکسیجن کی مانگ میں غیر متوقع اضافہ کو یاد کرتے ہوئے، وزیر اعظم نے کہا کہ اس چیلنج کا سامنا جنگی سطح پر کیا گیا اور اس کے لیے حکومت کے تمام سسٹم کو بروئے کار لایا گیا۔ وزیر اعظم نے کہا کہ ہندوستان کی تاریخ میں طبی آکسیجن کے لیے اتنے بڑے پیمانے پر کبھی مانگ نہیں کی گئی تھی۔
A WHO release said the mental health impacts of the pandemic will be long-term and far-reaching.	عالمی ادارہ صحت کا کہنا ہے کہ وبا کی وجہ سے ذہنی صحت پر پڑنے والے اثرات طویل المدت اور دیرپا ہوں گے۔
It supports all operating systems:	تمام آپریٹنگ سسٹم کی حمایت کرتا ہے:
"She dropped her head again, ""Teach me to hunt."	"""یار دوبارہ سے اس کی شرٹ خراب کر دی تھی اب وہ کہہ رہا ہے کہ مجھے شرٹ لا کر دو۔۔۔۔۔"""
it can get into the country.	حاصل کرسکتے ہیں اور ملک میں داخل ہوسکتے ہیں۔
It was of a prophetic nature.	تو وہ نباض فطرت تھا
"1:china is trying to ""invade"" Taiwan"	بھارت: شیوسینا نے تاج محل میں 'پوجا' کرنے کی دھمکی دے دی
to a Free Software society.	ایک آزاد معاشرے کے لئے مفت سافٹ ویئر.
sit down, your Honor.	نشيد سراااااب .
"The new order lifted the ban on 4G mobile data services, but asked police officials to ""closely monitor the impact of lifting of restrictions."""	"نئے حکم نے 4 جی موبائل ڈیٹا خدمات پر عائد پابندی کو ختم کردیا ، لیکن پولیس حکام سے ""پابندیوں کو ختم کرنے کے اثرات پر کڑی نگرانی کرنے"" کا مطالبہ کیا۔"
The reward on the other side of this is GREAT JOY that many never find because because they will not surrender to God.	اس بارے میں مختلف مسالک میں جو راۓ پائی جاتی ہے - وہ یہاں پیش کر رہا ہوں - انشاءللہ اس کو پڑھنے کے بعد کوئی دور نہیں ہو گا - انشاءللہ -
All the DNA for the second half is present in the first half.	سیزن کے دوسرے نصف حصے کے لئے ٹی این ٹی کا مکمل نظام الاوقات یہاں ہے
Avoid the use of plastic in your garden.	اپنے باغ پر نقصان دہ کیمیکل استعمال کرنے سے بچیں.
The Israelites crossed the river Jordan to reach the city of Jericho.	نے دریائے اردن (Arden, Jordan) کو عبور کرکے فلسطین کے شہر اریحا کو فتح
Logistic will be completely revamped.	کرکٹ مکمل طور پر بحال کرنے کے لیے سرگرم رہیں گے۔
Thank you for this work you've done, thank you!	یہ کام کی چیز ہے جو آپ نے بتائی ہے ۔ شکریہ
There is currently 7.	فی الحال 7حاضرین ہیں
e.g.: May I have your name?	شوکت: میں تمہارا نام رکھ دوں؟
You may think you work [...]	مجھے لگتا ہے کہ آپ سطح پر منحصر کام کر سکتے ہیں (...
There are no district, regional, national, or international governing boards - no earthly headquarters, and no humanly-designed organization.	کوئی حکومتی بورڈ نہیں ہے - نہ ہی ضلع، علاقائی، قومی اور نہ ہی بین الاقوامی - نہ ہی زمینی ہیڈکوارٹر اور کوئی انسان ڈیزائن شدہ تنظیم.
I had read that Wasabi was on its way out.	یہ سننا تھا کہ حارث وہاں سے بھاگتے ہوۓ باہر کی جانب گیا۔۔
Stop asking questions, unless you don't want to see your family again.	ہاں / کوئی سوال مت پوچھو جب تک کہ آپ اپنی کنواری پن کو دوبارہ رجسٹر کرنا نہیں چاہتے ہیں۔
"""They repay me evil for the good I have done; though I have tried to do good to them, they hurl accusations at me."""	میرے خلاف گینگ بنائی ہوئی ہے کہ میں نے اقرباپروری کے خلاف کیوں آواز اٹھائی، ان لوگوں کو شرم نہیں آتی، میرے پیچھے پڑے ہیں، مجھے تو ان لوگوں کے ساتھ کام ہی نہیں کرنا اور یہ بات میں ان کے منہ پر کہہ چکی ہوں'
I hope there are lots of participants.	اُمید ہے بہت سارے ممبران اس میں
In order to address this challenge, Dr. Vijay Gahlaut, an Inspire Faculty Fellow of the Department of Science and Technology (DST), is exploring the epigenetic route to modify gene expression in a manner that is stably transmitted but do not involve differences in the underlying DNA sequence, so that theheritable genes do not buckle under heat stress and non-stress conditions during different grain filling stages.	اِ س چیلنج سے نمٹنے کے لئے سائنس وہ ٹیکنالوجی کے محکمے ڈی ایس ٹی کے ایک اِنسپائر فیکلٹی فیلوڈاکٹر وجے گہلوت ایک مرکزی جینیاتی روٹ کا پتہ لگا رہے ہیں، تاکہ جینیات کی اِس طرح تصحیح کی جاسکے، جسے مستحکم طریقے سے منتقل تو کیا جاسکے، لیکن اس عمل میں ، ڈی این اے کے نظم میں پائے جانے والے اختلافات حائل نہ ہوں، تاکہ اناج کی پیداوار کے مختلف مرحلوں کے دوروان قابل وراثت جین، گرمی کے دباؤ میں اور غیر دباؤ والے حالات میں غیر مؤثر نہ ہوجائیں۔
"""Some people are queuing up the whole night..."	"""جوانوں نے رات بھرجاگامنایاہے ... ہیں۔"""
You can enter up to 4 images in each section.	لہذا آپ ہر کمرے میں 4 پوائنٹ پاس ورڈ فراہم کر سکتے ہیں.
Newspaper headline about the victory of the national team of Argentina.	قومی کرکٹ ٹیم کی فتح پر آرمی چیف کا وکٹری کا نشان۔
it's kind of awkward. - So where do we go? - It's right up here. - Okay.	ہم کہاں جائیں اتنی دور عدم ؟ مۓ کدۓ کو یہاں اٹھا لاؤ
I've done my apprenticeship in the industry and am now a full time professional.	میں نے یونیورسٹی میں بین الاقوامی اقتصادیات کا مطالعہ کیا اور اب میں مکمل وقت تاجر ہوں.
When you need to lift a heavy weight, a pulley can make the job easier A pulley is one of the physic's six non-motorized simple machines - in this case, one that reduces either the effort necessary to lift a load or the direction in which the force needs to be applied in order to move the load - or it may do both things: reduce the force needed, as well as the direction.	جب آپ کو بیعانہ کیا ہے زیادہ وزن اٹھانا پڑتا ہے تو ، ایک گھرنی کام کو آسان بنا سکتی ہے۔ ایک گھرنی جسمانی طبیعیات کی چھ غیر موٹرائیزڈ سادہ مشینوں میں سے ایک ہے - اس معاملے میں ، یہ ایک بوجھ اٹھانے کے لئے ضروری کوشش کو کم کردیتی ہے یا اس سمت میں جہاں بوجھ کو منتقل کرنے کے ل force فورس کو لاگو کرنے کی ضرورت ہے یا یہ ہوسکتا ہے دونوں کام کریں: ضرورت کے ساتھ ساتھ سمت کو بھی کم کریں۔ مائیکرو فنانس کیسے کام کرتا ہے.
Rotator cuff disorders (rotator cuff tears, subacromial impingement and calcific tendonitis) are one of the most common causes of shoulder pain	روٹرٹر کیف کی خرابی (روٹرٹر کف آنسو، subacromial پنکھ اور calcific tendonitis) کندھے کے درد کے سب سے زیادہ عام سبب ہیں.
"""There's more light over there."""	سنا ہے روشنی اُس پار کچھ زیادہ ہے.
Nevertheless, before you decide to do buy a package deal deal, Check out yourself to check out what the prices will be to purchase Just about every independently.	تاہم، آپ سے پہلے ایک پیکج کے معاہدے کی خریداری کرتے ہیں، آپ کو خود کو الگ الگ خریدنے کے لئے قیمتوں کو دیکھنے کے لئے خود کو چیک کریں.
When two plates move towards each other forming collisions.	جب دو پلیٹیں ایک دوسرے کے مخالف سمت میں حرکت کررہی ہوں یعنی ایسے
Please inform us about the price in us dollars.	برائے مہربانی اپنے پروگرام میں قیمت امریکہ ڈالر میں بتائے کریں شکریہ
George Sale the Lord of heaven and earth, and of whatsoever is between them; the mighty, the forgiver of sins.	Urdu 66: آسمانوں اور زمین کا پرودگار اورجو کچھ ان کے درمیان ہے غالب بڑا معاف کرنے والا ہے
And outfits were never an issue with me.	لبوں پہ میرے نہ آئے کبھی سوال کی بات
on behalf of Richard Miller	جواب:رچرڈ ملر
Israeli media reported on May 28, 2007 that only 800 out of a total of 3000 pupils in Sderot had turned up to schools.[186]	اسرائیلی میڈیا نے 28 مئی 2007 کو اطلاع دی کہ سدرٹ میں 3000 شاگردوں میں سے صرف 800 ہی اسکولوں میں داخل ہوئے ہیں۔
"A fox saw him and was surprised, ""Why are you sharpening them now?"	"تاجر نے حیرت سے اسے دیکھا اور پوچھا۔ ""آپ نے یہ دینار کیوں پھینک دئیے؟"""
Therefore, the computers are starting fresh at start up every day.	اسی لئے ہر نیا دن اسٹارٹ ہونے پر کریڈٹس دوبارہ زیرو ہو جاتے ہیں
Every one wants to play this game.	ہر کوئی یہ کردار چاہتا تھا.
Lebanon's President Michel Aoun says he has hope in the possibility of the formation of a new government in the coming days.	دریں اثناء لبنانی صدر میشیل عوان نے یہ خوش خبری دی ہے کہ آیندہ چند روز میں مثبت پیش رفت ہوگی۔ ان کا اشارہ شاید نئی حکومت کی تشکیل کی جانب تھا۔
2225; or ten rivulets of sublatis.	1) 5 رولز یا 10 رولس پلاسٹک شیرنک لپیٹا ۔
Russia today is terribly sick.	مردے از روستاهاے اصفهان.
The prayer, however, is supposed to	نماز ہر حال میں فرض ہے:
At another point, Palestinian negotiators were said to have agreed that only a token number of refugees, just 10,000, should return to Israel.	فلسطینی مذاکرات کار وں کے بارے میں یہ بھی کہا گیا ہے کہ وہ اس پر تیار ہوگئے تھے کہ اسرائیل صرف 10 ہزار پناہ گزینوں کو واپسی کی اجازت دے دے۔
bring peace of mind,	یہ جوش اے نفس شعلہ بار رہنے دے
one of the fastest-growing companies.	اور کمپنیوں کے اندر سب سے تیزی سے بڑھتی ہوئی ترقی میں سے ایک.
I live alone, in a home with free room, and can host.	لئے تلاش کر رہا ہوں تو ایک گھر میں اکیلے رہتے ہیں میں اپنے گھر میں ایک گھر کے ساتھ ایک مفت کمرے.
Not all processed foods increase the risk of cancer.	تمام پروسس شدہ گوشت ایک ہی کینسر کا خطرہ نہیں اٹھاتے ہیں
My daddy will be so pleased to see us all.	پروین: وہ بھی بہت خوش ہو گی جب ہم سب کو دیکھے گی۔
Democrats may not see it that way.	ڈیموکریٹس اسے اس طرح نہیں دیکھتے ہیں۔
The clients were not getting a lot of use out of the pool...	ملازموں کو کفیلوں سے فرار ہونے کیلئے زیادہ پیسوں کا لالچ نہ دیا ...
Detangling hair is an art that requires patience.	بال کی ترقی کی خوبصورتی ایک صبر ہے جو عمل کی ضرورت ہوتی ہے.
Developing countries' products continue to face significant impediments in rich countries' markets.	ویکسین تک رسائی، امیر ممالک غریب ممالک کی راہ میں رکاوٹیں بھی ڈال رہے ہیں
The Deputy First Minister: The independent panel of experts will also undertake other work.	وقف بورڈ سے کارکردگی کا آغاز، مشیر خصوصی حکومت دیگر اداروں کو بھی متحرک کرینگے
Getting married is not for me.	شادی اپکی ہوئ ہے میری نہیں..
People who were opposed to the war from the beginning	اور مجلسِ احرار جو شروع دن سے تقسیم کی مخالف تھی ....
Manish Sharma's Videos	شاہدہ منی کی سیکسی ویڈیو
You shouldn't talk hastily.'	"تم نہ اس قابل ہی نہیں ہو کہ تم سے تمیز سے بات کی جائے""وہ.."
It's time to bring your rooms into the 21st century.	یہ 21st صدی میں آپ کے باورچی خانے کو لینے کا وقت ہے.
"""There's no point in lying,"" said Nally on the rostrum afterwards."	""" جھوٹ سمجھنے کی کوئی وجہ نہیں ۔ "" فریدی نے دوربین پر جھکتے ہوئے کہا ۔"
Consider these major media news stories that were issued in the fall of 2008, during the darkest days of the 2008-2009 financial meltdown:	میڈیا کی ان اہم خبروں پر غور کیج that جو 2008-2009 کے مالی خرابی کے اندھیرے دنوں میں ، 2008 اولمپک تجارت میں فاریکس کو کیسے تجارت کریں کے موسم خزاں میں جاری کی گئیں۔
The public social security funds are established by law.	"جملہ حقوق بحق ""سوشل فنڈا"" محفوظ ہیں۔"
"""It would be a once in a year thing."""	"""سال میں ایک بار کچھ پوچھیں گے تو یہی ہوگا۔"""
There is a great way to test channels!	کچھ انٹرمیڈیٹ کی مہارتوں کا ٹیسٹ کرنے کا ایک بڑا طریقہ ہے!
Their clothes were scorched.	انکے کپڑے گندے تھے ـ
And they're not just in Mozambique.	لیکن صرف مغالطے میں نہیں ہوں ۔
You can set up an escrow within 24 hours	آپ سپنج کو ٢٤ گھنٹوں پہلے بھی اندر رکھ سکتی ہیں
He brandished a hand.	اس نے ایک ہاتھ سے جوس پیا تھا..
Even though the weather is flu and people from the US to Pakistan suffer from it, people are still talking about the flu, not the Coronavirus.	اگرچہ یہ موسم فلو کا ہے اور امریکہ سے لے کر پاکستان تک لوگ اس کا شکار ہیں تو پھر بھی لوگ فلو کے متعلق نہیں بلکہ کورونا وائرس کے متعلق ہی بات کر رہے ہیں۔
Pick up your socks, fellas.	میری سوئی لاو، دوستو!
Akif, I am with the govt.	حکایت - میں سرکار صلی اللہ علیہ وسلم کے پاس آیا ہوں
"Our company regards ""reasonable prices, efficient production time and good after-sales service."	"ہم ""مناسب قیمتوں، موثر پروڈکشن کا وقت اور اچھی سروسز کے بعد فروخت"" کے بارے میں غور کرتے ہیں"
These are some great specimens.	سچ کہوں, وہ کچھ بڑے پیمانے پر بہت بڑا علامات ہیں.
Let me tell you about hairfall.	بھئی ہم آپ کو بال سیاہ کرنے کا نسخہ بتادیں گے -
Demonstrators are protesting against the spending on the football World Cup.	اس سے پہلے برازیل میں فٹ بال کے عالمی کپ پر اٹھنے والے اخراجات کے خلاف مظاہرے ہوئے تھے۔
This tutorial explains how to create new files and directories in the WordPress /uploads/ folder.	میرے الفاظ کی وضاحتآپ کی پوسٹ / صفحہ کے مواد میں الفاظ ٹیگ اور وضاحت لکھنے کے لئے قابل بناتا ہے.
Tor Ladies and Gentlemen.	- شمس، والاحضرت
Attached to the wall, as an air duster	خم دیوار پہ۔۔۔ سیّارے کی مانند رواں
The Health Insurance Hospitals Company (Dhaman) affirmed that 50 percent of the company's shares will be offered as public subscription to citizens at the end of 2021, reports Al-Qabas daily quoting informed sources.	روزنامہ القبس کے باخبر ذرائع کی رپورٹ کے مطابق ہیلتھ انشورنس ہاسپٹلز کمپنی (ضمان) نے اس بات کی تصدیق کی ہے کہ کمپنی کے 50 فیصد حصص 2021 کے آخر میں شہریوں کو عوامی رکنیت کے طور پر پیش کیے جائیں گے۔
What books can we expect to see in the future?	ہم مستقبل میں کس قسم کے منصوبوں کی توقع کرسکتے ہیں؟
We take great pride in selecting only the best instructors for our classes.	ہم اپنے کھلاڑیوں لطف اندوزی کے لئے صرف بہترین پرساد کو منتخب کرنے پر فخر ہے.
De: waoooooooooooooo	رد: لـــــــــــــــدى سؤال
Tapper asked the RNC chairman.	ںثار کھوڑو نے حکومت سے این آر او مانگ لیا۔۔
"""I hope to create change."""	"""مجھے امید ہے کہ میں تبدیلی کی علامت ہوں"""
These efforts not only reflect China's high sense of responsibility for the lives and health of its own people, but also its strong support for global disease prevention and control.	اس وبا سے لڑنے کے لئے چین کی جانب سے کی جانے والی کوششیں نہ صرف چین کے اپنے لوگوں کی صحت کی حفاظت کے لئے ہیں بلکہ عالمی امراض کی روک تھام اور قابو پانے کے لئے بھی بھرپور تعاون فراہم کرتی ہیں۔
Clea's home	کلاٹ home گھر
There are no roads in this part of the South Luangwa, and all game-viewing is done by foot.	بھوٹان کے دارلحکومت میں کوئی ٹریفک لائٹ نہیں ہے اور تمام روڈ سائنز ہاتھ سے بنائے جاتے ہیں۔
And do not let Heiko be aware that you are frightened for him.	دوسرا فرمایا کہ جہاد کے بارے میں کسی بزدل سے مشورہ نہ کرنا۔ جو خود ہی ڈرپوک ہو، اس سے آپ نے مشورہ کیا تو وہ آپ کو بھی ڈرپوک بنا دے گا۔
In a brief but brilliant essay on this question.	اس کے بارے میں چھوٹی مگر ایک مفصّل تفصیل جانئیے اس ڈاکومنٹری میں۔
"""We have a commitment to find a cure."	ہم ایک علاج تلاش کرنے کے لئے مصروف ہیں.
looking down at the gates	گھروں کے دروازوں پر دیکھ رہے تھے
The United States is not affected by Turkey's purchase of S400.	S 400 کو خریدنے کے سلسلے میں امریکی دھمکیاں بے اثر ہیں
It's my pleasure to see you finally in the flesh, Bujin.	پہلی بار سیمی فائنل میں پہنچنے کی بہت خوشی ہے، کرس لین
national consensus is required.	اس لیے قومی اتفاقِ رائے کی ضرورت ہوگی۔
Without it, I'd be missing so much.	آپ کے بغیر ، میں اتنا کھو جائے گا۔
Dr. Muñoz: Are you a man of faith?	ڈینفورتھ: اور تم انجیلِ مقدس کے ماننے والے عیسائی ہو؟
I'd also like to thank my family for their never-ending love and support.	میں بے پناہ محبت اور حمایت کرنے پر اپنے مداحوں کا بھی شکریہ ادا کرتا ہوں.
Bye bye Panasonic products	خداحافظ جسی پینکمن
The people of Hungary who would like to stay members of the European Union	ہنگری کو یورپی یونین کی رکنیت ملنے کے موقع پر شائع ہونے والے وہاں کے اخبارات
Like a lot of us, they once started with little to no experience in their profession.	بہت سے دوسرے صارفین کی طرح، آپ کی ذاتی زندگی میں نئے تاخیر کے بغیر کسی تاخیر کے بغیر شروع.
Keep at it, it can help you work through this stuff.	توجہ دینا، کیونکہ یہ انٹرویو بھر میں آپ کی مدد کر سکتا ہے.
Here are the videos from GMU.	ذیل میں گیگا او ایم کا ایک اسکرینکاسٹ ہے
So, I ventured into the library to test some of these books.	میں دکاندار سے اجازت لیکر ان کتابوں کو ایک نظر دیکھنے میں مشغول ہو گیا۔ ہر
Devil is the enemy of humans.	شیطان انسان کے لئے ایک زبردست دشمن ہے کہ اس میں کوئی شک نہیں ہے .
I don't have the steamer bit and never used it.	میں ایڈورائس Semalt کا بہت کم برقرار رکھتا ہوں اور اس کے ساتھ کبھی بھی تبدیل نہیں ہوا.
It's important to take care of your mental health and be COVIDSafe.	اپنی ذہنی صحت کا خیال رکھنا اور COVIDSafe رہنا اہم ہے۔
He might do the same to you if you end up with him.	وہ ا یسا کر سکتا تھا کہ تمہاری اس خطا کے باوجود تمہیں فتح دے دیتا.
It will not be possible to talk about anti-aging masks for all skin types, but you can list some effective ingredients.	جلد کی تمام اقسام کے لئے عمر رسیدہ ماسک کے بارے میں بات کرنا ممکن نہیں ہوگا ، لیکن آپ کچھ موثر اجزاء کی فہرست دے سکتے ہیں۔
must be URLs.	سیاہ urad ہونا ضروری ہے.
Dash had been on the edge of his control.	داجی اپنی ضد پر آڑے تھے..
The film doesn't investigate.	اس فلم کا کاروبار کرنا جائز نہیں ہے۔
"""Does my baby girl want an award?"""	"کیا میری بیٹی میرا بدلہ چُکائے گی. """
Tag: let's learn English	Tag: انگلش بولنا سیکھیں
A complete description is on this site.	مکمل بیان اس سایٹ پر موجود ہے
Welcome to contact us NOW!!!	ہمارے ساتھ رابطہ کرنے میں خوش آمدید !!!!
Each community website is tailored to individual communities/sections of the city.	Home / شہر کی خبریں / شہروں میں ہر گھر کو انٹرنیٹ سہولت فراہم کی جائے گی
Next Hapag-Lloyd opens new office in Kenya	Next: لیکوئی-بکس نے تائیچو چین میں نیا کارخانہ کھول لیا
Meekins: That is, if you must label	Labels: تمھارا کہنا ہے
"""Only if they"	ہے۔ اگر صرف
The US has never joined the ICC and does not recognize its authority over American citizens, saying it poses a threat to national sovereignty and that the US has its own robust procedures in place.	امریکہ کبھی بھی آئی سی سی میں شامل نہیں ہوا ہے اور وہ امریکی شہریوں پر اپنے اختیار کو تسلیم نہیں کرتا ہے ، کہتے ہیں کہ اس سے قومی خودمختاری کو خطرہ لاحق ہے۔
with certain proteins.	کچھ پروٹین.
. in your city and state.	- آپ کے شهر اور محله میں ہے
The Car was Dirty but it was Convenient...	گاڑی کا راستہ اب واضح تو تھا لیکن بہت ناہموار .....
I've been praying for all of you.:)	دعائیں تو میں بہت ساری کرتا ہوں آپ کے لیے۔ سب کی سب لکھوں؟:)
And don't forget the hours.	بھول جائے کہ گھڑی نے کتنے بجائے ۔
Q: Pakistan film industry is on its revival.	سوال: پاکستان کی فلم انڈسٹری بحالی کی طرف جا رہی ہے، آپ کا اس حوالے سے کیا خیال ہے؟آپ اس کا مستقبل کیسا دیکھتی ہیں؟
I bought the same skirt...	خرید لی وہی ہنڈا اکاڈ اُس نے بھی
I'm so far out i can't remember my face.	اب مجھ سے اور دور نہیں رہا جاتا۔ مزید کتنی دوریاں بڑھاؤ گی۔ ایک تمھارا چہرہ تک تو میں دیکھ نہیں سکتا۔
Incompatibilities are truly irregular after ingestion - Positive customer opinions on the product support this positive image in terms of the careful composition of the active ingredients and the efficiency.	اجزاء کے بعد ناقابل یقین حد تک بے ترتیب ہیں - مصنوعات پر مثبت کسٹمر کے خیالات فعال اجزاء اور کارکردگی کے محتاط ساخت کے لحاظ سے اس مثبت تصویر کی حمایت کرتے ہیں.
The primary school teacher who became president	پرائمری سکول ٹیچرپیروکا صدر بن گیا
Has a very old temple.	اس مندر میں ایک بہت پرانا پپل کا درخت ہے.
Canada's Ministry of Foreign Affairs, Free Trade, ...	کریں گے۔ دوسری جانب کینیڈا کی وزیر خارجہ کرسٹیا فری...
Russia has successfully tested a country-wide alternative to the global Internet.	روس نے اعلان کیا ہے کہ اس نے عالمی انٹرنیٹ کے متبادل انٹرنیٹ کا پورے ملک میں کامیاب تجربہ کیا...
Each time you put 1-3 bags of products into the fire, you can see the flames become colorful, including dark or bright blue, purple, red, green, yellow and other colors	جب بھی آپ 1-3 بیگ کی مصنوعات کو آگ میں ڈالتے ہیں ، آپ دیکھ سکتے ہیں کہ شعلہ رنگین میں تبدیل ہوتا ہے ، بشمول گہرا یا روشن نیلے ، جامنی ، سرخ ، سبز ، پیلا اور دیگر رنگ۔
Former South African captain Graeme Smith amassed 1,656 runs in 15 Tests in the year 2008.	جنوبی افریقہ کے سابق کپتان گریم اسمتھ سنہ 2008 میں 1656 بنا سکے تاہم انہوں نے 15 میچز کھیلے۔
My mom still trying to catch her breath.	میں اذیت میں ہوں کہ میری ماں ابھی تک مری خاطر پانی کی تلاش میں سرگرداں ہے۔
We're living for the thrill	ہم جی رہے ہیں شاہِ چمکدار کے سبب
Former CIA officer charged with providing secrets to China...	ایک سابق امریکی سفارتکار کو چین کو خفیہ معلومات دینے کے الزام میں گرفتار کر...
We've become separated.	ہم علیحدہ ہو گئے ہیں
The human will to make meaning.	انسان چاہتا ہے مداوائے اضطراب
President Vladimir Putin will be a major focus of attention, due to concerns that he is deliberately building up further military pressure in eastern Ukraine.	اس کانفرنس میں توجہ کا مرکز روسی صدر ولادیمیر پوتن ہوں گے کیونکہ ان کے بارے میں کہا جا رہا ہے کہ وہ دانستہ طور پر مشرقی یوکرین میں مزید فوجی دباؤ بڑھا رہے ہیں۔
"He is just going to catch a fish!"""	اس نے صرف مچھلیوں کے شکار کے لئے وہاں قیام کیا ہے!
No Hospital and Clinic.	ہسپتال نہ کوئ سکول اے.
Lets take a closer look at how it works.	آئیے ایک قریبی جائزہ لیں کہ یہ کیسے کام کرتا ہے۔
"""I know but he is just too stubborn."""	"""جانتا ہوں مگر بہت ضدی ہیں۔"""
We must stop now.	ہمیں اب رک جانا چاہیے
Soyaoil jumped to its highest in more than 13 months.	Next articleملک میں مہنگائی 3 ماہ کی بلند ترین سطح پر پہنچ گئی
I miscalculated Above.	میں نے اس کے اوپر کمبل درست کرتے ہوئے کہا
stands in front of it	کے سامنے رکے
Back To The Theatre	واپس تھیٹر (ساخت) پر جائیں
Warner scored a 76-ball 69, which included six fours.	وارنر نے 76 گیندوں پر 69 رنز بنائے جس میں چھ چوکے بھی شامل تھے۔
But forgiveness... and allowing forgiveness, covers you with GOD, whenever it is done in sincerity.	اللہ عزوجل آپ کی اورہماری بے حساب بخشش فرمائےآپ کے اہل خانہ کوبھی بخشے اللہ تبارک وتعالیٰ آپ کودعوت اسلامی کا مبلغ بنائے
WGMS is still alive.	ای وی ایم کا سوال زندہ ہے
If you could delete one thing from the United States what would it be?	اگر آپ امریکہ کے بارے میں ایک چیز بدل سکتے ہیں تو یہ کیا ہوگا؟
I'll call you when I get off the train.	جہاز سے اُترتے ہی میں آپ کو فون کروں گی اور۔۔
Imran was brought to the car.	عمران زیر تعمیر مکان میں بچی کو لے کر گیا تھا.
30th December 2006, Saddam Hussein is executed.	30 دسمبر 2006ء: صدام حسین کو پھانسی دیدی گئی۔
The pain 14.	روٹی درد 14
Cow's Milk is for calves only!	ٹارٹیلا چپس صرف ناشتے کے ل!
Ripley: (whispers) It's too late.	عرفان صدیقی: (ہنسی) ہاں دیر بھی بہت ہو گئی ہے۔
He's a guy that loves politics.	"""محبت کون کرتا ہے سیاست کون کرتا ہے"
He said it would take three to five months, and it has now been eleven months.	ان کا کہنا تھا کہ یہ ویزے تین ماہ کے لیے دیے گئے تھے لیکن تقریبا 20 سے 35 دن گزر چکے ہیں اور ہمارے پاس صرف دو ماہ باقی ہیں
"18 In hope, he believed against hope, so that he became the father of many nations; as he had been told, ""So shall your descendants be."""	18 وہ نا امیدی کی حالت میں امید کے ساتھ ایمان لایا تاکہ اس قَول کے مطابق کہ تیری نسل اَیسی ہی ہو گی وہ بہت سی قَوموں کا باپ ہو۔
New drug approved to reduce risk of blood clots	دمہ حملہ کے خطرات کو کم کرنے کے لئے ایک نئی دوا کا وعدہ
The commission is 5%.	کمیشن 2 فیصد ہے.
Prime Minister of Spain spoke at the G20 for reform of the WTO	ارجنٹائن: جی 20 سربراہ اجلاس میں عالمی رہنما عالمی تجارتی تنظیم (ڈبلیو ٹی او) میں اصلاحات پر متفق ہو گئے
Two thirds of Spain's exports are barrel wines.	ہسپانوی شراب کا ایک تہہ برآمد کیا جاتا ہے.
I said that the night it happened.	میں نے کہا کہ دیکھ یہ میں یہ ہوا یہ رات
A Core i5-8210Y should be fast enough for your light - which can grow over time - but it's still poor value for money in a MacBook Air.	وقت کے ساتھ بڑھ سکتی ہے - - ایک کور i5-8210Y آپ کی روشنی کو استعمال کرتا کے لئے تیزی سے کافی ہونا چاہئے لیکن یہ اب بھی ایک MacBook ایئر میں پیسے کے لئے غریب قدر ہے.
Creating real and actual change.	حقیقی اور پائیدار تبدیلی ..
Have a nice ride down, down, down.	کھیل تمہارا سفر اچھا ہو ڈاؤن لوڈ، اتارنا
3:1.The word of the LORD came to Jonah a second time:	1 اور خُداوند کا کلام دُوسری بار یُوناہ پر نازل ہُوا۔
The hotel is just a 20...	وہ کلب نے کیا ہے نہ صرف 20 ...
circle of life: Overjoyed	تحفظ: اووروولٹاج
The researchers requested 50 states, Recent York City, the District of Columbia, Puerto Rico, Guam, and the US Virgin Islands to submit files on coronavirus deaths in those under 21, between February 12 and July 31.	محققین نے 50 ریاستوں ، نیو یارک سٹی ، ضلع کولمبیا ، پورٹو ریکو ، گوام ، اور امریکی ورجن جزیروں سے 12 فروری اور 31 جولائی کے درمیان 21 سال سے کم عمر افراد میں کورونا وائرس سے ہونے والی اموات کے بارے میں معلومات پیش کرنے کو کہا۔
Northern bobwhites.	شمالی بشنود.
In 2019, he co-produced a short film called Issac and Emma.	2019 میں ، اس نے ایک سیلف فنانسڈ ہارر مووی کو ریلیز کیا جس کا نام ہے اماوس.
the prophetic text.	- پیشینگوئیاں text
The Chair reported on the progress of the Engineering Committee.	سیکرٹری داخلہ نے چینی کے حوالے سے کمیٹی کی پیشرفت سے متعلق آگاہ کیا.
The same bread.	وہی روٹین وہی...
Islamic terrorism is nothing to worry about.	اسلامی اتحاد کی فکر کوئی زود گذر فکر نہیں ہے
We trust a hearty response will be given to Mr Hill's appeal.	توقع یہ تھی کہ زرداری صاحب کی تقریر کا بہت شدید ردِ عمل سامنے
Britain's Oldest Romantic Novelist	امیر ترین نو عمر برطانوی فن کار
Greetings in other languages	دیگر زبانوں میں ہیلو
I'm right there with you in the forgetting often category.	میرا نام بھی شامل رکھیں میں اکثر پاس ورڈ لاگ ان بھول جاتا ہوں
Take a look at some videos about New Zealand.	نیو یارک کے بارے میں ایک ویڈیو دیکھیں
We have the best relationships.	اور ہم سب سے اچھے تعلقات چاھتے ہیں.
it's a matter of time, this too shall pass.	کوئی بات نہیں حسن نثار، یہ وقت بھی گزر جائے گا.
Scalar: A quantity that is defined by its magnitude alone.	Scalar quantity - عددیہ مقدار/غیر سمتی مقدار: ایسی مقدار جس نو  ں صرف قیمت (magnitude) دے ذریعے بیان کيتا جا سک  ے۔
After selecting English, it was still in Chinese.	جب چن رہی تھی انگلیاں ، یہ انگلی بھی تب تھی وہاں
8th Day: You need to rest	مٹھی 1: آپ کو آرام کرنے کی ضرورت ہے
Never have I ever had to go to court	میں امید کرتا ہوں کہ مجھے کبھی عدالت نہ جانا پڑا.
there is another website	ایک دوسری ویب سائیٹ
Long government department.	لنگ حقیر حکومتی.
An additional 2,600 army medics were later sent to Wuhan to help.	اس وبا کے خلاف جنگ کی حمایت کے لئے فوج اضافی 2,600 طبی عملہ ووہان بھیجے گی
Holy shit, mark.	لعنتی، ماوریک
The Turks, terrified	ہوم ٹیگز ، شام Terrified
You don't follow me on twitter?	ٹویٹر پر کون میری پیروی نہیں کرتا؟ ·
How many jobs without such a tax break will be lost in the same period?	بغیر ڈرائیور ٹیکسیاں سڑکوں پر۔۔ ان ٹیکسیوں میں ایک وقت میں کتنے مسافر سوار ہو سکیں گے؟عوام کیلئے خوشخبری
It is the 14th homicide this year in Vancouver.	- بتا دیں کہ اس سال کوٹہ میں یہ 14 واں خودکشی کیس ہے.
I'm taking a political stand!	ہاں میں سیاسی نیتا ہوں!
Would you rather get it for a year for free?	کیا میں نے اس کا ذکر کیا ہے کہ آپ کو ایک سال تک یہ مفت ملے گا اگر آپ اس کو نیا خریدتے ہیں؟
Nothing's the same, I'll say it's name.	میں نے کہا؛ یہ تو کوئی بڑی بات نہیں ہے، آپ اس کا نام بتا دیں۔
Uses the hospital and teaching certification of 2020.	2020 طب اور طبی ڈگری کورسز اور داخلہ کی ضروریات کو یہاں ملاحظہ کریں
"Carter said the ""specialized expeditionary targeting force"" will work with both Iraqi and Kurdish Peshmerga forces in Iraq, and be capable of unilateral action in Syria."	کارٹر کا کہنا تھا کہ یہ فورسز عراق اور کرد پیش مرگہ کے ساتھ مل کر کام کریں گے اور شام میں یکطرفہ کارروائی کی صلاحیت بھی رکھیں گے۔
She continued running.	وہ دوڑ رہی تھیں
You know that fire.	تُجھے خبر نہیں یہ آگ ایسی ہے
- It's very good. oy to ask.	جی جی بلکل۔۔۔ نیکی اور پوچھ پوچھ
David didn't listen to his mother.	داود نے ماں کی بات کا جواب نہیں دیا..
of U.S. grandparents are married.	کیا واقعی امریکی سپریم کورٹ نے ان بہن بھائیوں کو آپس میں شادی کی...
cemetery over a half century.	نصف صدی سے زیادہ کا قصہ
It's only Facebook.	نه، فقط فیس بوک.
The framework called for Syria to submit a comprehensive list of its chemical weapons within one week; for inspectors to return to Syria by November 2013; and for the destruction of all chemical weapons by mid-2014.	ان کا کہنا تھا کہ شام ایک ہفتے میں اپنے کیمیائی ہتھیاروں کے ذخائر کی فہرست فراہم کرے اور نومبر تک عالمی معائنہ کاروں کو رسائی دے۔ انہوں نے بتایا کہ شام کے تمام کیمیائی ہتھیار 2014 کے وسط تک تلف کرنے کا ہدف طے کیا گیا ہے۔
Pakistan is a gift.	پاکستان ایک نعمت ہے...
Seven years later, where do we stand?	ستر سال کے بعد۔ ہم نے کہاں جانا ہے
Dinner:what do you want from dinners, except the 3rd day (boiled crabs can be used).	رات کا کھانا:آپ رات کے کھانے میں کیا چاہتے ہو ، سوائے تیسرے دن کے (ابلا ہوا کیکڑے استعمال ہوسکتے ہیں) ۔
Do you know what I remember the most?	آپ کو پتا ھے میں نے سب سے ذیادہ کسے یاد کیا ۔۔۔۔
In 2003 he finished 4th at the World Championship in Cairo, and a year later claimed gold at the Asian Shooting Championship in Kuala Lumpur.	انہوں نے 2003 قاہرہ میں منعقدہ ورلڈ چیمپیئن شپ میں چوتھی پوزیشن حاصل کی تھی اور ایک سال بعد کوالالمپور میں ایشین شوٹنگ چیمپیئن شپ میں سونے کا تمغہ جیتا تھا۔
excuses, and left.	رک رک ۔۔۔ رک جا ۔۔۔۔ مجھے معاف کردے ۔۔ میں جارہا ہوں ۔۔۔
to strengthen the capacity and willingness of China to work with the United	چین دنیا کیساتھ کشادگی اور باہمی تعاون کے فروغ کےلئے پرعزم
I received mine today, it's REALLY beautiful.	میرے علم میں آج یہ با ت آئی ہے ، بے حد خوبصورت
i'm ready boss!	خاک ہوں، سرکار صلى الله عليه وسلم !
In the Sun: October 2011	آفتاب پرست: October 2011
"may not be cold."""	"""یہ کبھی ٹھنڈے نہیں ہونے چاہئیں۔ """
Internally displaced persons 1	افراد ديابتی تيپ 1
'It is a reality.'	""" یہ ایک حقیقت ہے -"""
According to data from 2019:	جب کہ سویڈن کے اعداد و شمار 2013کے مطابق:
In this season's preseason opener, Love suffered	محبت کے موسم میں Prose Poetry میں محبت کے اس موسم میں مرنا چاھتا ہوں
The college started its journey	آزادی ٹرین نے اپنے سفر کا آغاز کردیا
Also, try to get as much experience as possible.	اس کے علاوہ، جہاں تک ممکن ہو اپنے تجربے کا اندازہ لگائیں.
Kemal kidnaps his daughter.	Milfa وہ سزا دے رہا ہے ان کی بیٹی
dots, and lines.	دھاریاں ، لکیریں ۔
Who can benefit from the EOT?	کون استعمال کرسکتا ہے eToro?
The company continued to improve the performance of the camera on these phones to compete with the newer iPhone and Pixel models.	کمپنی نے آئی فون سے مقابلے کے لیے نئے ماڈل میں کیمرے اور بیٹری کو بہتر بنانے پر خصوصی کام کیا ہے
Real-time extensions for Ethernet networks	XRT توسیعات کے لیے حقیقی وقت
She told me she was willing to go.	میرے سمجھانے پر وہ جانے کے لیے راضی ہو گئیں.
They're a complete couple.	والی لڑکی ایک مکمل جوڑی ہوتی ہے ❤️
Olly, you have done well.	علی تم نے اچھا نہیں کیا
Instant response to problems by working as a team with the guest.	کسی ٹیم کے ساتھ رہتے ہوئے صورتحال کے مطابق فوری طور پر حکمت عملی طے کرنا۔
Body of work: Eminem.	ڪمے فڪر میڪنم:راجع بهش فڪر میڪنم.
Appearance of USB-C ports is a definite plus in the development of the MacBook Air, but personally I will miss the SD card reader.	USB-C بندرگاہوں کی آمد - MacBook ایئر کی ترقی میں ایک یقین کے علاوہ ہے، لیکن میں ذاتی طور پر ایسڈی کارڈ ریڈر کی کمی محسوس کریں گے.
He added that it also contains 32 references to international human rights organisations and 14 references from Pakistan.	انہوں نے مزید کہا کہ اس میں بین الاقوامی انسانی حقوق کی تنظیموں کے 32 اور پاکستان کے 14 حوالہ جات بھی شامل ہیں۔
D.R.: Kate, what you're doing is really, really cool.	T: اوہ ، بہت اچھا ہے۔ کیٹی آپ کے بارے میں کیا خیال ہے؟
I am curious about this place.	میں اس مقام عجیب یعنی
"""Listen, my good friend."	سنو میری پیاری ، میری اچھی دوست
(7) With regards to garcinia cambogia, it can easily be overused and is also not so well-regulated.	Garcinia کیمبویا کے معاملے میں، یہ آسانی سے overused کیا جا سکتا ہے اور بہت اچھی طرح سے منظم نہیں ہے.
The current situation in East Africa, the report says, remains extremely alarming as yet another generation of breeding has occurred with more swarms forming and maturing in northern and central Kenya, southern Ethiopia and probably in Somalia.	رپورٹ میں کہا گیا کہ مشرقی افریقہ میں موجودہ صورتحال انتہائی خطرناک ہے کیونکہ نئی نسل پیدا ہورہی ہے جس کی وجہ سے مزید ہجوم اکٹھے ہورہے ہیں اور شمالی اور وسطی کینیا، جنوبی ایتھوپیا اور ممکنہ طور پر صومالیہ کے علاقوں میں پختگی اختیار کر رہے ہیں۔
If your roof is 40 years old, there could be a problem - even if it looks good from the ground.	'اگر آپ کی 40 سالہ پرانی چھت ہے تو ، کوئی مسئلہ ہوسکتا ہے - یہاں تک کہ اگر یہ زمین سے اچھی لگتی ہے۔'
I couldn't live a day	میں ایک سے کسی موسم میں نہیں رہ سکتا
The Life of Women in the Six Dynasties	تلنگانہ انتخابات میں تین خواتین کی دھوم
"There's an old saying: ""everything ends up in the ocean."""	ایک جن آیا اور بولا تم سب کوئی چیز دریا میں پھینکو .
They again challenged God, and offended the Holy One of Israel.	41 اور وہ پھِر خُدا کو آزمانے لگے اور اُنہوں نے اِسرائیل کے قدوس کو ناراض کیا۔
October (64)	▼ اکتوبر (46)
A great fridge for the car.	آپ کی گاڑی کے لیے ٹھنڈی گیجٹ
He needed money for medication and treatment.	اس کو بچے کہ علاج اور دوا کے پیسے مل گۓ
Has it been this way since the beginning of time?	کیا یہ شروع ہی سے ایسا ہے ؟
"""The car is OK, we are OK, tomorrow morning we are coming to the start line."""	'۔ ۔ ۔ گاڑی کھل چکی ہے پاپا۔ ۔ ۔ میں صبح پہنچ رہی ہوں۔ ۔ ۔ '
There is more information about Peter Lacy.	LAZIO کے بارے میں مزید معلومات۔
On leaving the children alone.	جیسے کہ بچوں کو اکیلے باہرنہ جانے دینا۔
Jackson's latest movie, I, is the most expensive film ever made in India.	جیکسن کی تازہ فلم 'آئی' ہندوستان میں بننے والے سب سے مہنگی فلم ہے۔
The situation has become so bad that the poor people of Afghanistan are forced to sell their daughters to avoid starvation.	ورلڈ فوڈ پروگرام نے بتایا کہ افغانستان میں ایسے بحران شدت اختیار کر چکے ہیں جہاں لوگ بھوک مٹانے کے لیے اپنے بچوں کو بیچنے پر مجبور ہو گئے ہیں۔
The service is solid and service is excellent.	سلسلہ اچھا اور ٹھوس ہے۔ اور خدمت بہت ہی عمدہ ہے۔
The world abandons you.	دنیا تجھے خود چھوڑ دے گی ایک دن
Now that I see the moon.	اب میں آتا ہوں تو چاند نظر آتی ہے
I'll be on skype for a while, too!	میں نے کچھ وقت کے گروپ میں پاپ کر سکتے ہیں, بھی!
Finally exhausted we fell against each other.	آخر تھک ہار کر ہم ایک دوسرے پر گر پڑے اور میں
What a great changeup.	کیسی بڑی تبدیلی ہے!
Mr Amanat also left Iran just after the revolution and has not returned since.	حسین امانت نے بھی انقلاب کے بعد ایران چھوڑ دیا تھا اور پھر کبھی واپس نہیں آئے۔
"""How long have you been involved with the vi---um, Mr. Cooper?"""	کیا تم کافی دنوں سے یہاں رہ رہے ہو؟  Bạ- s--- ở đ-- l-- c---?
'Tell me what you've learned.'	"اور بتائیں آپ نے کیا سیکھا۔ ""*"
Require every employee to exercise personal responsibility in preventing harm to themselves, to others and to the environment.	کمپنی کے ہر ملازم سے اس بات کا تقاضا کرنا کہ اپنی ذات، دیگر افراد اور ماحول کے نقصان سے بچاؤ کو اپنی ذاتی ذمہ داری سمجھے۔
About freedom, a license and a gun.	ہم ایک اتھارٹی ، ایک قانون اور ایک بندوق کے بارے میں بات کررہے ہیں
Also why don't you give return labels anymore????	اوراسی طرح دیگروساوس کا جواب (تصدیق) میں کیوں نہیں دیا ؟؟؟
A Decade of Change.	دہائی ہے تبدیلی سرکار کی!
"Delitzsch - The beginning of wisdom is: ""Get wisdom."""	"مشہور مقولہ ہے: ""الرّفق رأس الحکمہ""۔ نرم روی حکمت کی بنیاد ہے۔"
U.S.-backed forces raised their flag over the northeastern Syrian town of Baghuz and said the self-declared caliphate of the Islamic State terror group was finally dead.	امریکی حمایت یافتہ افواج نے شام کے شمال مشرقی قصبے باغوز پر اپنے جنھڈے گاڑ دیے ہیں اور اعلان کیا ہے کہ داعش کے دہشت گرد گروپ کی خود ساختہ خلافت آخر کار دفن ہو چکی ہے۔
"""Not in the file room."""	"""نہیں نہیں، کھانا کمرے میں ہی۔ """
friends who love each other - XVIDEOS.COM	خوبصورت لڑکیوں کی ویڈیو محبت کرتا ہے۔ - Xvideos.com
This exhibition also makes a connection to the future.	۵۔ اور یہ مستقبل کے ساتھ بھی ایک رشتہ بناتی ہے
earlier that morning, he was hungry again.	"کل سے بھوکا ہوں۔۔۔"" اس نے پھر صدا لگائی۔۔"
Q: What happened to the other worshipers who were with you?	سوال: آپ کے دونوں انسپکٹر ساتھیوں کا کیا ہوا؟ جو ابی سے آپ کے ساتھ ملنے گئے تھے ؟
Hunger and insecurity are the worst enemies of peace.	دیکھو !تم ناواقف رہی کہ جہالت اور پسماندگی ہی تہذیب کے سب سے بڑے دشمن ہیں.
All this is my memory of my dad.	ہم تو سب کا مطالعہ کرتے ہیں یہی میرے والد کی نصیحت ہے
Oh fuck, where did you go?	ارے نہیں ....تم شاید کہیں جارہے تھے ....؟
This time around, the Church appealed to people not to vote for the BJP.	اس بار حزب اختلاف نے بی جے پی کے خلاف مسلمانوں کے ووٹ حاصل کرنے کے لئے پورا زور لگا دیا .
No one's life is safe.	کسی کی بھی جان و مال عزت محفوظ نہیں.
A complex machine.	انسان، ایک پیچیدہ مشین
the Lord's compassion is on those who fear him.	خُداوند کے فضل نے اُسے خوفزدہ کر دیا تھا!
CD: Are you afraid of death?	س:موت سے ڈر لگتا ہے؟
At least, it wouldn't.	کم از کم یہ تو نہ ہوتا
There was a study that came out a year or so ago?	ہاں جی تو ایک برس قبل کیا گیا تجزیہ درست ثابت ہوا یا نہیں ؟
Please wait for the new version, which should be faster.	انہوں نے کہا کہ براہ کرم بہت محتاط رہیں۔ نئی لہر تیزی سے پھیلتی ہے اور زیادہ جان لیوا ہے۔
He was just happy that he won.	وہ بس اسے جیتنے پر خوش تھا ۔۔
In this chapter, 'had' was used 25 times.	"٭ لفظ "" اِیْمَان "" 25دفعہ اورلفظ "" کُفْر "" بھی اتنی مرتبہ ہی استعمال ہوا ہے۔"
Ms Berejiklian says that is not the case.	ابن رجب حنبلی کہتے ہیں کہ یہ حدیث درست نہیں.
you are not only our teacher, but also our friend, philosopher and guide, all molded into one person. we will always be grateful for your support.	آپ نہ صرف ہمارے استاد ہیں بلکہ آپ ہمارے دوست ، اتھارٹی ، اور رہنما بھی ہیں ، سب ایک ہی شخص میں پائے جاتے ہیں۔ ہم آپ کے تعاون اور مہربانی کے لئے ہمیشہ آپ کا مشکور ہوں گے۔
If I don't speak out, who else gonna do it?	میں اگر عدل نہ کروں تو اور کون کرے گا!
Heretofore, hospitals were reimbursed for all reasonable charges.	اس وقت آسٹریلوی ہسپتالوں کو ہر علاج کے لئے ایک مقررہ قیمت پر فنڈز مختص کیے گئے ہیں.
(This one comes with a warning that it may cause stomach upset.)	غُصہ میں نصیحت کرنے والا زہر لگتا ہے
"said: ""If it was not grown in the field or fished out of the"	انھوں نے کہا کہ اگر سکھ باشندے اپنی پیدائش کے مقامات میں بھی محفوظ نہ ہوں تو پھر وہ کہاں جائیں یہ ملک چھوڑ دیں یا کیا کریں۔
"""I grieve to say that I hear his name for the first time."""	'مجھے پہلی بار اپنے نام کی وجہ سے ڈر لگا'
