حقیقت میں پانی جسم كے ہر کام سر انجام دیتا ہے .	Water supports all your body's functions.
"سے اوپر ہے!"""	"on top of it!"""
نہیں کوئی نہیں، بس سپروائز کرتی ہوں۔	Belle: No, no, I'm just helping out.
دیسی بیوی شوہر 02:41	Queen of the Damned 2:41Â
مغربی معاشرے میں اپنے ثقافتی لباس پہننا شرمندہ تعل .ی کی کوئی بات نہیں۔ تاہم ، بدقسمتی سے کبھی کبھار ، کچھ لوگوں کے لئے ، یہ رکاوٹ پیش کرسکتا ہے۔	In our liberal Western societies, it is - fortunately - impossible to keep people locked up at home.
سنگ سنگ شکن جو	Deep-seated doubts about
کہیں نہیں...میں سوچ رہی تھی یہ سوٹ ویلیمے میں پہن لوں گی...اتنا بھاری ہے-	I am wearing...I think I should take this question out of this template..always so boring.
بروشسکی ویکیـپـیڈ یا میں خوش آمدید.	Welcome to Ukrainian Wikiversity.
میں ہے اور أَثَام	I am and i shall be to the end
خیال رہے کہ اٹلی میں ہفتے کو 793 ہلاکتیں اس بیماری کے نتیجے میں ہوئیں جو کسی بھی ملک میں ایک دن میں سب سے زیادہ ہلاکتیں تھیں، جبکہ اتوار کو یہ تعداد 651 تھی۔	It is thought that in Italy on Saturday, the disease resulted in 793 deaths, the highest in any country in a single day, compared to 651 on Sunday.
1۔ یہ آڈیو واقعی 7 دسمبر کو تباہ ہونے والے طیارے کی تھی	This was followed by a Spectacular Audio Launch of the film on the 7th of December .
ڈبلیو ٹی جی پی: نجی جانا چاہتے ہو؟ (ایک نجی چیٹ روم میں منتقل کرنے کی درخواست۔).	Virtual Private Network.Do you want to come to Canada?
'کہیں یہ امریکہ تو نہیں'	"""This is NOT the United States"""
شکریہ ، ابھیجیت!	Thank you for now!
پولیس تعاون نہیں کر رہی:زینب کی والدہ	I don't feel safe: Binayak's wife
كيونكہ آپ اپنے خاوند كے بھائيوں كے	You're thinking of his brother
اس سال کئی رسالے Galicia کے بارے میں Yaremche کارل فرانز جوزف Habsburg ، جو بعد میں آسٹریا بن کے مستقبل کے وارث کے میں رہ لکھا تھا -- ہنگری Cisar اور چارلس (1916 -- 1918).	This year, many magazines Galicia wrote about being in the future heir Yaremche Karl Franz Joseph of Habsburg, who later became the Austro-Hungarian Emperor Charles I (1916 - 1918).
پانی خشک ہوجائے.	The water will be dry.
سبھی کو لوٹ جانا ہے	They all have to go back
ھممم۔۔۔ تو آپ بھی میرے ساتھ یہ کرنے والی ہیں؟!:00002:	"""So... will you do it with me?"""
ہم سمجھتے ہیں کہ اسی احتساب کو چلتے رہنا چاہیے اور چلتے چلتے اس میں بہتری لائی جائے .	I think we should keep that in mind and move forward.
عوسیہ ۔ حمایت ۔ مددگار ۔	Wrist. supports.
حکومت کو سپریم کورٹ جانا ہی نہیں چاہیے تھا	The Government of Canada did not go to the Supreme Court.
میں رو رہا ہوں قوم کے مرجھائے پھول پر	I am the nation's weeping dead
تے جدوں داء لگدا جان بجھ کے دادی دی کوئی شے خراب کردیندا تے فیر راتیں کُٹ پینی لازمی ہو جاندا سی۔	7) For those who sleep, sleep at night, and those who get drunk are drunk at night.
دوسری جانب یورو فٹبال کپ کے ترجمان نے کہا کہ 'کھلاڑیوں کو پریس کانفرنس کے دوران پانی کے ساتھ ساتھ کوکا کولا اور کوکا کولا زیرو بھی پیش کی جاتی ہے۔	"A Euro 2020 spokesperson added, ""Players are offered water, alongside Coca-Cola and Coca-Cola Zero Sugar, on arrival at our press conferences."""
"ستمبر 1950 میں ، میک آرتھر نے اقوام متحدہ کو اپنی عوامی رپورٹ میں کہا ، ""بے گناہ شہریوں کے قتل اور شہری معیشت کو پہنچنے والے نقصانات سے گریز کا مسئلہ مستقل طور پر موجود ہے اور میری ذاتی توجہ دی جارہی ہے۔"""	"In September 1950, MacArthur said in his public report to the United Nations, ""The problem of avoiding the killing of innocent civilians and damages to the civilian economy is continually present and given my personal attention.""[319]"
"کوئی چھوٹا "" سا دو لفظی """	"""Thats two words."""
میں سوچتا رہا، کرائے کے بغیر سفر کیسے کروں۔	I don't know how I could travel without it.
اور آپ اسے کبھی بھی ایسی کوئی چیز نہیں بھیجنا چاہتے جو رجحانات میں ہے۔	She never want you get it is going to the events.
امریکی شہریوں نے اپنے پیاروں کی میتیں وصول کرنے سے انکار کردیا	people of the United States lost their beloved
جمہوری نظام میں دیکھو یا پھر آمریت میں دیکھو۔	"""Look at the regimes in the region or in Latin America."
دور جدید مبارک باد .	modern-day royals.
پھر آہستہ آہستہ یہاں کے بہت سے لوگوں کی محبت۔۔ جن میں بہت سے ممبرز شامل ہیں۔	In remoteness from one another, many peoples live here.
آغاز ہمیشہ فع سے ہوتی ہے یہ دھن	To start the process, it is always good
"میں نے کہا""ہو تو سکتے ہیں بلکہ بعض اوقات پارٹی بازی میں یہ چنڈال چمچے بن جاتے ہیں۔"""	"I said, ""I think so, Pam can get kind of squirmy sometimes."""
سب سے پہلے، آن لائن رقم کمانے کا موقع.	Firstly, the opportunity to earn money online.
طیارہ بارش اور موسم کی خرابی کے باعث حادثے کا شکار ہوا	The contest was postponed due to rain and thunderstorms.
اچانک اس بیابان میں ایک آواز سنائی دی، اے صحرائے بیدا اس ظالم قوم کو اپنے اندر نگل لو۔ (5)	And there came a man from the furthest part of the city, running; he said, 'My people, follow the messengers.' (36:20)
()) اے پی پی کے تحت خریدی گئی سیکیورٹیز کی اصل ادائیگیوں کی دوبارہ انوسٹمنٹ پوری تاریخ میں جاری رہے گی ، جب گورننگ کونسل اہم ای سی بی سود کی شرحوں میں اضافہ کرنا شروع کرے گی ، اور کسی بھی صورت میں جب تک سازگار رطوبت کے حالات اور معاشی رہائش کی کافی حد تک برقرار رکھنے کے لئے ضروری ہے۔	In addition, reinvestments of the principal payments from maturing securities purchased under the APP will continue, in full, for an extended period of time past the date on which the Governing Council begins to raise the key ECB interest rates, and in any case for as long as necessary to maintain favorable liquidity conditions and an ample degree of monetary accommodation.
ہنگری کے وزير اعظم وکٹور اوربان	The Prime Minister of Hungary Viktor Orban
باقاعدہ قیمت £ 19.99 بک گیا	reduced price of £19.99.
"""ریٹائرمنٹ کے بعد اب آپ کی کیا مصروفیات ہیں؟"""	"""What are you occupied about now?"""
ایڈز/ایچ آئی وی کا شکار لوگ: 500 سے کم (2016ء تخمینہ۔)	HIV/AIDS - people living with HIV/AIDS: fewer than 600 (2007 est.)
رنگین دور میں بلیک اینڈ وائٹ باتیں دہرانے کا شکریہ	Thank you for putting my thoughts in black and white
میں آپ کے ساتھ اچھے تعلقات میں کرنا چاہتے ہیں	I do want to have a good relationship with you
مگر روٹی سے گدھے کا واسطہ؟	What to do about the bread?
پاکستان نے عسکریت پسندی، انتہا پسندی اور دہشتگردی کی روک تھام کیلئے ہمیشہ تمام علاقائی اور عالمی کوششوں کی حمایت کی۔	Pakistan has consistently supported all regional and international efforts to combat terrorism and extremism.
تمل ناڈو میں بارش کے بعد حالات بگڑے ، اب تک ۱۵ افراد کی موت ، سیلاب کا الرٹ	Heavy rains continue in Tamil Nadu, 12 people have died so far; water on...
ترجمہ: اگر اللہ تمہیں کسی قسم کا نقصان پہنچائے تو اس کے سوا کوئی نہیں جو تمہیں اس نقصان سے بچا سکے اور اگر وہ تمہیں کسی بھلائی سے بہرہ مند کرے تو وہ ہر چیز پر قادر ہے۔	And if Allah touches you with misfortune, there is no one who can remove it but He; and if He touches you with good fortune, it is He who has power over all things.
(١) مذکورہ حدیث حسب ذیل کتاب میں بھی نقل کی گئی ہے:	(v) A similar warning can also be read in the following ahadith:
ا اسٹاک پنج کو باضابطہ بنانے کے لیے قانون پر ایک کمیٹی کی سفارشات پر غور کرے۔ و دوریاستی.	Considers the recommendation of a Committee on a law to regulate the stock exchange.
اگر یہ موجود نہیں ہے تو ڈائریکٹری بنائیں۔	If it doesn't, create the directory.
نہیں، موجودہ پالیسی کافی...	Today, there is quite...
کم از کم تین سال کی تکمیل' یورپی یونین / EEA ملک یا سوئزرلینڈ میں ایک اعلی تعلیمی پروگرام میں اسٹڈی: 10 پوائنٹس	Completion of at least one year's study at a higher educational programme in an EU/EEA country or Switzerland: ۵ points
تو یہ ایک اچھا احساس ہے .	and this is a good feeling.
کی ایک زیادہ سے زیادہ 2 ٹریلین سککوں جاری کیا جائے گا, اور اس کا مقصد ایک واحد سکوں کے قابل ہو جائے گا ہے $1.	A max of 2 trillion coins will be issued, and the aim is a single coin will be worth $1.
ہائے میری جانی مہر۔۔۔تم اتنی سیریس۔۔۔	Oh Heero, you're such a fag...
مثال کے طور پرہم نے تشکیل دیا ہے.	For example, we would want to create.
سب سے زیادہ عام انسٹرومنٹ ایک سٹاپ نقصان ہو جائے اور لے منافع بخش سمجھا جاتا ہے.	The most common tools are considered to be stop-loss and take-profit.
"میں کہتا ہوں) ، یا آپ کے بارے میں سوچ رہے ہیں, ""مجھے سچ میں نہیں دیکھ بھال کے بارے میں ہے کہ چیزیں."""	"I say), or you're thinking, ""I really don't care about that stuff."""
سبز چائے کا یہ فائدہ جانتے ہیں؟...	What are the benefits of green tea?...
روایت سے مستنبط اہم مسائل	One of the main problems associated with traditional
اندرا کے لئے سونے کا وقت لے لو.	Take time to sleep in.
اور فوری طور پر میدان اور منتقلی کے نیچے حاصل کرنے کے لئے کھلاڑیوں کی حوصلہ افزائی کریں.	Encourage players to get up and down the field and transition quickly.
اگر یونانی اور ترک کسی معاہدے تک پہنچتے ہیں تور یونانی قبرص ترک بندرگاہوں اور ہوائی اڈوں کے ساتھ واروشا تک بھی رسائی حاصل کرے گا اور ترک قبرص غازی مغاسا کی بندرگاہ سے براہ راست تجارت کر پائے گا۔	If the Greek and Turkish sides reach an agreement, Greek Cypriots will gain access to Varosha and Turkish ports and airports, and Turkish Cypriots will be able to engage in direct trade via Famagusta port.
بھارتی میوزک کمپنی کو عاطف اسلم کا گانا ہٹانا مہنگا پڑگیا	Indian music company removes Atif Aslam's song from YouTube
کہاں بھینس اور کہاں بکری کی چھوٹی ذات۔	Mist everywhere, and a small glacier tongue.
سرد ترکی چھوڑنے کے بجائے الکحل کے استعمال کو کیسے کنٹرول کریں۔	Try weaning yourself off of cannabis instead of going cold turkey.
ارے آپ guyz !!!	Do you guys!.
اصل میں، وہ آپ سے بھی براہ راست رابطہ کر سکتے ہیں.	In fact, they may even be directly competing with you.
یہ فون اب سرکاری طور پر اسپین میں خریدا جاسکتا ہے.	Now, the smartphone can be officially sold in Brazil.
ایردوآن کے داماد ترکی کے وزیر خزانہ کے عہدے سے مستعفی	President Erdogan's son-in-law resigns as Turkish finance minister
ہم جانتے ہیں کہ تمام طالب علموں کو اپنی پیش گوئی کی گریڈ حاصل نہیں ہوتی.	We know that not every student will meet every goal.
اپنے نام کے ساتھ اپنے نبی کا نام ملا لیا جبکہ پانچویں وقت اشھد کہتا ہے آپ کی عزت و جلال کے اظہار کے لیے اپنے نام میں سے آپ کا نام نکالا دیکھو وہ عرش والامحمود ہے اور آپ محمد صلى الله عليه وسلمہیں	"Upon seeing him in this situation, his companion Bilal, who is about to recite the call to prayer for the pre-dawn, asks him ""O Allah's messenger!"
OMFG اوہ میرے خدایا	OMG, oh my god.
لیکن خبردار جو پینے پلانے کی بات کی؟ گردن اتار دی جاتی ہے یہاں پر ...کینیڈا نہیں ہے یہ	Don't be turned off because this whiskey was distilled in Canada.
تین سالوں میں بدترین نااہلی اور کرپشن کی گئی ہے	It was the coldest and wetest in 30 years.
I. آئیے دیکھتے ہیں آسمان میں کیا ہوگا، عبرانیوں12:22۔24؛	(3) as a figure of things in the heavens Hebrews 9:23; Hebrews 9:24.
رپورٹر:کیا آپ دوبارہ مسجد جائیں گی؟	Are you returning to the Church?
(4) یقیناً ہم نے کافروں کے لیے زنجیریں اور طوق اور شعلوں والی آگ تیار کر رکھی ہے.	And, of course, we install fire pits and fireplaces.
دوہڑے بیت کہے اس چنگے نہیں کتابیں کھُلاّ	Les said: This book is not for dummies.
اس ضرب کی زد پر سب سے پہلے فلسطین قوم اور اس کے بعد علاقے کی تمام اقوام تھیں۔	The primary target of this blow was the Palestinian nation and secondarily all the other nations in the region.
ایک 17 سالہ عمر کے طور پر، اس نے اس بیماری کے بارے میں کبھی بھی سنا نہیں تھا.	At age 58 she had never heard of this guy.
انھوں نے سنہ 2017 میں فلم 'مون لائٹ' کے لیے بھی بہترین معاون اداکار کا ایوارڈ ملا تھا۔	He won as Best Supporting Actor for the 2017 film 'Moonlight'.
پھر بھی حکومت کی ترجیح میٹروبس اور اورنج لائن ٹرین کیوں ؟	"""Why India's Metro and suburban railways should merge."""
شاید اس کا اصل مصدر حذف ہوگیا یا کردیا گیا.	It may be that the initial setup process was corrupted or interrupted.
کپتان جیت کے دیکھائے گا	The captain will win.
آرٹ کے مطابق تنازعات کا متبادل حل.	Alternative dispute resolution in accordance with art.
شاید کسی نئے کو کام آ سکے۔	It might be a new employee.
اس حملے کے بعد ملک بھر میں شدید صدمے اور غم و غصے کا اظہار کیا گیا۔	The attack triggered grief and anger across the country.
جناب انکی شوخیاں نہیں ختم ہونے والیں۔	Your veneers are not loose.
صلی اللہ علیہ وسلم دعا استسقاء کے سوا اور کسی دعا میں (زیادہ اونچا) ہاتھ نہیں اٹھاتے تھے۔ اس دعا میں آپ صلی اللہ علیہ وسلم اتنا اونچا ہاتھ اٹھاتے کہ بغل مبارک کی سفیدی دکھائی دیتی تھی۔	No prayer will be offered only in the condition of the prayer.
اسے گھرگھراہٹ ہے، غراہٹ ہے، یا جلدی جلدی سانس لے رہا ہے	He's either having trouble breathing, coughing, or breathing quickly.
بھارت دس سال بعد ہاکی کپ ایشیا کا ہیرو بن گیا	Four decades later, Singapore had become an Asian tiger.
ایک ہاؤس سیٹر پر کتنا خرچ آئے گا؟	What's the Cost of a Townhouse?
تو ہی سلامتی ہے!	there's peace!
اس کے باوجود، وہ کافی مستحکم ہے.	It does, however, feel very stable.
نشان زد تصویر کو دیکھو 3 مندرجہ بالا تصویر میں.	Look at the three circles in the above picture.
وفاقی دارالحکومت علاقہ، نائجیریا	the Federal Capital Territory of nigeria
نیا 100 دن، پرانا 9 دن۔	A whole 9 days old.
امریکا نے داعش سے لڑنے کیلئے کرد جنگجوؤں کو اسلحہ فراہمی کی منظوری دیدی	U.S. provides weapons to Kurds in fight against Islamic militants
میں اب بھی اصرار کرتا ہوں کہ یہ انسان کاتیار کردہ ہے	I'm still convinced he's a human.
"حقوق اداری"""	"right of action."""
اولڈ ٹاؤن اسکوائر تعمیراتی طرزوں کا شاندار امتزاج ہے، یہاں ایک خوبصورت گوتھک چرچ اور بہت سارے یہودی ورثے ہیں - حالانکہ دوسری عالمی جنگ کے دوران کمیونٹی کم و بیش مٹ گئی تھی۔	The Old Town square is a glorious mix of architectural styles, there's a beautiful gothic church and a lot of Jewish heritage - though the community was more or less wiped out during the Second World War.
اپنی نسبت سے میں کچھ نہیں ہوں اِس کرم کی بدولت بڑا ہوں اُن ٹکڑوں...	There's nothing greater than my dick, these sluts work best....
میرا مطلب یہ ہے کہ ویب سائٹ کی تعمیر کا عمل تقریبا ایک سو مختلف طریقوں سے ممکن ہوسکتا ہے.	Assembling a site may be accomplished hundreds of various ways.
پرچم، درفش.	Tuess, the se.
'قومی شناختی کارڈ کی شرط برقرار'	"lines of national identity."""
میری طویل ٹانگوں اور ٹنی انگلیوں کی ضرورت ہے کرنے کے لئے ہو پوجا	I've had a few worship my feet and long legs
قائم شدہ حکمران طبقہ جس کی طاقتور ترین جماعتوں کے مسلح ونگ ہیں توقع کی جاتی ہے کہ وہ ووٹ حاصل کرے ، مولوی مقتدا الصدر کی قیادت میں تحریک ، جو تمام غیر ملکی مداخلت کی مخالفت کرتی ہے اور جس کے اہم حریف ایران سے وابستہ گروہ ہیں ، پارلیمنٹ کے سب سے بڑے دھڑے کے طور پر ابھرتے ہوئے .	The established, Shi'ite Islamist-dominated ruling elite, whose most powerful parties have armed wings, is expected to sweep the vote, with the movement led by populist Shi'ite cleric Moqtada al-Sadr, who opposes all foreign interference and whose main rivals are Iran-allied Shi'ite groups, seen emerging as parliament's biggest faction.
"ذریعہ نے کہا ""نیٹ ورک سسٹم، عمارتوں کے ارد گرد شوٹنگ بھی کرنے کے قابل، 9/11 کی طرح اور دیگر قریبی خطرات کی دیکھ بھال کرے گی."""	"""The networked system, capable of even shooting around buildings, will take care of 9/11-like and other close-in threats,"" said the source."
Maulana Shah Imam Ahmed Raza Khan تو بولے کیا ہم اپنے میں کے ایک آدمی کی تابعداری کریں (ف۳۴) جب تو ہم ضرور گمراہ اور دیوانے ہیں (ف۳۵)	"Muhsin Khan: And they say: ""When we are (dead and become) lost in the earth, shall we indeed be recreated anew?"""
میرے دوست نے اپنی بالیاں توڑ دیا، کہ یہ کیا ہے ایک خواب دیکھا؟	When my hair has dried, it's a dream.
بس جو رہتا تها وہ اک تلاش.	Just looking for the guy that used to live here.
ملک میں پچھلے سال جون کے بعد پہلی بار ایک...	for the first time in June of last year.
تیری جھیل سی آنکھوں میں ڈوب جانے کو دل کرتا ھے	The quiet lake is stretching away before your eyes.
کم سے کم ذاتی ورژن $ 245.00	personal version for $40.00 USD
یہ 1960s میں شروع ہوا تھا، اور میں سوچتا ہوں کہ ایک چھوٹا پینٹنگ ایک بچہ رکھتا ہے جسے بچے کے لے جانے کے لئے اپنی آرٹ کا انتخاب کرنا ہوگا.	It is set in the 1980s, and it involves kids making their own video adventure movie.
کینا سوہنا مینوں رب نے بنایا،جی کرے ویکھدا رہواں	In the name of your Rabb Who created.)
"""ہماری سخت نو لاگز پالیسی اس بات کی ضمانت دیتی ہے کہ آپ صرف یہ جانیں گے کہ آپ آن لائن کیا کرتے ہیں۔"""	A zero-logs policy means only you know what you're doing online.
ہم تو کافر ہوں ۔۔۔۔اگر بندے نہ ہوں اسلام کے	We get it religion is bad...unless it's islam then we're Islamophobes.
جیو نیوز کے مطابق پاکستان پیپلز ...	According to DW, Pakistan's young...
مزید سنگین ضمنی اثرات جو طبی توجہ کی ضرورت ہوتی ہیں وہ شامل ہیں:	More serious side effects requiring medical assistance include:
بچپن کا دوست تو ایسا نہیں لیکن میرے تمام دوست میرے لیے سرمایہ ہیں لہذا کسی ایک کے بارے میں لکھ کر ناانصافی نہیں کرنا چاہتا.	I mean, all my friends are uni students, so they refuse to pay for a subscription for anything.
کورٹ میرج کے لئے عمر کی حد8 1سال ہے	The Clerk of Court is an eight year term.
وہ 55 دن تک بھوک ہڑتال پر رہے تھے۔	He has been on a hunger strike for a few days.
کچھ صارفین نے چائے کے مہنگے کپ سے متعلق دوبارہ تبصرے کیے۔	Other reviewers have commented on the cow smell.
وسطی اور مشرقی یورپ میں زبردستی ہجرت ، 1939-1950	کتاب Forced Migration in Central and Eastern Europe, 1939 -1950
وہ ممکنہ طور پر جدیدیت کے ایسے بانیوں کے لۓ آخری زندہ رہنما تھا جیسے لی کوربسیر اور بروہس والٹر گروپیس اور مارسل برور نے ان تمام سارے واقعات سے ملاقات کی.	He was possibly the last living link to such founders of modernism as Bauhaus stalwarts Walter Gropius and Marcel Breuer, all of whom he met.
نـع کی گفته ؟	Talking to the other one?
'روس بھی برطانوی سفارت کاروں کو جلد ملک بدر کرے گا'	Russia also plans to expel British diplomats in the near future.
سمجھ میں کچھ نہیں آتا کہ ہم کیا کررہے ہیں _ سخن سرا	We Have No Idea What We're Doing _ Unturned
استقبال میں شادی کی تقریب کو متعارف کروانے کے لئے گانے ، نغمے	Songs for the wedding party introduction at the reception.
'میں آپ لوگوں کو یہ بتانا چاہتی ہوں کہ دراصل میں۔۔۔' مقابلہ حسن میں شریک اس ...	I should add... that I truly wanted this company to be good...
مجھے ڈھونڈنے سے نہیں ملا	I failed to find.
قانون بلحاظ دہائی	A decade of the law
مجھ کو میرے وجود کی تک نہ جانئیے - Shaur	"don't remember my life before clay."""
سبھی اندین کو پتا تھا کہ میرے ملک کی ایجنسی مجھے ٹریس رہی مگر کسی نے بتایا نہیں۔	My neighbors knew everything that was going on in our house, and no one told them.
پہلا, یہ آپ کے بچے کا نام کیلئے ذاتی کیونکہ, ناشر سے پر مندرجہ ذیل میرے نام کی پہلی کتاب کھو گیا چھوٹا لڑکا / لڑکی کون اس کی / اس کا نام گمشدہ.	Primero, because it's personalised to your child's name, following on from publisher Lost My Name's first book The Little Boy/Girl Who Lost His/Her Name.
ج) مفید یا مضر و ارثی	2. favorable or propitious.
Next شرپسندوں نے دیوارِ قبرستان توڑی	The slum dwellers had broken the barrier
تبدیلیاں کیا ہیں؟	"""What are modifications?"
"بے معنی ہے اس کیلئے تو سب کچھ۔"""	"It definitely means everything."""
اونٹ اور گائے سات افراد کی طرف سے کفایت کرجاتی ہے	The camel or the cow can be shared by seven people.
میں نے کہا کہ میں نے آپ کو اس کے ساتھ مل کر کام کرنے کی کوشش کی ہے.	was trying to work with it.
"""یہ خبر شائع کرنے کے لیے مجھ سے کسی نے نہیں کہا تھا...."	"""I haven't told anyone else this information..."""
بخینی ۔ کسی حصے کا مکمل خاتمہ ۔	Wiped, end of party.
سب سے پہلے, یلئڈی فلیٹ پینل ہم سب سے پہلے روشنی کی بنیادی ساخت سمجھنے روشنی ساخت ذریعہ:	The main focus of the lab is to understand the molecular basis for
نیٹ ورکنگ ایک کام کی تلاش کا ایک لازمی جزو ہے.	Networking is an essential part of finding a job.
فرقہ وارانہ تشدد کی تاریخ سے دوچار شمالی آئرلینڈ اب بھی شناخت کی سیاست سے منقسم ہے متعلقہ امن پسند تاکہ یورپی یونین اور برطانیہ میں تیزی سے ان شکایات کو سانس لینے کے ل.	Northern Ireland, plagued by a history of sectarian violence, is still divided by identity politics, with peacemakers concerned that the EU-UK spat might create a space for those grievances to breathe.
نہیں نے لکھا:	Noe writes:
"""دیکھیں امو جان کون آیا ہے""۔"	"""Sanju, look who is here."""
ہم بھی ہیں وہی، مسئلۂ جاں بھی وہی ہے	because the issue is the same whichever it is.
چل جو بھی ہو دیکھا جائے گا۔	Whatever we'll see.
ہمیں بھلا ان سے واسطہ کیا جو تجھ سے ناآشنا رہے ہیں 189 189 162 176 بانگ درا	What to expect when you're expecting 618.9285 B896
پی ایس ایل کا ترانہحدیقہ کیانی بھی میدان میں آگئیں	The PSNI3 canine unit will also be patrolling the area.
اگر آپ ایک مختلف وقت میں جاگ تو، ایک مختلف جگہ میں،	If you wake up at a different time, in a different place,
لیکن تمام عمر ہی چلنا پڑا تجھے!	So you had to walk all the time.
تیسری پارٹی ہماری ویب سائٹ پر اشتہار دے سکتی ہے.	Third party links may be present on our website.
لیکن مجھے تو وقت کا پتا ہی نہ چلا کم از کم تم کو مجھے بتانا چاہیئے تھا۔۔وہ واقعی شرمندہ ہورہی تھی.	I didn't have the courage to tell you then, but you ruined me.
ڈھاکہ:'زندہ ملنے کی اب کوئی امید نہیں	Toprak: There is no hope for us anymore.
"اس سائٹ پر دوسری سائٹس، ایپلی کیشنز اور پلیٹ فارمز کے لنکس شامل ہیں (یہاں "" لنک کردہ سائٹس "" کے بعد)."	"The Site may contain links to other websites, applications, and platforms (hereinafter the""Linked Sites"")."
دونوں قیمتوں پر ایک نگاہ ڈالیں چارٹس ذیل میں.	Have a look at the two charts below.
گھنٹے: 7 دن ایک ہفتے 9AM - ایکس این ایکس ایکس اگست اگست 5 - اکتوبر 16، 31	Hours: 7 days a week 9am - 5pm August 16 - October 31, 2019
نہ ممکن تھا کہ وہ اس کو بناسکتے۔ آئیے ہم ذرا اس بارے میں سوچتے ہیں۔	It cannot, think about it.
اس سے ہونٹ کچھ ہی دنوں میں نرم اور چمکدار دکھائی دینے لگیں گے.	They will turn soft and sweet in a few days.
دنیا کا سب سے بڑا خاندان: بھارت یا یوکرین میں؟	The vast populations of India or China?
4) کچھ ایسا ہو گیا ہے یار اپنا	"""Something has happened, Mr."
جوفرا آرچر پر جرمانہ، وارننگ لیٹر جاری	The saga of clogging the arteries, continued
مسلسل مر رہی ہوں میں	I'm constantly dying.
مرحوم ایک معروف احمدی مسلمان تھے.	Abdus Salam was a Ahmadiyya Muslim.
کرنسی کے جوڑوں اور چھوٹے لاتوں کی بڑی تعداد کا استعمال کرتے وقت، غیر ملکی کرنسی مارکیٹ میں بالکل محفوظ ٹریڈنگ حاصل کرنا ممکن ہے.	Using a large number of currency pairs and small lots, absolutely safe Forex trading is achieved.
فی الحال ، میں آپ کو ایک ہاتھ کا استعمال کرتے ہوئے متن بھیج رہا ہوں کیونکہ دوسرا حصہ کہیں اور مصروف ہے۔ لگتا ہے کہاں ہے؟	Right now I'm sending you texts with one hand because the other hand is busy with something else.
ایک کامیاب اثر و رسوخ کی مارکیٹنگ کے پروگرام کو تشکیل دینے کا طریقہ.	How to Build a Successful influencer Marketing Program
ہمارے ہیرو کون؟	Who's our hero?
یہ زیادہ تر فوٹو گرافی سے کیا جاتا ہے.	It is in most of the photos.
اگر آپ شک میں رہیں تو، باقی امتحانات کے جائزے کو ملاحظہ کریں.	If you doubt that, just look at the other reviews.
تو آپ کی مصنوعات کے بارے میں اور کیا جاننا چاہئے؟	What more do you want to know about my products?
پھر کیا فرما یا انہوں نے	Mind over matter, though (or so they say).
اپنے کتے کو کتے کے تربیتی کلاس میں داخل کرنے پر غور کریں ، جہاں آپ کا کتا تفریح   کے دوران ضروری مہارتیں سیکھ سکتا ہے۔	Alternatively, take part in a hands-on cooking class, during which you will learn how to make Shanghai dumplings.
ریاستہائے متحدہ ، جو زیادہ تر فوج فراہم کرتی ہے ، کے پاس عراق میں 2500 فوجی باقی ہیں - جو ایک سال پہلے 5،200 تھے۔	The United States, which provides the bulk of the force, has 2,500 troops left in Iraq, down from 5,200 a year ago.
ترکمانستان وہ ملک ہے جہاں فضائی آلودگی کے باعث ہونے والی اموات کی شرح سب سے زیادہ ہے۔	And China is the country with the highest death toll because of air pollution.
کارروائی،سرچ آپریشن	in operations research
A VFR اس طرح کی چیز کے لئے ایک بہترین انتخاب ہو جائے گا.	VPN will be one of the best solutions for this.
اس ماحول میں مولانا ثناء اللہ صاحب کی شخصیت اور اصول کے اس پہلو کو عام کرنے کی اشد ضرورت ہے۔	In any case, there is always an essential ambiguity in the nature of this god of the stone pile.
سب کچھ وہ موبائل فون پر کیا معلوم	what he knew over the telephone.
انہوں نے کہا کہ اس کے میڈیا کا دعویٰ ہے کہ بھارتی طیارے 21 منٹ تک پاکستان کی فضائی حدود میں رہے ان میں ہمت ہے تو ایسا کرکے دکھائیں۔	He dared Indian Air Force to remain in Pakistani airspace for 21 minutes and see what happens.
اسٹوڈیو: Noovo	made by: Nooooooooooooooo
سالہ ایک عظیم فٹ بال ہے.	This is a big year for the game.
نہیں تو کم از کم مرکزی کمیٹی کا ٹی وی پر آنا بند کردیں	Or at least cut back on your cable television service.
عراق میں داعش نے دوب...	I'm Kurdish in Iraq..
آپ کو اس علاج کی خریداری کے لۓ اس سے آگاہ ہونا ضروری ہے:	You must be aware of this fact to buy the right equipment.
اسے مارنے والے امریکی تھے؟ نہیں!	Americans were going to kill them.
2020-21 اسکول سال کے کیلنڈر کو اپنایا گیا	The calendar for the 2020-21 school year has been set.
یہ چند دن قبل خشک ہونا چاہئے.	It should be fermented a few days ago.
تمہاری موت لوگوں کو تتر بتر کرنے کا ایک طریقہ ہے	of them is the way of death.
میں دلچسپ ہوں اور مزید معلومات کے ل questions سوالات پوچھنا چاہتا ہوں۔	I am interested and have more questions.
ہماری حالت کی جانچ پڑتال کر رہا ہے یہ 10 سے کم ہے کہ.	From what we have determined, these number less than 10.
شاید ہے یہ کوئی باپ	Maybe he's not a daddy.
کمیونزم کے خلاف شائع کیا گیا ایک پراپیگنڈہ پوسٹر	Street poster with anti-Communist message.
ہم دنیا بھر کے لئے جہاز 2.	We ship Hope II all over the world.
"دو مریل کتوں کے بھونکنے کے شور میں، میں ایک بوڑھی، کمان بنی عورت سے پوچھتا ہوں "" ماسی عمر دراز کا گھر کہاں ہے ؟"""	"That reminds me of a fast-food ad in which an elderly lady yells out, ""Where's the beef?"""
لفظ کے ارد گرد ہو جاتا ہے.	The word does get around.
وہ شخص كہنے لگا: اے ابو عبدالرحمن	"""And He said, Abba Father..."
قیمت آخر میں سپورٹ کو توڑتی ہے.	The price will eventually goes down.
ڈی اے کاٹز نے کہا کہ ویڈیو نگرانی کی فوٹیج میں دکھایا گیا ہے کہ 7 فروری 2021 کو شام 2 بجکر 45 منٹ پر اسٹوکس ایک کھڑی گاڑی سے باہر نکل رہے تھے۔	DA Katz said video surveillance footage shows Stokes exiting a parked car around 2:45 p.m. on February 7, 2021.
احتیاطی پابندیاں فروری کا پورا مہینہ نافذالعمل رہیں گے:پب اور بار بند رہیں گے۔	Check-stops will be set up throughout the month and into January.
چلو، اس شہر سے	And get out of this town
مسئلہ۔ مردار کی کھال کو جب ڈھول میں سکھا ڈالیں یا کچھ دوا وغیرہ لگا کر درست کر لیں کہ پانی مر جاوے اور رکھنے سے خراب نہ ہو تو پاک ہو جاتی ہے اس پر نماز پڑھنا درست ہے۔ اور مشک وغیرہ بنا کر اس میں پانی رکھنا بھی درست ہے۔ لیکن سور کی کھال پاک نہیں ہوتی اور سب کالیں پاک ہو جاتی ہیں مگر آدمی کی کھال سے کوئی کام لینا اور برتنا بہت گناہ ہے۔	a meat cleaver is a large, most often rectangular knife that is used for splitting or 'cleaving' meat and bone. a cleaver may be distinguished from a kitchen knife of similar shape by the fact that it has a heavy blade that is thick from the spine to quite near the edge. the edge is sharply beveled and the bevel is typically convex. the knife .
بٹوار پر مکے مار کر کے ہر ٹکڑا ہے viewfinder ہے.	Every inch of the boat is fiber-glassed.
انہوں نے کہا کہ اس سے دور بہت پیسہ بنایا.	He made quite a lot of money from it.
جلد ہی کرسمس کی ، تو کیا!	And then Christmas shortly after.
نامزد من ک نیس.	wise designated.
""" مجھے مونونخ سے محبت ہے."	I love the Monaco.
اس کا مطلب ہے لائیو گیمز بہترین معیار میں دکھایا گیا ہے کہ.	These include that games are played in the best temperatures.
تعلیمی مواقعوں کو فروغ دینے والے پیرو اور امریکہ کے دو ملکی مراکز کے ساتھ مل کر سفارت خانے نے حال ہی میں محکمہ خارجہ کا کاروبار کے لیے تیاری کرانے کا ایک ایسا آن لائن پروگرام متعارف کرایا جس میں توجہ ابھرتی ہوئی منڈیوں میں خواتین کاروباری نطامت کاروں کی مدد کرنے پر مرکوز کی جاتی ہے۔	Working with Peruvian-American Binational Centers, which promote educational opportunities, the embassy recently introduced a State Department-sponsored online business development program focused on helping women entrepreneurs in emerging markets.
یہ کورس / کلاس پہلے ہی مکمل طور پر بک ہیں	The middle class is completely extinct.
عملی - عملی طور پر ایک داڑھی کا کٹر ہے، جو دھوکہ ہے اور آپ کو وقت بچاتا ہے.	There is actually a ferry that allows you to cut across and save some time.
اس حادثے کی بنیادی وجہ جاپانی ثقافت میں موجود تابعداری اور حکام کے خلاف سوال اٹھانے میں جھجھک کا ہونا ہے۔	The biggest question for me seems to be in a disconnect between the laws and the on-the-ground culture of Japan.
آنے والی نسلوں کو مقام زہرہ کے آداب سیکھانا پوری امت مسلمہ کی ذمہ داری ہے	The entire Christian community should feel the responsibility of educating new generations.
"""زُبین ،تمہیں پتہ ہے ؟ وہ ضرور ایک چھوٹے گھر کی لڑکی ہے لیکن وہ بھی تو انسان ہی ہے اور ہم سب جیسے دوست ہیں وہ بھی ہماری دوست ہے نا""۔"	"""Know this, that he that is a friend to himself, is a friend to all men."""
The Boy Who Ran Away (لڑکے والے کو بھاگ گئے ۔)	The Boy That Got Away (Rock)
تاریخ کی تمام مستند کتابوں میں ان باتوں کا ثبوت موجود ہے.	All the books of history mention this.
"""سائنس کی پوری تاریخ بتدریج یہ سمجھی گئی ہے کہ واقعات منمانے والے انداز میں نہیں ہوتے ہیں ، بلکہ یہ کہ وہ ایک خاص بنیادی ترتیب کی عکاسی کرتے ہیں ، جس سے خدائی الہام ہوسکتا ہے یا نہیں۔ """	"""The whole history of science has been the gradual realization that events do not happen in an arbitrary manner, but they reflect a certain underlying order which may or may not be divinely inspired."""
شہر کا نام لکھیں.	Writing the name of the town.
شعبہ صحت سے وابستہ افراد کو ترقی کے حصول کے لئے انتظار کی سولی پر نہیں لٹکنا نہیں پڑے گا' مشیر صحت	Proponents of same-sex marriage will no longer have to wait for the legislative process to catch up with public opinion.
وہ مجھے عزیز ہے اور میں اُن کا مطالعہ کروں گا۔	I love it & I love them.
دادو شہر میں بارش ہويٴی۔	Rain in big city.
پسماندہ علاقوں کی ترقی کے لئے 100 ارب مختص	Rs100 billion for the development of underprivileged areas
پٹرولیم مصنوعات کی مصنوعی قلت کسی صورت قبول نہیں	Pigment dispersions are not suitable for Oil based products
کورسیرا پر کچھ مل سکتا ہے۔	Something in Korean.
میرے ہاتھوں پہ آج ظالم نے	I hold in my hand today's
ڈاکٹرمسرت امین سمجھتی ہیں کہ اس فیصلے کی ٹائمنگ بہت اہم ہے۔	According to Dr Dhawan, timing is very important.
تو دوستو ، تحریرکچھ یوں تھی۔	So, dear friends, here's the tip.
پھولوں سے۔۔۔۔۔۔ مگر یہ جلد مرجھا جاتے ہیں۔	it blooms... but soon it dies.
John 8:32 اور سَچّائی سے واقِف ہوگے اور سَچّائی تُم کو آزاد کرے گی۔ یُوحنّا 32:8	"John 8:32 famously stated, ""And ye shall know the truth, and the truth will set you free."""
میں بھی منہ زبان رکھتا ہوں	I have tongue as well.
پیدائش 3باب 2اور 3آیات:	Kinematics, in Chapters 2 and 3
لوگ ایسی پرانی گاڑیاں بھی نہیں چلاتے	Don't use old vehicles
"یکم فروری کو ، ماحولیاتی تحفظ کی وزارت نے ""ماحولیاتی لیبلنگ مصنوعات کے فرنیچر کی تکنیکی ضروریات (HJ 2547-2016) "" کو سرکاری طور پر نافذ کیا ، اور ""ماحولیاتی لیبلنگ مصنوعات کے لئے تکنیکی ضروریات کا فرنیچر"" (HJ / T 303-2006) ختم کردیا گیا ."	"1, July 1, 2007, the Ministry of Construction to develop the street design standards ""urban road lighting design standards"" (CJJ45-2006) began to implement."
پاکستان کا رقبے کے لحاظ سے سب سے بڑا صوبہ بلوچستان جسکا کل رقبہ تقریباً آدھے پاکستان کے برابر ہے حالت جنگ میں ہے۔	[Pakistan's] biggest province Baluchistan, which comprises almost half its territory, is in a state of open revolt.
جرمن اور روسی میڈیا کی رپورٹس	Germans and Russians reports
از راہ چنارو ،کہ سلامت نا کنند .	Socrates, The Way of the Peaceful Warrior.
آپ نے ۱۴سال ہارون الرشید کے قید خانہ میں گزارے.	You spent 17 years in prison under Enver Hoxha's regime.
اٹھیں لیکن اٹھیں وہ مجرمانہ	got up and pled guilty.
مفت نمونہ اثر	The Free-Form Effect
میرا خیال ہے کہ وہ ہماری طرح بے وقوف نہیں ہیں بلکہ سمجھدار لوگ ہیں جو اپنا قیمتی وقت برباد کرنا نہیں کرنا چاہتے۔	I don't think people are generally stupid enough to waste their time.
اس کے نتیجے میں ، امریکن رجسٹری برائے انٹرنیٹ نمبر (اے آر آئین) دسمبر 1997 میں قائم ہوا تھا ، نیشنل سائنس فاؤنڈیشن کی ہدایت پر ایک غیر منفعتی ، غیر منافع بخش کارپوریشن کے طور پر اور تیسری علاقائی انٹرنیٹ رجسٹری بن گیا۔ [143]	As a result, the American Registry for Internet Numbers (ARIN) was established as in December 1997, as an independent, not-for-profit corporation by direction of the National Science Foundation and became the third Regional Internet Registry.[174]
یہ ممبئی ہے	This is our Bombay.
Urdu 3: کیا انسان سمجھتا ہے کہ ہم اس کی ہڈیاں جمع نہ کریں گے	"""Does man think that he will be left neglected (without being punished or rewarded for the obligatory du-ties enjoined by his Lord Allâh on him)?"""
اگر آپ Google Analytics کو ضم کرنے کا فیصلہ کرتے ہیں، تو مزید معلومات دستیاب ہو گی.	If you would like to opt-out of data collection by Google Analytics, you can find out more information here.
Home / کاروبار / گزشتہ 24 گھنٹوں میں سونے کی قیمتوں کے حوالے سے ناقابل یقین تفصیلات آ گئیں	Notable news items/price action moves over the past twenty-four hours.
گلگت بلتستان ایپکس کمیٹی کا اجلاس، نیشنل ایکشن پلان کے تمام نکات پر مکمل عمل درآمد کو یقینی بنانے کے لیے تمام اداروں کو بلا امتیاز کاروائی کی ہدایت	The supervisory body dedicated to ensuring that SAP provisions are fully implemented by all parties throughout the Black Sea region
پلیز سبسکرائب لائک اینڈ شیر	For example, lion and tiger.
انہوں نے کہا کہ پریس کلب کو سہولتیں دینا بھی میری پالیسی ہو گی، ڈیجیٹل میڈیا کو مکمل سپورٹ دیں گے۔	He said that it will also be his policy to provide facilities to the press clubs.
شام کا مسئلہ تو تازہ ہے جب کہ فلسطین کا مسئلہ تو ٦٠ سال سے بھی پرانا ہے!!!!	Nigeria's problems are more than 50 years old!
افغانستان میں 5 پاکستانیوں کا قتل: دفتر خارجہ کا احتجاج، وزیر اعظم کا اظہار مذمت	Five protesters killed in Iraq's capital: Rights commission
غم حسینؑ ضرورت ہے ہر زمانے کی!	Flip-flops needed at all times!
اس کو کیا پہچانیے جس کا کوئی چہرا نہ ہو	But who has no knowledge of this?
ضرورت کوئی خصوصی سرور سوفٹ ویئر	Does not require any special software
ناکامیوں کی دار پہ لٹکا دیا مجھے	I installed to the default.
ان کا مزید کہنا تھا کہ چند روز قبل وزارت ماحولیات نے خصوصی آڈٹ کروانے کا فیصلہ کیا ہے۔	He said the finance ministry only obtained the information a few days ago.
جلد کو صاف رکھنا چاہیے .	It must clean up quickly.
"""اے محمد (صلی اللہ علیہ وسلم) اب بتاؤ میری تلوار سے آج تجھے کون بچا سکتا ہے ؟"""	"""Mo fella, see who will save you from me today..."""
ہم دوستوں کا انتخاب کر سکتے ہیں مگر ہمسایوں کا نہیں۔	We can choose our friends, but not our ancestors.
JS زبان کی خصوصیات: اسکرپٹ ، عملدرآمد ، آبجیکٹ پر مبنی ، سادہ ، متحرک ، کراس پلیٹ فارم کی وضاحت کریں۔	JavaScript known as JS is a lightweight, cross-platform, object oriented scripting language.
ایک سائبان موجود ہے...	There exists a secre...
The 3 OnePlus سے چوتھی اسمارٹ فون ہے - ایک چھوٹا سا چینی ابتدائیہ حریفوں کے مقابلے میں نمایاں طور پر کم پیسے کے لئے بہترین تجربہ ممکن مصنوعات فراہم کرنے کے مقصد - اور تمام سمتوں میں ایک بڑا قدم ہے گزشتہ سال کی OnePlus زائد 2.	Ang 3 is the fourth smartphone from OnePlus - a small Chinese startup aiming to provide the best experience possible product for significantly less money than rivals - and is a big step in all directions over last year's OnePlus 2.
.7 مطلوبہ نمبر داخل کریں۔	Enter the desired channel number.
نیز یہی ہاتھ ہی انھیں ہر موقع پر تحفظ فراہم کرتا تھا.	This ensures your safety at all times.
۳۔ استفہام:کسی فعل یا سرگرمی کے بارے میں استفسار کیا جاتاہے ۔	Statement of Work: A detailed statement of what activity or work is to be done.
کیا ڈو ثبوت اپنی وفا کا اس سے بڑا	This is further proof of his faith?
انٹیگریٹڈ اصل وقت آلہ مطابقت کرنے کے لئے گھڑی	Boredom is integral to the process of taking one's time
جب آپ دستیاب ہیں اور آپ کی موجودہ رکنیت کی حدود کے اندر ہی آپ صرف ریفرل کرایہ کر سکتے ہیں.	6.5 You can only rent referrals when they are available and within the limits of your current membership.
"گھر سے بھگایا ہے میں نے... ""اٹھتے ہوئے.."	"I woke up and I went ..."""""
یو ای ٹی میں طالبات جینز نہیں پہنے گی	Students in France won't be allowed to wear any garments
8: آج، گزشتہ کل، آئندہ کل، اور آئندہ کل کے بعد؟	Today and Tomorrow8.
Idiom زندہ رہنا ۔	the language alive.
"""مگر یہ قانون ہے"""	"""But it is the Law."""
آرٹسٹ ہی تو امیر ہوتا ہے۔	The art is rich.
تاریخ سے آگاہ رہو؛ہم جناب نے موسیٰ (علیہ السلام) کو نو عدد آیات عنایت کی تھیں جو اپنے آپ میں حقیقت کی جانب رہنمائی کرنے والے بےنظیر مشاہدات پر مبنی تھیں ۔ (حوالہ الاسراء۔101)	"The Honored Qur'an expresses the importance of the revelations given to Moses: ""It was We who revealed the law (to Moses): therein was guidance and light...."
ایک چھوٹا سا کاروبار کھولنے میں بہت سے پیسہ شامل نہیں ہے، لیکن اس میں کچھ سرمایہ کاری شامل ہوگی.	Opening a small company doesn't need to involve a lot of money, but it is going to involve a few investment.
上傳者: عمر نور	The Dark Ages: an age of light
اشعار بھی شامل تحریر کیے جائیں.	Text features will be added as well.
شکریہ منتظم ، میں نے ایک بہت ہی پر جوش مضمون ، مختصر ، سمجھنے میں آسان ، قاری کی ضرورت کے مطابق ، لکھا ہے	Thank you Chris, again a very well written, easy to understand, article.
ہم محفوظ لنکس کے ساتھ، آپ بالکل خطرہ نہیں اٹھا رہے ہیں.	With latex, though, you're not at risk.
گا ---- اس سے پہلے کہ یہ پشین فتنہ پوری طرح سر اٹھاۓ فوج اور	mountains through that pass, the Byzantine army was ambushed and
لہو لہو زہر گھل چکا ہے ، بتاؤ تو تمہیں کیا پتا ہے؟	Is Torcello flooded, do you know?
مذکورہ معاہدوں پر مذاکرات کا آغاز چار سال قبل سابق صدر جارج ڈبلیو بش کے دور میں ہوا تھا جبکہ امریکی کانگریس نے حال ہی میں ان کی توثیق کی تھی۔	Where were the protests during the previous eight years of former President George W. Bush's administration, when they were in control?
اگرچہ بعد کے ادوار میں آزاد کشمیر کی قیادت نے گلگت بلتستان کو دوبارہ اپنے زیر کنٹرول لانے کی کئی بار کوششیں کی، مثال کے طور پر سال 1972 میں آزاد کشمیر قانون ساز اسمبلی نے اس بابت ایک قرارداد بھی پاس کی جبکہ آزاد ریاست جموں و کشمیر کے عبوری دستور 1974 میں بھی گلگت بلتستان کو آزاد کشمیر کا حصہ قرار دیا گیا ہے۔	Although in later periods the leadership of Azad Kashmir made several attempts to bring Gilgit-Baltistan under its control again, for example in 1972 the Azad Kashmir Legislative Assembly passed a resolution in this regard while the independent state of Jammu and Kashmir Gilgit-Baltistan has also been declared a part of Azad Kashmir in the 1974 Interim Constitution.
بٹکوئنز کا کاروبار ایک ذاتی پرس سے دوسرے پر ہوتا ہے۔ پرس ایک چھوٹا سا ذاتی ڈیٹا بیس ہے جو کمپیوٹر ڈرائیو ، اسمارٹ فون ، ٹیبلٹ ، یا کلاؤڈ میں محفوظ ہوتا ہے۔	A wallet benicar fda approval is a small personal database that is stored on a computer drive, smartphone, tablet, or in the cloud.
پیر کو شامل ہوتا ہے ہفتہ وار سلسلہ بزنس۔	PCIT consists of weekly sessions.
مولانا سے انتہائی ادب کے ساتھ چند سوالات ہیں:	There are a few groups with a strong emphasis on Latino literature:
Next: شاہد آفریدی کے لیے الوداعی میچ نہیں تقریب	In no particular order: Go on an African safari
اس موقع پر مرکزی وزیر پٹرولیم اور قدرتیگیس موجود ہوں گے۔	Minister of Petroleum and Natural Gas is sitting here.
یہ ایک بے حد خوبصورت یادگار پروگرام تھا۔	It was a very memorable program.
سرفراز نہیں تو پھر کون ؟؟	Then again, who doesn't??
واہ ، یہ بہت سی مچھلی ہے۔	that's a lot of fish.
ڈاکٹر میگی Dr. McGee نے رومیوں10:17 کے بارے میں کہا،	Pastor Monte preached on Romans 10:17.
ہوا کے ساتھ چلنا چاہتا ہے	I want to walk with the wind
میں اپنے اکاونٹ میں پیسے جمع کروانا چاہتا ہوں-	I would like to deposit money into my account.
کھڑے ہو جائیں اور اِسے گائیں - دوسرا بند!	Stand up and shut up!, page 1
پیرس کے اہداف کو پورا کرنے کے اقدامات عالمی جی ڈی پی کے 1 فیصد کے ارد گرد لاگت آئے گی.	Actions to meet the Paris Agreement goals would cost around one per cent of global GDP.
١ - طالب علم، بہت سے شاگرد۔	One teacher, many students.
اور ظاہر ہے میرے ڈاکٹر کے پاس بہت شکریہ مجھے بچایا!	Now I'm fine thanks to my doctor.
۱۹۸۱: پرنسس دیانا	1981: Launch of the .
یہ کہہ کر تھانیدار نے فون بند کر دیا۔	Sonia put down the phone.
ملک معاشی طور پر بڑا کمزور ہے.	But the country was economically very weak.
اس کا بیان کرتا ہے قرآن بار بار	the Qur'an several times.
"بجلی بند: ایم ایف کے بٹن کو دبائیں اور پکڑو جب تک کہ آپ ""پاور آف"" نہ سنیں۔"	Press and hold the on/off button till you hear the drum sounds.
فارب سوچ رہا تھا کن الفاظ میں اسے تسلی دے ۔	Cobb thought how best to put it into words.
37:7 دیکھو, میں نے اس سے ایک روح بھیج دیا جائے گا, اور اس نے ایک پیغام سن لیں گے, اور وہ اپنے ملک کو واپس آ جائیں گے.	37:7 eccu, I will send a spirit to him, and he will hear a message, and he will return to his own land.
انہوں نے لکھا ہے: 'دسیوں ہزار امریکی جو یورپ کے قبرستانوں میں ابدی نیند سورہے ہیں وہ اس بات کے خاموش گواہ ہیں کہ حقیقی معنوں میں ہماری خوشحالی اور سکیورٹی ایک دوسرے کے ساتھ کس قدر مربوط ہے۔ اور جس راستے کا آپ اب انتخاب کریں گے اس کی بازگشت امریکہ کی موجودہ نسل کے مستقبل کے امکانات میں بھی سنی جائے گی۔'	"""The tens of thousands of Americans who rest in Europe's cemeteries are a silent testament to just how intertwined our prosperity and security truly are, and the path you choose now will echo in the prospects of today's generation of Americans as well."""
میکسیکن فلمیں	Mexican Film.
تو میرا دل ہے میری جان منڈیراں والے	"""Become my servants."
کینیڈا شمالی امریکا میں ہے-	Northern American Canada is in North America.
بڑی بات یہ کہ یہ کتاب پندرہ دن پہلے مارکٹ میں آئی ہے.	It has been on the market for 15 days.
کیا آپ غیر ملکی کرنسی مارکیٹ میں سنجیدگی سے سرمایہ کاری کے بارے میں سوچ رہے ہیں؟ آپ کو ہونا چاہئے.	Are you thinking about trading on the foreign exchange market?
ڈاکٹر کو مطلع کریں اگر آپ کے استعمال کے ساتھ الرج ردعمل کی کوئی تاریخ ہے	Tell your doctor if you have ever had an allergic reaction to anothe...
سلام آپم وقت کردی سر بزن.	Peace in your time, Mr. Senate President.
اس سے زیادہ نیا اور کیا؟ - ہم سب	What's more new?
شراب کے بارے میں اور نہیں بول سکتا ہے - بالکل ممکن ہے.	Can't say much about the drinkability.
اور کون تھا اسرائیل کے پیچھے ۱۹۴۸ میں؟	Who was the leader in Israel in 1948?
شیر کا سائنسی نام کیا ہے؟	What is the scientific name for the lion?
آئی سی سی ایوارڈز 2011ء کی پرشکوہ تقریب 12 ستمبر کو انگلستان کے دارالحکومت لندن میں منعقد ہوگی۔	The 2011 LG ICC Awards were held on 12 September 2011 in London in England.
میری بڑی بیٹی اس سے محبت کرے گی	My Great Granddaughter is going to love it.
شكل آئرودینامیكی دیسك	Or can i use a arduino.
ہماری کتاب میں ، موسم گرما کی طرح کچھ بھی نہیں کہتے ہیں جولائی کا چوتھا .	Nothing screams summer like The 4th of July.
عمارت کے ایک حصے کو آگ بھی لگائی گئی۔	Part of the site was also set on fire.
ایلبٹ یونان کے T-6 ہوائی جہاز کو اپ گریڈ کرنے اور چلانے کے لئے کٹس فراہم کرے گا اور اس کے ساتھ تربیت ، سیمولیٹرز اور لاجسٹک سپورٹ بھی فراہم کرے گا۔	Elbit will supply kits to upgrade and operate the Greek T-6 aircraft, as well as provide training, simulators and logistical support.
شوہر کویہ جملہ بولنے والی عورت ضرور جہنم میں جائیگی؟	Do you believe that the person who commits suicide will go to hell?
فواد چوہدری کا کہنا تھا کہ دس سالوں میں ٹرانسپورٹ کا چالیس فیصد الیکٹرک پر چلے جائیں گے، ہمیں اندازہ کرنا ہو گا کہ کون سی نوکریاں کم ہو رہی ہیں، اس ٹیکنالوجی کا شہریوں کو فائدہ ہوگا۔	Kai-Fu basically said that in ten years half of the jobs will be replaced by robots.
رنکو گيټ ټاور بلډنگ - ويکيپېډيا	the John Hancock tower and nearby buildings
امریکی حکومت کے پاس 8133 ٹن سونا ہے۔	The US Treasury still owns 8,133 tonnes of gold.
اور دانستہ۔ یہ دَر باز کیا ہے ہم نے	So you know that that's what we ended up with.
۲۰۰۱ میں ڈھیر ہونے والا کتا اب جیل میں ڈھیر ہے۔	contacts in 2005 are now in prison.
"""آپ کو خود ہی رات کے اوقات گھومنا نہیں چاہئے۔"""	"""You should not walk around at night on your own."""
14 میں خود کو خطرے میں ڈال رہا ہوں اور میں اپنی زندگی اپنے ہاتھوں میں لے رہا ہوں۔	14 Wherefore do I take my flesh in my teeth, and put my life in mine hand.
جسم سے پانی کا وزن کم کرنے کے ٹوٹکے.	roles in reducing the body's water content.
با ت یہ جاناں تمھاری ہوبھی سکتی ہے	Ah, but you know that it can be.
Kids Mag - بچوں کے میگزینز	Penguins - Children's
اپنے کام اور اپنے امور و معاملات کو اس [...]	With his past and his job and his [...]
یہ ضروری ہے حل کرنا؟	Is it essential to solve this issue?
پورے ملک میں یہی حال ہے جناب	This is happening all over the country
آسٹریلیا میں ایک حام...	A house in Australia.
میرے شاگرد سات بجے سے تھوڑا پہلے وہاں پہنچتے ہیں	The students get there at 8:00.
... لیکن زیادہ تر لوگ ، ہر قیمت پر اس نتیجہ سے بچنا چاہتے ہیں۔	Most people cannot get these at any price.
جہاں میں کام کرتا ہوں وہاں پر سال یعنی	During the years in which I worked on
فیز 3 کا مطالعہ لوگوں کی وسیع آبادی میں ویکسین کی حفاظت اور تاثیر کی جانچ کرے گا۔	Phase 3 then tests the safety and efficacy of the vaccine in a larger group of people.
گورنمنٹ سکولزسینئر سٹاف ایسوسی ایشن کے انتخابات30مارچ	April 30 Student Services office.
میرے بیٹے کو مائی لے لو یہ ایک خواب سچ ہو گا.	"""For my child, this is a dream come true."
ترجمہ:جو بھی نیک کام کرے گا، چاہے وہ مرد ہو یا عورت، اگر صاحب ایمان بھی ہو تو ان سب کو جنت میں داخل کیا جائے گا۔	"""If any do deeds of righteousness - be they male or female - and have faith, they will enter Heaven, not the least injustice will be done to them"" (4:124)."
کم سن ملتانی بچہ ایک مرتبہ پھرسے گاڑی لے کر نکل گیا، ویڈیو وائرل	A baby in the car was uninjured, again TBTG.
Prague: سفر کا انتخاب کریں	Hawai'i: prelude to a journey.
اب اپنے 28 ویں سال میں ، اے ٹی ایم 2021 اتوار ، 16 مئی سے بدھ ، 19 مئی کو دبئی ورلڈ ٹریڈ سینٹر (ڈی ڈبلیو ٹی سی) میں آگے بڑھے گا ، کیونکہ حتمی تیاریوں کا سلسلہ جاری ہے۔	Now in its 28th year, ATM 2021 will go-ahead at the Dubai World Trade Centre (DWTC) on Sunday 16 to Wednesday 19 May, as final preparations are being put in place
اس صورت میں، آپ کو دشواری سائٹ میں ایک یا دو ڈراپ منشیات کو چھوڑنے کے لئے اور اسے جذب چھوڑنا ہوگا.	In such a case, you should consider removing one or two layers off the baby and relaxing them.
کیک پخت 30 دقیقه.	Tomate at 30.
واقعی؟ 99 فیصد لوگ ناکام ہو جائیں گے؟	There's going to be 99% of people who fail.
نہیں یہ سب جھوٹ ہے...بکواس ہے	It's not a lie...Uggla is streaky.
ہے ُشکر کی جگہ کہ شکایت نہیں مجھے	Dude i'm not complaining.
نئے تجاوز کو مزید معلومات فراہم کرتا ہے جو ہم پہلے ہی جانتے ہیں.	The new synopsis adds a little more to what we already know.
"""یہ گھونگھٹ نکالو اپنے اپنے۔۔۔۔"""	Get down off your horse....
اب سٹیٹس سکوں خود کے بارے میں بات کریں.	Let's talk about regional stats.
میں نے لوگوں کو ایک منفرد آواز حاصل کیا یقین ہے.	I hope I have a unique voice.
""" یہ فلیٹ آپکو کمپنی کی طرف سے دیا جا رہا ہے """	This letter is from you to the company.
اور وہ بھی 120 پاؤنڈ مل گئے.	He also gained 50 pounds.
میرے پاس کوئی اندازہ نہیں تھا تو اس بات کا اندازہ کتنا ہی زیادہ ہے کہ میری زندگی بدل جائے گی.	I had NO idea how much my life would change.
انڈیا کبڈی ورلڈ کپ 2016ء کا میزبان ، اکٹوبر میں انعقاد	India to host Kabaddi World Cup in October 2016.
میں طویل عرصے سے موٹر سائیکل کی سواری پر انحصار کرنے ...	I've been a motorcyclist for a LONG time..
اور مجھے زندگی کا ایک بڑا ٹکڑا دیتا ہے۔	She gives me a great perspective on life.
قادیانیوں کو چاہئےکہ مرزاقادیانی نے جوخدا کا تصور پیش کیا اس کو ملاحظہ فرمالیں تاکہ کچھ سوچنے کا موقع مل سکے،	Christians have to start allowing the Word of God to be the foundation for their thinking.
جب کوئی کمپنی مسابقت کی تلاش کرتی ہے ، تو اس کا مطلب یہ ہے کہ اس میں اضافہ ہو رہا ہے کاروبار کے نئے طریقے اور مارکیٹ کی حکمت عملی جو اسے ایک مثبت اور مافوق ارتقاء بخشتی ہے ، اور اس طرح موجودہ معاشی نمونے کو اپناتی ہے۔	When a company looks for competitiveness, it means that it is considering new methods of business and market strategies that offer you a positive and transcendent, and thus evolution to adapt to the current economic model.
عالم میں نشے کے شب مہتاب نے تیرے	Immerse you in the world of the night.
"صاعقہ: "" کیا کر رہی ہو، کہاں جا رہی ہو، کون آ رہا ہے...."""	"Oates, ""Where Are You Going, Where Have You Been"""
مجھے لگا جیسے سب نے بھاگ کر اپنے اپنے گٹھڑ اٹھا لیے ہوں.	I felt like it was all getting on top of me.
یہاں سب خوف میں ہیں سانس لیتے	"""Everyone here is terrified."
وہ شاید اس کار کو پہچان گیا تھا....	"""He recognized the car."
مولا اس سال آپ کے پاس نہ آسکے	Becky didn't attend this year.
اور یہ کس مجبوری کی وجہ سے اپنی تعلیم مکمل نہ کر سکیں.	Because of this, he was unable to finish his education.
کوسانس فاؤنڈیشن ایک غیر منفعتی ، 501 (c) (3) مخیر تنظیم ہے۔ صفر کے اوور ہیڈ کے ساتھ ، 100٪ آپ کا چندہ ہیتی لوگوں کو جاتا ہے۔	AADB is a nonprofit 501 (c) (3) organization governed by a board of directors, the majority of whom are deaf-blind.
کے برعکس میں	10. on the contrary
عصآهہ بعد آن يبصر ♡	minutes later.Immediately after the
انہوں نے ہمیں اہداف پر ہمارے شاٹ لینے میں مدد؛	helped us achieve this goal.
"صرفا"" احساسشاטּ در هماטּ لحظہ است!"	"They don't understand "" just looking""!"
وہ میچ کا اہم موڑ تھا.	It was the key play of the game.
اما سندس فرحت ❤️	the applause of his
اور اب فاتحین -	and the winners...
Home / اہم خبریں / روزانہ اس فروٹ کا جوس پی لیں یہ اس قدر طاقتور ہے کہ صرف ایک ہفتے میں جگر ، معدے کاتمام گند صاف کر دیگا	Home / Decoration / This bike rack is so easy and quick to make that it is ideal for the whole family on a weekend.
انہوں نے 1952-1953 میں 10 ماہ کے عرصے تک واقع ہوا، تاہم ان مصروفیات سے پہلے اور بعد میں بھی اس کے خلاف جنگجوئی لڑائی ہوئی تھی.	They occurred over a period of 10 months in 1952-1953, though there was also vicious fighting both before and after these engagements.
الیکٹرانک ادائیگی کے سب سے مشہور سسٹموں کا استعمال کرتے ہوئے کھلاڑی اپنے اکاؤنٹ میں جمع کراسکتے ہیں:	Funding your account can be made using the most popular payment systems.
بریرہ نے اسکی آنکھوں میں دیکھا.	Cheri saw it in his eyes.
یہاں سے چلے جائو، تمہیں یہ ملک چھوڑنا ہو گا۔	You've gotta get out of this place!
کمپیوٹر پروگرام سمیت تنظیم کے اندر پیدا کی معلومات، دین ٹیکسٹائل کی ملکیت ہے، اور مناسب اتھارٹی اور تصدیق کے بغیر انکشاف نہیں کیا جانا چاہئے قانونی طور پر ضرورت ہے جب تک.	Information generated within the organization including computer programs, is the property of Din Textile, and should not be disclosed without proper authority and authentication unless legally required.
اور اس کے خاندان کو شرمندہ کرنا کتنا سہل ؟	So embarrassing for his family.
کون اس سے بہتر پہنتے تھے	who is the best dressed
حمایت کی ضرورت ہے.	We are needing support.
اسے اپنی ذندگیوں سے نکال دوں گا	I'd get him out of my life.
کہاں جائیں ہم دردِ فرقت کے مارے	We'll kill the pain
مختصراً: ہاں، ہم Google Maps کا استعمال بہتر خدمات فراہم کرنے کے مقصدسے استعمال کرتے ہیں.	In Other Words: Yes, we utilize Google Maps for the function of providing better service.
کیا ہم پر کسی کی بد دعا ہے	Are We Punished for the Wrongs of Others?
زمرہ:موبائل آپریٹنگ سسٹم	Main article: Mobile operating system
(یہ قطار سوی کس جا ہے؟)	(Who is that soembody?)
اور اگر ان دنوں کے درمیان میں کسی بھی وقت مخصوص جگہ مکمل طور خشک ہو جائے ، چاہے چند گھنٹوں کیلئے ہی کیوں نہ ہو، تو اس خشکی کو طہر شمار کیا جائے گا، چنانچہ عورت غسل کر کے نمازیں ادا کرے گی۔	And if he has time at his disposal, even to offer one Rak'at of prayers, he should offer short prayers.
میں سمجھا تھا کہ بس رسمی تعلق ہے مرا اُن سے	I thought they were just legally separated.
آڈیو سنیئے:	Listen to the audio:.
اسے 5 منٹ میں سیکھیں	Learn in five minutes.
برطانوی عوام کا فیصلہ کوئی اچانک یا غیریقینی بات نہیں ہے، اور نہ ہی یہ کوئی انہونی ہے.	for resettlement throughout the United States was not a sudden, spur-of-the-moment decision.
گندگی ڈسپوزل کو ہٹا دیں	Isolate the disobedient
'لیکن وہ لڑائیاں تو سب کی لڑتے ہیں '	"""They all struggle."
شکریہ پابلو ، اس نے عمدہ کام کیا ہے۔	Thank you, Paul did a good job.
اس نے غور کیا آواز اس کے اندر سے آ رہی تھی	He heard the sounds of the party coming from inside.
Omegle کی لڑکیاں چیٹ کریں ہمیشہ آپ کے لئے انتظار کریں گے.	Call Girls Yalding are waiting for you.
ابتدائی میری زندگی میں، میں نے ان تجربات میں سے بہت سے تبرکشیت کیا گیا تھا.	In my own experience, I have suffered many of these injuries.
میں فرانسیسی کے ساتھ ایک طویل وقت گزارا.	I have been so busy with French.
"میتھیو میں 7 یسوع کہتا ہے, ""فیصلہ نہ کرو, یا آپ بھی فیصلہ کیا جائے گا."	"In Matthew 7 Jesus says, ""Do not judge, or you too will be judged."
دنیا بھر میں اس وبا سے اب تک پچپن لاکھ سے زائد افراد صحت یاب ہوئے ہیں۔	More than 45 lakh people across the world have recovered from the infection.
کوئی نہ کوئی معنی دینے کی کوشش میں پاگل ہے	Not trying to come off mean at all.
٦ - بھلا اس نے تمہیں یتیم پا کر جگہ نہیں دی؟ (بےشک دی)	(628) Why didn't you send me to him in the first place?
◄ مصر کھیل سانچے  (3 ز)	Egypt game (3)
ہم آپ کو اس کی سفارش کرتے ہیں.	we are recommending to you.
آپ اپنی بات دوسروں کو گالی دئیے بغیر بی کر سکتے ہیں	You can give access to other people without giving them a key
شاید ابھی تمہارا وقت نہیں آیا، خواھش کے راستے پر چلنے کا.'	"""Perhaps its time for us to move on."""
میں تمہیں بتاؤں ' میرا بھی دل کرتا ہے کے میں وہ خوبصورت لباس...	I'm also going to make this adorable dress:
II۔ دوسری بات، تلاوت ہمیں بتاتی ہے کہ مسیح نے خُداوند سے دعا مانگی تھی، جو گتسمنی میں اُسے موت سے بچانے کے قابل تھا۔	5: tells us that Christ prayed unto Him that was able to save Him out of death
اس کو اہنے ایک کمرے میں لے گیا	He put her in a room.
چنیں پرستار: 'F**kin' Perfect' سے طرف کی P!nk	Lyrics to 'Fuckin' Perfect' by P!nk.
وہ دیتا ہے کسی بھی پریزنٹیشن کی طرف لاتا ہے.	He provides exposition.
محض چیزوں کی مشابہت کا نام	the names of the few constellations
کرنے ہوتے ہیں۔ سیکیورٹی کے لئے آپ کو دستی سامان سمیت سکینر سے گزرنا	You will be required to go through a security screening with bags going through a scanner.
وہ جُنوں ، چھین لیا، حِرص و ہوس نے تجھ سے	The one who conceived and bore you
میں نے دروازے کو دھکیلا تو وہ کھلتا چلا گیا .	When I broke down the door, he disappeared.
ایک کو مل گیا اور اس کی طرح بہت زیادہ.	We got that and so a lot more.
یہ ایک حقیقی یونین ہے.	It is a real association.
یہ ہمارے مشن ہے، ہم کبھی نہیں روکیں گے.	And that's a tradition we'll never stop.
لندن فیشن ویک اپنی رعنائیوں کے ساتھ جاری	London's biggest fashion shows, with their
دادا کا اوڑھنا بچھونا کتابیں تھیں۔	"""My grandfather used to breed birds."
ہاں بھئی جیسے وہ تم لوگوں پے نظر رکھتی ہے لگتا تو ایسا ہی ہے..	Yes, it looks just like you think it looks.
ارے واہ آپ کے پاس تو کافی لمبی لسٹ موجود ہے۔	Yeah, you have quite a long list there.
چروکی (Cherokee) ایک مقامی امریکی قوم ہے جو تاریخی طور پر جنوب مشرقی امریکا میں آباد رہے ہیں (بنیادی طور پر جارجیا، شمالی کیرولائنا، جنوبی کیرولائنا اور مشرقی ٹینیسی) ۔	Cherokee are a Native American people historically settled in the Southeastern United States (principally Georgia, the Carolinas and Eastern Tennessee).
اردو: فاطمہ کی ہماری خاتون	HWP: Litany of Our Lady of Fatima
بی بی سی کو اس حوالے سے نئے ثبوت دستیاب ہوئے ہیں کہ متحدہ عرب امارات کے ایک ڈرون نے جنوری 2020 میں لیبیا کے دارالحکومت طرابلس کی ایک ملٹری اکیڈمی میں 26 غیر مسلح کیڈٹس کو ہلاک کر دیا تھا۔	Libya: A drone operated by the United Arab Emirates was reportedly responsible for the deaths of 26 unarmed cadets at a military academy in the capital Tripoli in January of this year.
جو کچھ سمجھ چکے ہیں وہ لکھیے 🙂 😉	understand what I've written;)
یہ میچ دونوں ٹیموں کے لیے انتہائی اہمیت کا حامل ہے - فوٹو: اے ایف پی	This game is fundamental for both teams: Man.
آپ کی قیمتی ٹپس کے ساتھ آپ کی کمی بھی محسوس ہو رہی ہے	I will miss you kind heart.
(مالی معاملات سے متعلق جدید مسائل کے شرعی احکام)	(Ancient answers for modern issues).
Tag: ایک کتاب کی آپ بیتی	b: a chapter of a book
میں شمال سے ہوں۔	I'm from North.
ہم دونوں نے بہت کوشش کی.	We have both been trying hard.
واقعی آپ نے تو حد ہی کر دی ۔	You have really gone over the edge.
تحریری اسلوب لازما کسی ہندوستانی لہجے والا ادبی یا نیم ادبی ہوجاتا ہے.	Literary fiction tends to be a small, indie-press thing.
پہلے زیادہ سے سال ایک by alvinoh	A year earlier, Alvin's personnel
ملکی تاریخ میں پہلی بار سعودی ولی عہد کی پاکستان آمد ۔۔۔کب آرہے ہیں ؟اعلان ہو گیا - Pak Online News	In Saudi Arabia for the first time in the history of the executed Prince _ News from Ukraine
کسی کے چلے جانے سے زندگی رک نہیں جاتی ہاں سست ضرور ہوجاتی ہے .	Life doesn't stop for people that go slow.
ہے اور حکومت سے اپیل کی ہے کہ ویکسین لگانے کا سلسلہ بھی تیز کیا جائے۔	That is why I asked the state to expedite the utilisation of vaccines.
کو تیار نہیں۔ جب ہم	When you're not ready
اس موقع پرحفاظتی انتظامات اولمپک کھيلوں سے بھی زيادہ ہيں	This multi-sport Games is larger than the Olympics.
اللہ معاف ہی رکھے ایسی سیٹوں اور نوکریوں سے۔: (کالم ضرور شیئر کیجئے گا اور زرداری کے بچوں والا کیا معاملہ ہے؟	These were the divisions of the doorkeepers; of the sons of the Korahites, and of the sons of Merari.
ہم بی-لائن موٹر سائیکل پارک میں تھے، جن میں سے ایک کیلگری کے تفریحی سہولیات میں سے ایک ہے.	The V Drive-In Theatre, on the Vestal Parkway, was one of several drive-in facilities.
مسقبل میں دن 24 گھنٹے کا نہیں بلکہ 25 گھنٹے کا ہو گا،	The day will have 10 hours, not 24.
لائمہ ۔ ملامت کرنے والی ۔	Lye, Oatmeal.
"""کیوں ؟""میرے مونہوں نکلیا۔"	"""Why?,"" I wrinkled my nose."
لندن: ماہرینِ غذائیت کا خیال ہے کہ بعض غذائیں ...	Randomblings from Rich: There are certain foods....
تصنيف اڷـآنميے: درآمآ ، مغآمرآت ، خيآڷ عڷميے	Lama Sönam: Yes, jealousy, and pride, and sadness.
سوال یہ ہے کہ جو ہمیں تقسیم کیا یہ درست ہونے کا ایک موقع ہے کے لئے کافی پاگل ہے.	The question, which divides us, is whether it is crazy enough to have a chance of being correct.
Mark Rutte (آزادی اور جمہوریت کے لیے پیپلز پارٹی)	VVD (People Party for Freedom and Democracy).
100 سے زیادہ زبانوں میں	In more than 100 languages.
سوال نمبر1۔ بعض اوقات میَں حیران ہوتا ہوں کہ کیا خُدا مُجھ سے محبت رکھتا ہے۔ اگر وہ محبت کرنے والا خُدا ہے، پھر کیوں دُنیا میں اِتنا غم اور تکلیفیں ہیں؟	Why, if God loves, is there so much pain and suffering in the world?
کسی آئی فون کی تصویر پر تاریخ اور وقت مقرر کرنا	To set the date and time on an iPhone photo
واقعی زندگی میں اہم ترین اسکے سوا کچھ بھی نہیں لگتا...	It's by far not the most important thing in life.
ضرورت یا پاگل پن؟ ....	Brave or Crazy...
ٹھیک کچھ سیکنڈ بعد نایاب نے اسے پکارا تھا	A few days later, Nadia phoned.
ZIP کے لیے ہدایات۔	Directions to HPD.
1968 کے جمہوری کنونشن میں کیا ہوا؟	What happened at the 1968 Democratic Convention in Chicago?
11:4 لیکن اس کے پاس الہی ردعمل کیا ہے?	Romans 11:4 But what is the divine response to him?
میں اس کے لئے ہٹانا چاہتا ہوں کیونکہ وہ ایک فنکار ہے.	I blame it on being an artist.
کہ سیاست میں کوئی کسی کا مستقل دوست یا دشمن نہیں ہوتا.	It is popularly said that there is no permanent enemy or permanent friend in politics.
ہم اندھیروں سے نکل کر روشنی کی طرف سفر کرنا ہی نہیں چاہتے.	We move from darkness into the LIGHT.
Matt 500 کے تحت بہترین توشک	best dishwashing machine under 500.
تم نے میرٹ کی بنیاد پر اس طرح گندگی فیصلہ نہیں کرتے.	Don't waste Mads in shit like this.
زرائع کے مطابق دفتر میں اوقات کار سے زائد وقت دینے پر ملازمین کو اوور ٹائم دینے کی تجویز بھی زیر غور ہے۔	Contract workers are encouraged to spend more time at the office.
لیکن ایسا ہو ا تھا۔۔۔ یہی ایک منٹ ، دنیا بدل دیتا ہے۔	But it will come, one day, and change the world!
یونین علاقہ (5)	Commission of the European Union (5)
میرے دل کے نیچے سے ایک بار پھر آپ کا شکریہ.	Thank you again from the bottom for my heart.
"""دیکھا کہ یہ پتھر بھاری ہے"""	"""The stone is heavy,"""
میں ایک مکمل اسٹیک سافٹ ویئر ڈویلپر ہوں۔	I'm a full-stack software developer
برطانیہ کی دو بڑی پارٹیاں ہیں.	The USA has two major parties.
* اشعار میں مختلف جگہوں پراضافت کا استعمال ہوا ہے، ایسے الفاظ تلاش کر کے لکھے ۔	*Affiliate links are used in this post to help you find items that are mentioned.
ریسٹورنٹ اور مالز میں بچوں کو بھیجنا زیادہ ضروری ہے یا اسکول میں ؟	Is it more important for children to play or to study?
یہاں پر کچھ آسان طریقہ ہے جو تم اور یا تمہارے دوست تبدیلی لانے کے لیئے کر سکتے ہیں۔	Here are a few simple options that you and your friends can try.
سری لنکا نے جزیرے کے اقلیتی مسلمانوں کے لئے فتح کا جشن مناتے ہوئے زبردستی قبرستان ختم کرنے کا اعلان کیا۔	In the aftermaths, Sri Lanka announces an end to the forced cremations, marking a win for the island nation's minority Muslims.
آ ہم آ ہم کیا تم واقعی سیر یس ہو ؟	come on.... are u for real?
سيبل (ڈس ایمبی گو ایشن) - ایک ممالیہ جانور ہے	Pig (disambiguation) - A pig is an animal.
● 10 سال محدود وارنٹی	A limited warranty of 10 years
یہاں تھا وہ باغ	he was in the garden
سیکھ نہیں پا رہا ہوں میٹھے جھوٹ بولنے کا ہنر	I'm learning how not to feed the lies.
ہر فاصلہ اور وقت کیا آپ نے تسخیر- تھی دیدنی بندے کی بڑائی شبِ معراج	time and all the ages by its distance from the present?
اور تم، کیا آپ پہلے ہی انسٹاگرام پر بیچنا جانتے ہیں؟	Are you already in a position to sell?
جرمن موٹر ویز پر رفتار کی حد مقرر نہیں کی جا رہی	There are no speed limits on the German Autobahns.
انڈیا میں بہت کم ہی سزائے موت پر عمل درآمد ہوتا ہے۔ گذشتہ دہائی میں ایسا صرف تین بار ہی ہوا ہے۔	In India, executions are rarely carried out here, with just three recorded in the last decade.
(C) براہ مہربانی کل ضرور آئیں	B. Please come tomorrow.
چھوٹے کاروباری قرضے کیسے استعمال کیے جاسکتے ہیں؟	How they can be used in small business loans?
کیونکہ HGH انسانی جسم میں قدرتی طور پر پیدا کیا جاتا ہے کیونکہ، HGH کے ضمنی اثرات نایاب ہیں.	Despite the fact that the human body can naturally produce hgh.
اگر پورے اجزاء کا ذریعہ پہلی اجزاء کے طور پر درج نہیں کیا جاتا ہے، تو شاید یہ شاید بہت کم ہے.	If the source of whole grain is not listed as the first ingredient, then it probably contains very little.
'یہ بھی تو ہوسکتا ہے کہ وہ محض گھومنے آیا ہو - '	"""Perhaps he has merely run away."""
"اسٹیٹ ڈپارٹمنٹ کے ترجمان نے ایک بیان میں کہا ہے کہ ""امریکہ افغان حکومت کی مشاورت سے امن عمل کو آگے بڑھانے کے لیے تمام ممکنہ راہیں تلاش کر رہا ہے۔"""	"""The United States is exploring all avenues to advance a peace process in close consultation with the Afghan government,"" a State Department official had said."
وزیر اعظم کا کہنا تھا کہ یہ رقم آپ کی ہی رہے گی۔	I'd say the money is yours.
(م) مصروفِ تبسم جو کہیں ہو گا اُسی کو	(e) the period during which the course is to be
کیلیفورنیا سے 2 لاکھ افراد کا تخلیہ	million people of California.
"آپ کو ""کھیل"" بٹن دباؤ سے روکنے یا شروع کر سکتے ہیں."	You can start or stop it using the middle button.
عاجز یہ کسی اور کا چہرا ہے کہ تم ہو؟	You've bruised someone else's face?
دل (قلب) ایک چیز ہے۔	Something is a heart.
"پاکستان اس کے مطابق جواب دینے کا حق محفوظ رکھتا ہے اور خود کو دفاع کرنے کا حق برقرار رکھتا ہے."""	"Pakistan holds the right to self-defence and proper response."""
زینب الرٹ بل:حکومت کے لیے ...	Scarborough Fair: For the love of pink....
کی حالت بد سے بدتر ہوتی جارہی ہے،اس وقت جھیل کے راستے میں گھنے درختوں کا ایک جھنڈ آتا تھا،اب وہ	there was a terribly natural phenomenon that changed the river to a lake, which is now
Q کیا ہر تعلق برقرار رکھنے کے ل you آپ کی خدمت کرسکتا ہے؟ A	Q. Are you in the employ of any association ?-A.
اقوام متحدہ نے فضائی حملوں کے خلاف ورزی کی وفاقی قانون کا اعلان کیا ہے جس کے نتیجے میں فضائی حملوں کے پہلے مہینے میں کئی سو شہری ہلاک ہوئے ہیں.	The United Nations declared the airstrikes a violation federal legislation right after a number of hundred civilians had been killed in the initial month in the airstrikes .
Naomily! spongebob5 0 732 پہلے زیادہ سے سال ایک	knife from 0.5 mm plywood. the first year.
ابھی کچھ دیر پہلے۔:ڈی	It was a long time ago:D
میں تو سعودی عرب میں ہوں، میرے لیے بجھوانا کچھ مشکل ہے	I am here at Saudi Arabia and it's very difficult to talk to the
ترقی و پیشرفت کی طرف اشارہ کرتے ہوئے کہا کہ...	It would focus on the development,...
خیال رہے کہ ٹوکیو اولمپکس کے انعقاد کو تقریباً دو ہفتے رہ گئے ہیں لیکن کورونا وائرس کا پھیلاؤ روکنے کیلئے انتظامیہ کی جانب سے پورے شہر میں ایمرجنسی نافذ کر دی گئی ہے۔	It is believed that the Tokyo Olympics are almost two weeks away, but the administration has declared a state of emergency across the city to prevent the spread of the corona virus.
"سب سے پہلے تمہیں ثنا اختر سے ثنا پروین بننا ہو گا۔"""	"""You need to give up on Sakurai."""
تمہیں اپنا بیٹا کہتے ہوئے ....	He tells his son ...
آپ کی کار بہت خوبصورت ہے۔	Her car is very nice.
اگرچہ اب اس کی تائید نہیں ہوئی ہےڈاؤن لوڈ کرسکتے ہیںاور انسٹال کریںانٹرنیٹ ایکسپلورر 11.	This feature is currently unavailable on Internet Explorer 11.
4 نویں جرمن	4th, Germany
ٹینس کھلاڑی	tennis player
یہ صرف ایک خوبصورت زندگی کا آغاز ہے!	This is just the beginning of a wonderful life.
مطالبہ نمبر۶ کے متعلق کمیشن بیٹھ چکا ہے اور اس کے لئے ہم ریاست کے ممنون ہیں-	The application was judged at the state level and we were ranked 6th in the state.
"""یہ کردار خود کو ایک ہی موقع پر بھی ڈھونڈتا ہے."	And it is the player at precisely the same moment.
"< start=""4197.092"" dur=""2.903""> وائس پریذیڈنٹ پینس: میں چلوں گا >"	SCP-173: I'm going to
← جرم جتنا ہے بس اُتنی ہی سزا دیں مجھ کو وہ اگر ٹُوٹ کے بِکھرا ہو گا →	I'm thinking it's basically the same penalty for me if he gets pulled over?
"""یہ چھوڑو۔ مام میرا مطلب ہے مسز ہاجرہ کو کہہ دینا کہ میں آج باہر ہی لنچ کروں گا""۔"	"""I have to say I respect Roger for coming out tonight."""
تنظیم ایسے تمام ہتھکنڈوں کو رد کرتی ہے.	This Agreement prohibits all hacking.
'جی میں نے چوری نہیں کیا.'	'I didn't steal it.'
قتل نہ کرو بس	Don't rule out the bus
اس مثال میں ہم KCS (Kucoin سکین) کے لئے اپنے Bitcoin تجارت کرنا چاہتے ہیں.	In this case we will be trading for Bitcoin (BTC).
نہیں ،میں طلاق دلانے والا وکیل بن جاتا ہوں ۔	I am a marriage advocate.
صدر سعودی عرب میں ہیں جہاں وہ صحتیاب ہو رہے ہیں۔ اُنھیں جون میں اپنےصدارتی محل کے احاطے پر ہونے والے حملے میں زخم آئے تھے۔	The president remains in Saudi Arabia where he is recovering from injuries sustained in a June attack on his presidential compound.
اوہ اچھا میں شروع سے بتانا شروع کرتا ہوں.	But Let me tell you from the start.
مزید پڑھیں۔ ہمارے مسائل کی بنیادی وجہ کرپشن ہے ، چیئرمین نیب	As we explain further below, the root of the problem is the prosecutor's
ٹرین میں میری ڈک چھوئیں	I left my coat on the train
اوپر سے کوئی چیز پھینکنا	By draw something on top of it.
لہذا یہ انسانوں یا پالتو جانوروں پر استعمال کرنا محفوظ ہے۔	It is safe to use on humans and pets.
لورین فرانس دے 27 تھانواں چوں اک اے۔	Harry Potter has twenty-seven of twenty-nine.
فون کرنے والے شخص نے کہا کہ کراچی اسٹاک ایکسچینج میں ہوا دہشت گردانہ حملہ پوری دنیا نے دیکھا ہے۔ اب ہندستان کے تاج ہوٹل میں 26/11 جیسا حملہ ایک بار پھر ہو گا۔	"The caller said that ""everyone saw the terrorist attack on the Karachi Stock Exchange, now the 26/11 attack in the Taj Hotel will happen once again."""
یہاں نہیں تو وہاں!!	In other words, there's no there there!
Previous: کوشش کروں گا جب تک فٹ ہوں کھیلتا رہوں	May be, I'll try my hand at playing football.
یہ تقریبا ایک سال پہلے تھا، 17 جنوری، 2005 کو، ہنس مر گیا!	Richard died almost a year ago on March 15, 2010.
اس لیے بس سوچ کر بھی خوشی ہوتی ہے..	It makes me happy to think of it.
"""ارے بس کرو، کیا دروازہ توڑ دو گے۔"" ممی جی نے چیخ کر کہا۔"	"""What d'you mean, shut up,"" screamed his mother."
روایتی ای میل کے لئے حمایت بھی بچاؤ کے مسائل اور مسائل کے لئے استعمال کیا جا سکتا.	support for traditional e-mail can also be used to rescue issues and problems.
"""الله"" کی قربت کا ""بہترین"" راستہ ""عاجزی"" ھے."	"""Flying is the closest thing to God,"" she beams."
جاگو اس سے پہلے کہ دیر ہوجائے۔	Wake up before it's late.
گڈ!کبھی کبھی بے اختیار منہ سے سچ نکل جاتاہے،۔	But sometimes, the scenario is devoid of honesty.
انہوں نے مختلف موضوعات پر 12 سے زائد کتب تحریر کیں	He has written more than 12 books on different subjects.
واقعہ کی دعوتیں	the invitation of the event
سنٹروک اپنی نشست کھونے سے کہیں زیادہ خراب ہے.	The pillow covers are even worse than the seat covers.
برہان وانی کا خون ضائع نہیں جائے گا۔	The neocon bloodlust will not be denied.
اس سے کوسوں دور ہے، مقصد کی تکمیل	Far from the intended target.
"""ان کی عمر کتنی ہے، آنٹی؟"""	"How old are you, Matthew?"""
اس مسئلے پر سنہ 2014 میں ہونے والے ریفرنڈم میں اس ملک نے چار ممالک برطانیہ کا حصہ بننے کا انتخاب کیا تھا۔	The country chose to remain part of the four-nation United Kingdom in a 2014 referendum on the issue.
I۔ پہلی بات، اُس شخص کو کوڑھ تھا۔	A. At first, he was stoical.
جی استاد ہے نا، ایک اور سوال بھی ہے۔ وہ کیا۔؟	Oh Professor, one more thing.
سپین ، نری کب.	Noia, Spain.
ایکگو کے لشکر ایکگو کے لشکر کے لئے آرمی آف ایکسگو ایک حقیقی وقتی حکمت عملی والا ویڈیو گیم ہے۔	Armies of Exigo is a real-time strategy video game for Microsoft Windows.
معاہدہ بخارسٹ کے ایک طرف سے رومانیہ اور دوسری طرف سے مرکزی طاقتوں کے درمیان امن معاہدہ کیا گیا تھا ایک تعطل کے بعد 1917 رومانیہ کے لئے پہلی عالمی جنگ سے روس کی یکطرفہ طور پر علیحدگی کے بعد الگ تھلگ چھوڑ دیا تھا فوسٹانی اور معاہدہ بریسٹ لیتھوسک کرنے کے لئے).	The Treaty of Bucharest was a peace treaty between Romania on one side and the Central Powers on the other, following the stalemate reached after the campaign of 1916-17 and Romania's isolation after Russia's unilateral exit from World War I (see Treaty of Brest-Litovsk).
انہیں امریکی فیض کو دیا گیا تھا.	he was given the U.S.
مشکلات کے باوجود انہوں نے ابتدائی تعلیم وہیں سے حاصل کی۔	He received his early education in.
پتا نہیں کون تھی وہ لڑکی لیکن کافی آزاد خیال تھی	I have no idea who this little girl was, but she was completely engaging.
آپ کی دلچسپیوں میں کودو اور یو پر اپنے جذبات T. کی ہم سے زیادہ گریٹر ٹورنٹو ایریا میں تین کیمپس بھر میں 700 انڈر گریجویٹ اور 200 گریجویٹ پروگرامز پیش کی ترقی.	Undergraduate FAQ Department of History Dive into your interests and develop your passions at U of T. We offer over 700 undergraduate and 200 graduate programs across three campuses in the Greater Toronto Area.
تلاش انجن محبت سے محبت کرتا ہوں.	Love the search engine.
بسنت پنچمی کی آپ سبھی کو، پورے ملک کو بہت بہت نیک خواہشات!!	I wish all of you a Happy Basant Panchami.
میں بہت حیران تھی کہ کوئی اپنی ماں کی بہن کو گندی عورت کی اولاد کیوں کہے گا؟۔	Others are wondering why a mother would kill her young daughter.
اپنی سیاسی دوکان چمکانے کے لیے چیختے ہی رہتے ہیں لہذا ان	that are trying to put their economic houses in order for
صارفین کی جانب سے واٹس ایپ انتظامیہ کو شکایت موصول ہوئی تھی کہ نوٹیفکیشن کا یہ نیا رنگ صحیح طور پر نظر نہیں آرہا جس کے باعث انہیں مشکلات کا سامنا ہے۔	Some of my accent reduction clients have complained that the new voice recognition technology doesn't understand their heavy accent.
رہنا اس انجمن میں بہم اتفاق سے	Stay here in this fully furnished.
دیوار پردیس says:	Surfers paradise says:
جب ہم ہار جاتے ہیں تو دماغ میں کیا ہوتا ہے؟	What happens in the brain when we lose someone?
مائیکرو سافٹ کے مطابق:	In accordance with Software:
نام 100% برانڈ نیا	100% of brand new
مجھے پسند نہیں کرتے جو لوگوں کے جھوٹ یا دھوکہ.	I don't like liar or fake people.
نوکرانی کمرے کا دروازہ بند کرکے چلی جاتی ہے.	the door of work is closed.
1۔ ایک ویکسین کب تک امریکا اور کینیڈا کے عام افراد کے لیے دستیاب ہوسکے گی؟تحریر جاری ہے	When do you think an approved vaccine will be available for general public use in Canada/the United States?
جی پی پی کے ذریعے حقیقی وقت کی ٹرینیں	Real-time processing with FPGAs
میر بالاچ مری پہاڑوں پر چلے گئے تھے اور چی گویرا کی مانند پہاڑوں میں گوریلوں سے جاملے تھے	And they were floating in the ocean like the mountains.
ایک تحقیق میں بتایا گیا ہے کہ کھانے سے آدھا گھنٹہ قبل آدھا لیٹر (17 اونس) پانی پینے سے ڈائیٹرز کو کم کیلوری کھانے میں مدد ملتی ہے اور ان لوگوں کے مقابلے میں جو 44.	Some studies showed that drinking a half liter (17 oz) of water about a half an hour before meals helped dieters eat fewer calories and lose 44% more weight (3).
'اس نے تو ابھی مسکرنا ہی سیکھا تھا' _ جی نیوز	"""He's got that you've insulted me smile."" ~ J"
انہوں نے کہا ، وہ اسے والد نہیں کہتے ہیں۔	They Would Not Call Him Father.
فلاسیسیڈ ، پییکن ، اور مچھلی _ اومیگا 3s	Beef, poultry, and fish (3 oz)
"وہ ہٹ دھرمی سے بولی۔""مجھے تمھاری بکواس نہیں سننا۔"""	"She says, quietly, ""I won't make them mad."
"ان کا کہنا تھا کہ ""سوال یہ ہے کہ جس شام کو ہم جانتے تھے، اُس دوبارہ بننے میں کتنی اور جانیں ضائع ہوں گی، اور کتنی تباہی ہوگی۔"""	"He said: ""We knew it would be a difficult night, we knew they could get the away goal, but credit to the lads."
ہلاک ہونے والوں میں سے اکثریت طالب علموں کی تھی جو خرکیو نیشنل ایئر فورس یونیورسٹی میں زیر تعلیم تھے۔	Most of the dead were students at the Kharkiv national air force University.
برند:ایپی اور - EPEVER	Baby & Co. - epaper
سرور بعض اوقات مجھے مرکزی صفحہ پر کیوں بھیجتے ہیں؟	Oh god, why do they let me on the internets?
جس کا مطلب بولوں: میں شرمندہ نہ ہوں گا	Which means, I'm not shy.
جواب: پاکستان۔	The answer is: Pakistan.
اور دردناک مسئلے پیدا ہوجائنگے۔	there will be some hardship.
"اعلانیہ ایٹمی قوت بن چکا ہے"" ۔"	"A nuclear explosion has occurred."""
آرام کرنے کے لئے ایک موسم بہار میں دورے کے دوران، آپ کو بہت تھکے ہوۓ ہو جائے گا ۔	When riding for a long time, you will be tired.
مجھے ڈاکٹر کی بات یاد آگيٴ ایک سے تین مہینے ہیں	I have seen a doctor for three months.
"""  اور يہ جان لو کہ تمھيں جس چيز سے بھي فائدہ حاصل ھو اس کا پانچواں حصہ اللہ ،رسول ،رسول کے قرابتدار ، ايتام ،مساکين اور مسافران غربت زدہ کے لئے ھے اگر تمھارا ايمان اللہ پر ھے اور اس نصرت پر ھے جو ھم نے اپنے بندے پر حق و باطل کے فيصلہ کے دن جب دو جماعتيں آپس ميں ٹکرا رھي تھيں نازل کي تھي ، اور اللہ ھي ھر شئي پر قادر ھے "" -"	008:041 Shakir And know that whatever thing you gain, a fifth of it is for Allah and for the Messenger and for the near of kin and the orphans and the needy and the wayfarer, if you believe in Allah and in that which We revealed to Our servant, on the day of distinction, the day on which the two parties met; and Allah has power over all things.
گھروں میں سے کچھ 19th صدی میں تعمیر کر رہے ہیں.	Several were built in the 19th century.
""" مجھے بہت ڈر لگ رہا ہے ، پلیز !"	"I'm scared, please!"""
1980 کے دہائی تک، سپرسسر ڈیزائن نے مارکیٹ کی جگہ داخل کرنے کا آغاز کیا.	In the 80s the brand started introducing itself in the ski market.
وہ رقص کرتی موسموں کی شوخیاں نہیں رہیں .	She doesn't mess around with the dancing.
LUIS C کو جواب دیں	Replying to Paul C.
"'کیونکہ یہ وہ شخص نہیں تھا جو وہ میرے ل wanted چاہتی تھی... اور میں اس پر الزام نہیں عائد کرتا... میں نے کہا ،' ماں ، میں واقعتا him اس سے محبت کرتا ہوں۔ اس کے اندر تکلیف ہے ، "" سیلائن نے 'پروجیکٹ' پر وضاحت کی۔"	"""Because it was not the person that she wanted for me... And I don't blame her... I said, 'Mum, I really love him."
یہ وہ لڑکی ہے جس سے میں کل ملا تھا۔	She's the girl I met last night.
پوری قوم آپ کے ساتھ ہے .اگر آپ سچے ہو تو الله آپ کی مدد کرے گا .	God is with you and will be with you.
12 اور حوُرام نے یہ بھی کہا خُداوند اسرائیل کا خُدا جس نے زمین اور آسمان کو پیدا کیا مُبارک ہو کہ اُس نے داؤد بادشاہ کو ایک دانا بیٹا فہم و معرفت سے معمور بخشا تاکہ وہ خُداوند کے لیئے ایک گھر اور اپنی سلطنت کے لیئے ایک گھر بنائے۔	Huram said moreover, Blessed be the LORD God of Israel, that made heaven and earth, who has given to David the king a wise son, endued with prudence and understanding, that might build a house for the LORD, and a house for his kingdom.
ہار & بالیاں & چوڈی (1)	Fluffy & Cuddly (1)
انہوں نے مہینے کے مہینے سڑک پر کام کرنے کی کوشش کی.	They had been on the road a month.
وہ جان گئی تھی ہمیں درد میں مسکرانے کی عادت ھے	She was used to acknowledging pain.
مختصر میں، جی ڈی پی آر آپ کی تنظیم پر لاگو ہوتا ہے کہ آیا آپ یورپی یونین میں موجود ہیں یا نہیں.	The GDPR applies whether your organisation is located in the EU or not.
32:3 دیکھنے والوں کی آنکھیں غیر واضح نہیں کیا جائے گا, اور سن ان لوگوں کا جو کانوں قریب سے سن گے.	32:3 And the eyes of those who see will not be shut, and those who have hearing will give ear to the word.
چـــشـمک عشق - جک..	So deal with the facts, Jack.....
پاکستان میں کی جانے والی دہشت گردی میں بھارت سر فہرست ملوث ہے.	India is a major source of terrorism in Pakistan.
ایسا کیوں ھو رھا کہ نوجوان بھی ڈپریشن کا شکار ھو رھے ھیں ۔۔۔	Which is why the teens suffer from depression.
'کیا مطلب، تم ملے ہو اس سے؟'	What you mean you got it?
NGINX کے بارے میں مزید	More about Quincunx.
وقت 1 ماہ کے اندر فروخت ہو گیا	It was sold in 1 month.
ہم غیر معمولی اوقات میں رہ رہے ہیں۔ بہت سے لوگوں کی طرح ، میں ذاتی اور...	we are very different.. we have different circumstances, we all often live in different places, both physically and spiritually...
آپ نے اس کی مطلق پروا نھیں کی کہ آپ کی بیوی ایک شھنشاہ وقت کی بیٹی ھیں .	He did not at all care for the fact that his wife was the daughter of the emperor of his time.
ماہرین کا کہنا ہے کہ مختلف تجربات نے یہ ثابت کیا ہے کہ کھانے کے فوراً بعد ایک سگریٹ پینا 10 سگریٹ پینے کے برابر ہوتا ہے- اور اس طرح کینسر جیسے مہلک مرض کے لاحق ہونے کا خطرہ بھی بڑھ جاتا ہے-	But it is said that smoking a cigarette right after your meal is equivalent to smoking 10 cigarettes, thus increasing the risk of cancer.
یہ گیند، میں تم کو دینے آیا ہوں، امی!	"""I'm about to give it to you, Pamie!"
GABRIELA جنرل اسمبلی لازم خواتین اصلاحات، دیانت داری، مساوات، قیادت اور عمل کے لئے	GABRIELA, formed in 1984, is the General Assembly Binding Women for Reforms, Integrity, Equality, Leadership and Action.
آن لائن فروخت: آپ کے امکان کے خریدنے والے محرکات کا پتہ لگانا	Capitalizing on the internet to capture the attention of potential buyers
ایک مقام پر تفصیل سے زبان کی اہمیت پر گفتگو فرمائی:	Look for detailed meaning in the language:
کار کے آخری الفاظ ٹامس	Thomas's new car
برائے مہربانی دوبارہ تعمیر کرنے کے لئے رقم بڑھانے میں مدد کریں.	Please help raise funds.
عظیم طاقتیں اور پہلی جنگ عظیم: 1870-1918[ترمیم]	Great powers and the First World War: 1870-1918 10
ایسے لوگوں کی دانش سے بچ کے رہیے.	Stand out from those people.
اولاً: حواس خمسہ ظاہری صرف طبیعی دُنیا (physical world) کی اشیاء کا اِدراک کر سکتے ہیں، جس میں مادّہ اور توانائی دونوں شامل ہیں۔	Physicalism, the idea that only physical entities comprised of matter and energy exist.
وہ تھک چکا تھا اور حد سے زیادہ تھک چکا تھا۔۔۔اور اب وہ تھک کر گر رہا تھا۔۔۔۔۔۔۔۔	He was too tired, and now he is sick.
""" ثم یتوب اللہ من بعد ذلک علی من یشاء واللہ غور رحیم: پھر اس کے بعد اللہ جس کی چاہے توبہ قبول فرما لیتا ہے، اور اللہ بہت بخشنے والا، بےحد رحم فرمانے والا ہے "" (التوبہ:27) (جامع البیان جز 9، ص 267 ۔ 268، مطبوعہ دار الفکر بیروت، 1415 ھ)"	9:27 then God thereafter turns towards whom He will; God is All-forgiving, All-compassionate.
اس سمت میں سمجھا اور آگے بڑھ رہا ہے.	mind develops and unfolds in this direction.
اگر اتفاق سے آپ کا جواب ہاں میں ہو تو یہ بتائیں کہ کیا امریکہ حملہ آور کافر ہے یا نہیں	Below that, select Yes or No to indicate whether or not you are a US citizen.
یہ کائنات آپ کی منتظر ہے!!!!	The studio is waiting for you!!
سمجھتے ہو مجھے تم۔ آہ !	Ahhh you understand me!
بہت عمدہ لڑی اور پیغام۔	A beautiful poem and message.
Ha Ha Love آپ Too:) Xx پہلے زیادہ سے سال ایک	love yourself (6 months ago)
ہمارے ساتھ رہو، ایک ساتھ مل کر ہم ایک بڑامعاہدے بنا سکتے ہیں!	Join us, together we can make a change.
ہم اس میدان میں ایک اہم فراہم کنندہ بننے کے لئے جاری رکھیں.	Become a leading provider in this market.
ہائی سپیڈ ڈیٹا منتقل کرنے کی ضمانت دی اور زیادہ سے زیادہ کی منتقلی کی شرح کے لئے USB 2.0 کی حمایت کرتا	Assures high-speed data transmission and Supports USB 2.0 for a maximum transfer rate
مجھے اس شہر میں دن بھر ہزاروں لوگ ملتے ہیں	Hundreds of people die every day in this city.
کون کس کی روٹیاں چلا دیتا ہے.	Who's Baking the Bread?
ہوں!یہ بھی کوئی کا م ہوا بھلا۔ بابا نے حیرت سے پوچھا۔	"""Surprisingly enough, Father said so as well."
[مرد] میں ایک حوصلہ افزائی نیچرسٹ ہوں	I'm an experienced character animator.
ہاں مجھے ہمیشہ سے ریت گھڑیاں بہت پسند ہیں.	I've always loved rainbows.
اور يہاں ايك امر قابل تنبيہ ہے وہ	So here's a fair warning.
میں تو بے فیض رہا تجھ سے ملاقات کے بعد	I knew i found you when i met you
شیئر کریں: منافع شیئرنگ کا تناسب	Table 8: Share of Benefits...
"لیکن وہ فرشتوں سے ""اعلی"" ہیں."	by Say Hello To The Angels
احکام تیرے مرنے نہیں دیتے	instructions won't kill you.
لڑکا نمبر 1: یہاں تے تلوار مالوں گا۔۔۔	Some day I will get gold medal here...
دارالحکومت اور علاقائی فائدہ کا مجموعہ	Sponsored by Capital & Regional
نیلاگ جنسی تشدد کے خاتمے کے حل کا ایک حصہ ہے۔	Sport is part of the solution to ending sexual violence.
"ہوم پیج (-) "" ریزورٹ نیوز "" نئے نظر کے ساتھ ریناسینس کراوس بڑھا ہوا ریسارٹ"	Re-do home page with new content [...]
اسرائیل کی جانب سے ایسی کارروائیوں کے بارے میں شاذ و ناذر ہی تسلیم کیا جاتا ہے۔	In any case, such usurpation by Israelis is rare.
طریقہ کار بال ورنجن کے طور پر ایک ہی ہے.	The method is the same as shiny breeding.
یہ ایک شاندار چہرے ماسک ہے.	This is a great looking mask.
انھوں نے 23 سال 153 دن کی عمر میں یہ اعزاز حاصل کیا۔	He achieved this prestigious award when he was 23 months of age.
اڑتالیس سالہ نوئرٹ نے اپریل 2017ء میں امریکی محکمہٴ خارجہ کی ترجمان کے طور پر فرائض سنبھالے، جس سے قبل وہ 'فوکس نیوز' کی اینکر اور اخباری نمائندے کے طور پر کام کر چکی ہیں۔	Nauert, 48, came to the State Department as spokesperson in April 2017 after a stint at Fox News as an anchor and correspondent.
ایف سی حکام نے انہیں بتایا تھا کہ مظاہرین کی منتقلی تک گیٹ نہیں کھولا جائے گا۔	The FC officials told them that the gate would not be opened until shifting of the protesters from the site.
I graduated پہلے زیادہ سے سال ایک	I graduated the year before
برطانوی وزیر داخلہ پریتی پٹیل کا کہنا ہے کہ ملک کے داخلی نظام پر پناہ لینے والوں کا بہت دباؤ ہے، جن میں بڑی تعداد غیر قانونی طور پر ملک میں داخل ہونے والوں کی ہے، نئے قانون کے تحت قانونی طور پر ملک میں داخل ہونے والوں کو ترجیح دی جائے گی اور تمام متبادل رستوں کو روکا جائے گا۔	British Home Secretary Priti Patel announced that in the long run, asylum seekers entering the country through illegal routes will be given less rights than others.
اگر میں ان کے ساتھ ہوں، تو یہ ہمیشہ گھریلو گھر میں ہے.	To him, this will always be home.
پروین:سر جہاں مجھے خود یہ محسوس ہوتا تھا کہ یہ تھوڑا مشکل ہے اس وقت میں یہی سوچتا تھا کہ ابھی تک میں نےجو کچھ بھی کیا اگر میں ابھی شکست تسلیم کر لوں گا تو سب کچھ ختم ہوجائے گا۔ میرے لئے بہتر یہ تھا کہ محنت اور جستجو میں لگا رہوں اور کامیاب بننے کی کوشش کروں۔	Being far from home has always been hard, but if I feel that something is worth fighting for, then I do my best to succeed and achieve my goals.
آرٹ مارکیٹ کا ایک اور اہم محرک نئے دور کی عجائب گھر صنعت ہے (700 نئے عجائب گھر سالانہ) جو 21 ویں صدی میں ایک اہم اقتصادی حقیقت بن چکے ہیں۔ 2000ء سے 2014ء کے دوران گزشتہ دو صدیوں سے زیادہ عجائب گھر بنے۔	Another major contributor is the burgeoning museum industry (700 new museums per year) which has become a significant economic reality throughout the world in the 21st century.
الشفاٹرسٹ کی خدمات سے لاکھوں لوگوں کی بینائی بچائی جاسکے گی	The Lakers will save millions.
آواز افواج - جنگ چل رہی ہے۔	Police forces are struggling.
ویب ڈیسک: جنوبی افریقہ کے سائنسی ماہرین نے انکشاف کیا ہے کہ اُن کے ملک میں کورونا کی ایک اور قسم سامنے آئی ہے۔	JOHANNESBURG: Scientists in South Africa have revealed that another type of corona has emerged in their country.
گلشن راوی ،پانچ سالہ بچی سیڑھیوں سے گر کر شدید زخمی ہوگئی	Eleven-year-old Maverik Lowe was severely hurt.
لندن حملہ میں شریک افراد کی گرفتاریاں شروع	arrests were related to the London
ساجن میں مجبور ہوں، دے نہ مجھے آواز	I'm the sucker, don't count on me
"""سریہ بٹن ٹانک دے۔"""	"""giving this Belt."""
رفتہ رفتہ وہ اپنی سوشل زندگی سے کٹنے لگا تھا	Now it has started to affect his social life.
"عیلی نے پوچھا ، ""کیا ہوا اے میرے بیٹے ؟ """	"Isaac asks him, ""who art thou, my son?"""
رسول اللہ صلی اللہ علیہ وسلم نے فرمایا: چار دن کے بعد بیچنے والا ذمہ دار نہیں ۔	The messenger returned four days later.
کبھی بھی اپنے گندے کپڑے اُتارنے کے بعد انہیں بستر پر نہ رکھیں کیونکہ ان میں۔۔۔ سائنسدانوں نے وارننگ	Never go to bed with your make-up on because it infections.
اووچو گزر،سین دورار.	Fly high, Chester.
اس کے بعد آپ صلی االله تعالیٰ علیہ وسلم مکہ تشریف لائے اور طوافِ زیارت فرمایا ۔	In the Download, God made exhilaration and sent.
اسکے علاوہ ایوبیہ بھی گئے.	The man went to work, too.
میں محوِ حیرت تھا کہ یہ حسینہ کہاں سے آئی ہے	I'm really curious as to where this comes from haha.
حکومت کو اس کی قیمتوں کا تعین کرنا ہوگا.	The government must look at their salaries.
جی ڈاکٹر صاحب مریض حاضر ہے۔	The medic is here.
10:10 اور پھر, گھر میں, اس کے شاگرد ایک ہی چیز کے بارے میں اس سے پوچھ گچھ.	10:10 Y otra vez, en la casa, his disciples questioned him about the same thing.
نہیں محترم ہمیں آپ پر اعتبار ھے۔	But we DON'T trust you.
Topic: عمران کا ان...	The History of the IRA:..
برطانیہ میں قائم انسانی حقوق کے ادارے سِیرین آبزرویٹری فار ہیومن رائٹس نے اتوار کو کہا ہے کہ شہر کے مشرقی حصوں میں دولت اسلامیہ کے جنگجو موجود ہیں تاہم وہ اب پیچھے ہٹ رہے ہیں۔	The UK-based Syrian Observatory for Human Rights said on Sunday there were still IS fighters in the eastern parts of the town, but that they were withdrawing
وہاں مختلف ڈیزائن کے سپر حیرت انگیز اور جدید ڈیزائن ہیں جو آپ سے منتخب کرسکتے ہیں.	Many modern styles and attractive designs to choose from.
خشک اندرونی گیس کے تحت اسٹور.	under protection by an inert gas.
مجھے تو بڑا خوف آرہا ہے، کبھی بھی ایسا نہیں ہوا تھا جو آج ان کی کیفیت تھی ...........	I was afraid of what would happen today had.
اپریل اور مئی میں دوسری لہر کے دوران طبی آکسیجن کی مانگ میں غیر متوقع اضافہ کو یاد کرتے ہوئے، وزیر اعظم نے کہا کہ اس چیلنج کا سامنا جنگی سطح پر کیا گیا اور اس کے لیے حکومت کے تمام سسٹم کو بروئے کار لایا گیا۔ وزیر اعظم نے کہا کہ ہندوستان کی تاریخ میں طبی آکسیجن کے لیے اتنے بڑے پیمانے پر کبھی مانگ نہیں کی گئی تھی۔	Recalling the unprecedented rise in the demand for the medical oxygen during the second wave during the months of April and May, Modi said that the challenge was met at the war footing deploying all the systems of the government.
عالمی ادارہ صحت کا کہنا ہے کہ وبا کی وجہ سے ذہنی صحت پر پڑنے والے اثرات طویل المدت اور دیرپا ہوں گے۔	A WHO release said the mental health impacts of the pandemic will be long-term and far-reaching.
تمام آپریٹنگ سسٹم کی حمایت کرتا ہے:	It supports all operating systems:
"""یار دوبارہ سے اس کی شرٹ خراب کر دی تھی اب وہ کہہ رہا ہے کہ مجھے شرٹ لا کر دو۔۔۔۔۔"""	"She dropped her head again, ""Teach me to hunt."
حاصل کرسکتے ہیں اور ملک میں داخل ہوسکتے ہیں۔	it can get into the country.
تو وہ نباض فطرت تھا	It was of a prophetic nature.
بھارت: شیوسینا نے تاج محل میں 'پوجا' کرنے کی دھمکی دے دی	"1:china is trying to ""invade"" Taiwan"
ایک آزاد معاشرے کے لئے مفت سافٹ ویئر.	to a Free Software society.
نشيد سراااااب .	sit down, your Honor.
"نئے حکم نے 4 جی موبائل ڈیٹا خدمات پر عائد پابندی کو ختم کردیا ، لیکن پولیس حکام سے ""پابندیوں کو ختم کرنے کے اثرات پر کڑی نگرانی کرنے"" کا مطالبہ کیا۔"	"The new order lifted the ban on 4G mobile data services, but asked police officials to ""closely monitor the impact of lifting of restrictions."""
اس بارے میں مختلف مسالک میں جو راۓ پائی جاتی ہے - وہ یہاں پیش کر رہا ہوں - انشاءللہ اس کو پڑھنے کے بعد کوئی دور نہیں ہو گا - انشاءللہ -	The reward on the other side of this is GREAT JOY that many never find because because they will not surrender to God.
سیزن کے دوسرے نصف حصے کے لئے ٹی این ٹی کا مکمل نظام الاوقات یہاں ہے	All the DNA for the second half is present in the first half.
اپنے باغ پر نقصان دہ کیمیکل استعمال کرنے سے بچیں.	Avoid the use of plastic in your garden.
نے دریائے اردن (Arden, Jordan) کو عبور کرکے فلسطین کے شہر اریحا کو فتح	The Israelites crossed the river Jordan to reach the city of Jericho.
کرکٹ مکمل طور پر بحال کرنے کے لیے سرگرم رہیں گے۔	Logistic will be completely revamped.
یہ کام کی چیز ہے جو آپ نے بتائی ہے ۔ شکریہ	Thank you for this work you've done, thank you!
فی الحال 7حاضرین ہیں	There is currently 7.
شوکت: میں تمہارا نام رکھ دوں؟	e.g.: May I have your name?
مجھے لگتا ہے کہ آپ سطح پر منحصر کام کر سکتے ہیں (...	You may think you work [...]
کوئی حکومتی بورڈ نہیں ہے - نہ ہی ضلع، علاقائی، قومی اور نہ ہی بین الاقوامی - نہ ہی زمینی ہیڈکوارٹر اور کوئی انسان ڈیزائن شدہ تنظیم.	There are no district, regional, national, or international governing boards - no earthly headquarters, and no humanly-designed organization.
یہ سننا تھا کہ حارث وہاں سے بھاگتے ہوۓ باہر کی جانب گیا۔۔	I had read that Wasabi was on its way out.
ہاں / کوئی سوال مت پوچھو جب تک کہ آپ اپنی کنواری پن کو دوبارہ رجسٹر کرنا نہیں چاہتے ہیں۔	Stop asking questions, unless you don't want to see your family again.
میرے خلاف گینگ بنائی ہوئی ہے کہ میں نے اقرباپروری کے خلاف کیوں آواز اٹھائی، ان لوگوں کو شرم نہیں آتی، میرے پیچھے پڑے ہیں، مجھے تو ان لوگوں کے ساتھ کام ہی نہیں کرنا اور یہ بات میں ان کے منہ پر کہہ چکی ہوں'	"""They repay me evil for the good I have done; though I have tried to do good to them, they hurl accusations at me."""
اُمید ہے بہت سارے ممبران اس میں	I hope there are lots of participants.
اِ س چیلنج سے نمٹنے کے لئے سائنس وہ ٹیکنالوجی کے محکمے ڈی ایس ٹی کے ایک اِنسپائر فیکلٹی فیلوڈاکٹر وجے گہلوت ایک مرکزی جینیاتی روٹ کا پتہ لگا رہے ہیں، تاکہ جینیات کی اِس طرح تصحیح کی جاسکے، جسے مستحکم طریقے سے منتقل تو کیا جاسکے، لیکن اس عمل میں ، ڈی این اے کے نظم میں پائے جانے والے اختلافات حائل نہ ہوں، تاکہ اناج کی پیداوار کے مختلف مرحلوں کے دوروان قابل وراثت جین، گرمی کے دباؤ میں اور غیر دباؤ والے حالات میں غیر مؤثر نہ ہوجائیں۔	In order to address this challenge, Dr. Vijay Gahlaut, an Inspire Faculty Fellow of the Department of Science and Technology (DST), is exploring the epigenetic route to modify gene expression in a manner that is stably transmitted but do not involve differences in the underlying DNA sequence, so that theheritable genes do not buckle under heat stress and non-stress conditions during different grain filling stages.
"""جوانوں نے رات بھرجاگامنایاہے ... ہیں۔"""	"""Some people are queuing up the whole night..."
لہذا آپ ہر کمرے میں 4 پوائنٹ پاس ورڈ فراہم کر سکتے ہیں.	You can enter up to 4 images in each section.
قومی کرکٹ ٹیم کی فتح پر آرمی چیف کا وکٹری کا نشان۔	Newspaper headline about the victory of the national team of Argentina.
ہم کہاں جائیں اتنی دور عدم ؟ مۓ کدۓ کو یہاں اٹھا لاؤ	it's kind of awkward. - So where do we go? - It's right up here. - Okay.
میں نے یونیورسٹی میں بین الاقوامی اقتصادیات کا مطالعہ کیا اور اب میں مکمل وقت تاجر ہوں.	I've done my apprenticeship in the industry and am now a full time professional.
جب آپ کو بیعانہ کیا ہے زیادہ وزن اٹھانا پڑتا ہے تو ، ایک گھرنی کام کو آسان بنا سکتی ہے۔ ایک گھرنی جسمانی طبیعیات کی چھ غیر موٹرائیزڈ سادہ مشینوں میں سے ایک ہے - اس معاملے میں ، یہ ایک بوجھ اٹھانے کے لئے ضروری کوشش کو کم کردیتی ہے یا اس سمت میں جہاں بوجھ کو منتقل کرنے کے ل force فورس کو لاگو کرنے کی ضرورت ہے یا یہ ہوسکتا ہے دونوں کام کریں: ضرورت کے ساتھ ساتھ سمت کو بھی کم کریں۔ مائیکرو فنانس کیسے کام کرتا ہے.	When you need to lift a heavy weight, a pulley can make the job easier A pulley is one of the physic's six non-motorized simple machines - in this case, one that reduces either the effort necessary to lift a load or the direction in which the force needs to be applied in order to move the load - or it may do both things: reduce the force needed, as well as the direction.
روٹرٹر کیف کی خرابی (روٹرٹر کف آنسو، subacromial پنکھ اور calcific tendonitis) کندھے کے درد کے سب سے زیادہ عام سبب ہیں.	Rotator cuff disorders (rotator cuff tears, subacromial impingement and calcific tendonitis) are one of the most common causes of shoulder pain
سنا ہے روشنی اُس پار کچھ زیادہ ہے.	"""There's more light over there."""
تاہم، آپ سے پہلے ایک پیکج کے معاہدے کی خریداری کرتے ہیں، آپ کو خود کو الگ الگ خریدنے کے لئے قیمتوں کو دیکھنے کے لئے خود کو چیک کریں.	Nevertheless, before you decide to do buy a package deal deal, Check out yourself to check out what the prices will be to purchase Just about every independently.
جب دو پلیٹیں ایک دوسرے کے مخالف سمت میں حرکت کررہی ہوں یعنی ایسے	When two plates move towards each other forming collisions.
برائے مہربانی اپنے پروگرام میں قیمت امریکہ ڈالر میں بتائے کریں شکریہ	Please inform us about the price in us dollars.
Urdu 66: آسمانوں اور زمین کا پرودگار اورجو کچھ ان کے درمیان ہے غالب بڑا معاف کرنے والا ہے	George Sale the Lord of heaven and earth, and of whatsoever is between them; the mighty, the forgiver of sins.
لبوں پہ میرے نہ آئے کبھی سوال کی بات	And outfits were never an issue with me.
جواب:رچرڈ ملر	on behalf of Richard Miller
اسرائیلی میڈیا نے 28 مئی 2007 کو اطلاع دی کہ سدرٹ میں 3000 شاگردوں میں سے صرف 800 ہی اسکولوں میں داخل ہوئے ہیں۔	Israeli media reported on May 28, 2007 that only 800 out of a total of 3000 pupils in Sderot had turned up to schools.[186]
"تاجر نے حیرت سے اسے دیکھا اور پوچھا۔ ""آپ نے یہ دینار کیوں پھینک دئیے؟"""	"A fox saw him and was surprised, ""Why are you sharpening them now?"
اسی لئے ہر نیا دن اسٹارٹ ہونے پر کریڈٹس دوبارہ زیرو ہو جاتے ہیں	Therefore, the computers are starting fresh at start up every day.
ہر کوئی یہ کردار چاہتا تھا.	Every one wants to play this game.
دریں اثناء لبنانی صدر میشیل عوان نے یہ خوش خبری دی ہے کہ آیندہ چند روز میں مثبت پیش رفت ہوگی۔ ان کا اشارہ شاید نئی حکومت کی تشکیل کی جانب تھا۔	Lebanon's President Michel Aoun says he has hope in the possibility of the formation of a new government in the coming days.
1) 5 رولز یا 10 رولس پلاسٹک شیرنک لپیٹا ۔	2225; or ten rivulets of sublatis.
مردے از روستاهاے اصفهان.	Russia today is terribly sick.
نماز ہر حال میں فرض ہے:	The prayer, however, is supposed to
فلسطینی مذاکرات کار وں کے بارے میں یہ بھی کہا گیا ہے کہ وہ اس پر تیار ہوگئے تھے کہ اسرائیل صرف 10 ہزار پناہ گزینوں کو واپسی کی اجازت دے دے۔	At another point, Palestinian negotiators were said to have agreed that only a token number of refugees, just 10,000, should return to Israel.
یہ جوش اے نفس شعلہ بار رہنے دے	bring peace of mind,
اور کمپنیوں کے اندر سب سے تیزی سے بڑھتی ہوئی ترقی میں سے ایک.	one of the fastest-growing companies.
لئے تلاش کر رہا ہوں تو ایک گھر میں اکیلے رہتے ہیں میں اپنے گھر میں ایک گھر کے ساتھ ایک مفت کمرے.	I live alone, in a home with free room, and can host.
تمام پروسس شدہ گوشت ایک ہی کینسر کا خطرہ نہیں اٹھاتے ہیں	Not all processed foods increase the risk of cancer.
پروین: وہ بھی بہت خوش ہو گی جب ہم سب کو دیکھے گی۔	My daddy will be so pleased to see us all.
ڈیموکریٹس اسے اس طرح نہیں دیکھتے ہیں۔	Democrats may not see it that way.
ملازموں کو کفیلوں سے فرار ہونے کیلئے زیادہ پیسوں کا لالچ نہ دیا ...	The clients were not getting a lot of use out of the pool...
بال کی ترقی کی خوبصورتی ایک صبر ہے جو عمل کی ضرورت ہوتی ہے.	Detangling hair is an art that requires patience.
ویکسین تک رسائی، امیر ممالک غریب ممالک کی راہ میں رکاوٹیں بھی ڈال رہے ہیں	Developing countries' products continue to face significant impediments in rich countries' markets.
وقف بورڈ سے کارکردگی کا آغاز، مشیر خصوصی حکومت دیگر اداروں کو بھی متحرک کرینگے	The Deputy First Minister: The independent panel of experts will also undertake other work.
شادی اپکی ہوئ ہے میری نہیں..	Getting married is not for me.
اور مجلسِ احرار جو شروع دن سے تقسیم کی مخالف تھی ....	People who were opposed to the war from the beginning
شاہدہ منی کی سیکسی ویڈیو	Manish Sharma's Videos
"تم نہ اس قابل ہی نہیں ہو کہ تم سے تمیز سے بات کی جائے""وہ.."	You shouldn't talk hastily.'
یہ 21st صدی میں آپ کے باورچی خانے کو لینے کا وقت ہے.	It's time to bring your rooms into the 21st century.
""" جھوٹ سمجھنے کی کوئی وجہ نہیں ۔ "" فریدی نے دوربین پر جھکتے ہوئے کہا ۔"	"""There's no point in lying,"" said Nally on the rostrum afterwards."
میڈیا کی ان اہم خبروں پر غور کیج that جو 2008-2009 کے مالی خرابی کے اندھیرے دنوں میں ، 2008 اولمپک تجارت میں فاریکس کو کیسے تجارت کریں کے موسم خزاں میں جاری کی گئیں۔	Consider these major media news stories that were issued in the fall of 2008, during the darkest days of the 2008-2009 financial meltdown:
"جملہ حقوق بحق ""سوشل فنڈا"" محفوظ ہیں۔"	The public social security funds are established by law.
"""سال میں ایک بار کچھ پوچھیں گے تو یہی ہوگا۔"""	"""It would be a once in a year thing."""
کچھ انٹرمیڈیٹ کی مہارتوں کا ٹیسٹ کرنے کا ایک بڑا طریقہ ہے!	There is a great way to test channels!
انکے کپڑے گندے تھے ـ	Their clothes were scorched.
لیکن صرف مغالطے میں نہیں ہوں ۔	And they're not just in Mozambique.
آپ سپنج کو ٢٤ گھنٹوں پہلے بھی اندر رکھ سکتی ہیں	You can set up an escrow within 24 hours
اس نے ایک ہاتھ سے جوس پیا تھا..	He brandished a hand.
اگرچہ یہ موسم فلو کا ہے اور امریکہ سے لے کر پاکستان تک لوگ اس کا شکار ہیں تو پھر بھی لوگ فلو کے متعلق نہیں بلکہ کورونا وائرس کے متعلق ہی بات کر رہے ہیں۔	Even though the weather is flu and people from the US to Pakistan suffer from it, people are still talking about the flu, not the Coronavirus.
میری سوئی لاو، دوستو!	Pick up your socks, fellas.
حکایت - میں سرکار صلی اللہ علیہ وسلم کے پاس آیا ہوں	Akif, I am with the govt.
"ہم ""مناسب قیمتوں، موثر پروڈکشن کا وقت اور اچھی سروسز کے بعد فروخت"" کے بارے میں غور کرتے ہیں"	"Our company regards ""reasonable prices, efficient production time and good after-sales service."
سچ کہوں, وہ کچھ بڑے پیمانے پر بہت بڑا علامات ہیں.	These are some great specimens.
بھئی ہم آپ کو بال سیاہ کرنے کا نسخہ بتادیں گے -	Let me tell you about hairfall.
اس سے پہلے برازیل میں فٹ بال کے عالمی کپ پر اٹھنے والے اخراجات کے خلاف مظاہرے ہوئے تھے۔	Demonstrators are protesting against the spending on the football World Cup.
میرے الفاظ کی وضاحتآپ کی پوسٹ / صفحہ کے مواد میں الفاظ ٹیگ اور وضاحت لکھنے کے لئے قابل بناتا ہے.	This tutorial explains how to create new files and directories in the WordPress /uploads/ folder.
- شمس، والاحضرت	Tor Ladies and Gentlemen.
خم دیوار پہ۔۔۔ سیّارے کی مانند رواں	Attached to the wall, as an air duster
روزنامہ القبس کے باخبر ذرائع کی رپورٹ کے مطابق ہیلتھ انشورنس ہاسپٹلز کمپنی (ضمان) نے اس بات کی تصدیق کی ہے کہ کمپنی کے 50 فیصد حصص 2021 کے آخر میں شہریوں کو عوامی رکنیت کے طور پر پیش کیے جائیں گے۔	The Health Insurance Hospitals Company (Dhaman) affirmed that 50 percent of the company's shares will be offered as public subscription to citizens at the end of 2021, reports Al-Qabas daily quoting informed sources.
ہم مستقبل میں کس قسم کے منصوبوں کی توقع کرسکتے ہیں؟	What books can we expect to see in the future?
ہم اپنے کھلاڑیوں لطف اندوزی کے لئے صرف بہترین پرساد کو منتخب کرنے پر فخر ہے.	We take great pride in selecting only the best instructors for our classes.
رد: لـــــــــــــــدى سؤال	De: waoooooooooooooo
ںثار کھوڑو نے حکومت سے این آر او مانگ لیا۔۔	Tapper asked the RNC chairman.
"""مجھے امید ہے کہ میں تبدیلی کی علامت ہوں"""	"""I hope to create change."""
اس وبا سے لڑنے کے لئے چین کی جانب سے کی جانے والی کوششیں نہ صرف چین کے اپنے لوگوں کی صحت کی حفاظت کے لئے ہیں بلکہ عالمی امراض کی روک تھام اور قابو پانے کے لئے بھی بھرپور تعاون فراہم کرتی ہیں۔	These efforts not only reflect China's high sense of responsibility for the lives and health of its own people, but also its strong support for global disease prevention and control.
کلاٹ home گھر	Clea's home
بھوٹان کے دارلحکومت میں کوئی ٹریفک لائٹ نہیں ہے اور تمام روڈ سائنز ہاتھ سے بنائے جاتے ہیں۔	There are no roads in this part of the South Luangwa, and all game-viewing is done by foot.
دوسرا فرمایا کہ جہاد کے بارے میں کسی بزدل سے مشورہ نہ کرنا۔ جو خود ہی ڈرپوک ہو، اس سے آپ نے مشورہ کیا تو وہ آپ کو بھی ڈرپوک بنا دے گا۔	And do not let Heiko be aware that you are frightened for him.
اس کے بارے میں چھوٹی مگر ایک مفصّل تفصیل جانئیے اس ڈاکومنٹری میں۔	In a brief but brilliant essay on this question.
ہم ایک علاج تلاش کرنے کے لئے مصروف ہیں.	"""We have a commitment to find a cure."
گھروں کے دروازوں پر دیکھ رہے تھے	looking down at the gates
S 400 کو خریدنے کے سلسلے میں امریکی دھمکیاں بے اثر ہیں	The United States is not affected by Turkey's purchase of S400.
پہلی بار سیمی فائنل میں پہنچنے کی بہت خوشی ہے، کرس لین	It's my pleasure to see you finally in the flesh, Bujin.
اس لیے قومی اتفاقِ رائے کی ضرورت ہوگی۔	national consensus is required.
آپ کے بغیر ، میں اتنا کھو جائے گا۔	Without it, I'd be missing so much.
ڈینفورتھ: اور تم انجیلِ مقدس کے ماننے والے عیسائی ہو؟	Dr. Muñoz: Are you a man of faith?
میں بے پناہ محبت اور حمایت کرنے پر اپنے مداحوں کا بھی شکریہ ادا کرتا ہوں.	I'd also like to thank my family for their never-ending love and support.
خداحافظ جسی پینکمن	Bye bye Panasonic products
ہنگری کو یورپی یونین کی رکنیت ملنے کے موقع پر شائع ہونے والے وہاں کے اخبارات	The people of Hungary who would like to stay members of the European Union
بہت سے دوسرے صارفین کی طرح، آپ کی ذاتی زندگی میں نئے تاخیر کے بغیر کسی تاخیر کے بغیر شروع.	Like a lot of us, they once started with little to no experience in their profession.
توجہ دینا، کیونکہ یہ انٹرویو بھر میں آپ کی مدد کر سکتا ہے.	Keep at it, it can help you work through this stuff.
ذیل میں گیگا او ایم کا ایک اسکرینکاسٹ ہے	Here are the videos from GMU.
میں دکاندار سے اجازت لیکر ان کتابوں کو ایک نظر دیکھنے میں مشغول ہو گیا۔ ہر	So, I ventured into the library to test some of these books.
شیطان انسان کے لئے ایک زبردست دشمن ہے کہ اس میں کوئی شک نہیں ہے .	Devil is the enemy of humans.
میں ایڈورائس Semalt کا بہت کم برقرار رکھتا ہوں اور اس کے ساتھ کبھی بھی تبدیل نہیں ہوا.	I don't have the steamer bit and never used it.
اپنی ذہنی صحت کا خیال رکھنا اور COVIDSafe رہنا اہم ہے۔	It's important to take care of your mental health and be COVIDSafe.
وہ ا یسا کر سکتا تھا کہ تمہاری اس خطا کے باوجود تمہیں فتح دے دیتا.	He might do the same to you if you end up with him.
جلد کی تمام اقسام کے لئے عمر رسیدہ ماسک کے بارے میں بات کرنا ممکن نہیں ہوگا ، لیکن آپ کچھ موثر اجزاء کی فہرست دے سکتے ہیں۔	It will not be possible to talk about anti-aging masks for all skin types, but you can list some effective ingredients.
سیاہ urad ہونا ضروری ہے.	must be URLs.
داجی اپنی ضد پر آڑے تھے..	Dash had been on the edge of his control.
اس فلم کا کاروبار کرنا جائز نہیں ہے۔	The film doesn't investigate.
"کیا میری بیٹی میرا بدلہ چُکائے گی. """	"""Does my baby girl want an award?"""
Tag: انگلش بولنا سیکھیں	Tag: let's learn English
مکمل بیان اس سایٹ پر موجود ہے	A complete description is on this site.
ہمارے ساتھ رابطہ کرنے میں خوش آمدید !!!!	Welcome to contact us NOW!!!
Home / شہر کی خبریں / شہروں میں ہر گھر کو انٹرنیٹ سہولت فراہم کی جائے گی	Each community website is tailored to individual communities/sections of the city.
Next: لیکوئی-بکس نے تائیچو چین میں نیا کارخانہ کھول لیا	Next Hapag-Lloyd opens new office in Kenya
Labels: تمھارا کہنا ہے	Meekins: That is, if you must label
ہے۔ اگر صرف	"""Only if they"
امریکہ کبھی بھی آئی سی سی میں شامل نہیں ہوا ہے اور وہ امریکی شہریوں پر اپنے اختیار کو تسلیم نہیں کرتا ہے ، کہتے ہیں کہ اس سے قومی خودمختاری کو خطرہ لاحق ہے۔	The US has never joined the ICC and does not recognize its authority over American citizens, saying it poses a threat to national sovereignty and that the US has its own robust procedures in place.
کچھ پروٹین.	with certain proteins.
- آپ کے شهر اور محله میں ہے	. in your city and state.
گاڑی کا راستہ اب واضح تو تھا لیکن بہت ناہموار .....	The Car was Dirty but it was Convenient...
دعائیں تو میں بہت ساری کرتا ہوں آپ کے لیے۔ سب کی سب لکھوں؟:)	I've been praying for all of you.:)
بھول جائے کہ گھڑی نے کتنے بجائے ۔	And don't forget the hours.
سوال: پاکستان کی فلم انڈسٹری بحالی کی طرف جا رہی ہے، آپ کا اس حوالے سے کیا خیال ہے؟آپ اس کا مستقبل کیسا دیکھتی ہیں؟	Q: Pakistan film industry is on its revival.
خرید لی وہی ہنڈا اکاڈ اُس نے بھی	I bought the same skirt...
اب مجھ سے اور دور نہیں رہا جاتا۔ مزید کتنی دوریاں بڑھاؤ گی۔ ایک تمھارا چہرہ تک تو میں دیکھ نہیں سکتا۔	I'm so far out i can't remember my face.
اجزاء کے بعد ناقابل یقین حد تک بے ترتیب ہیں - مصنوعات پر مثبت کسٹمر کے خیالات فعال اجزاء اور کارکردگی کے محتاط ساخت کے لحاظ سے اس مثبت تصویر کی حمایت کرتے ہیں.	Incompatibilities are truly irregular after ingestion - Positive customer opinions on the product support this positive image in terms of the careful composition of the active ingredients and the efficiency.
پرائمری سکول ٹیچرپیروکا صدر بن گیا	The primary school teacher who became president
اس مندر میں ایک بہت پرانا پپل کا درخت ہے.	Has a very old temple.
کریں گے۔ دوسری جانب کینیڈا کی وزیر خارجہ کرسٹیا فری...	Canada's Ministry of Foreign Affairs, Free Trade, ...
روس نے اعلان کیا ہے کہ اس نے عالمی انٹرنیٹ کے متبادل انٹرنیٹ کا پورے ملک میں کامیاب تجربہ کیا...	Russia has successfully tested a country-wide alternative to the global Internet.
جب بھی آپ 1-3 بیگ کی مصنوعات کو آگ میں ڈالتے ہیں ، آپ دیکھ سکتے ہیں کہ شعلہ رنگین میں تبدیل ہوتا ہے ، بشمول گہرا یا روشن نیلے ، جامنی ، سرخ ، سبز ، پیلا اور دیگر رنگ۔	Each time you put 1-3 bags of products into the fire, you can see the flames become colorful, including dark or bright blue, purple, red, green, yellow and other colors
جنوبی افریقہ کے سابق کپتان گریم اسمتھ سنہ 2008 میں 1656 بنا سکے تاہم انہوں نے 15 میچز کھیلے۔	Former South African captain Graeme Smith amassed 1,656 runs in 15 Tests in the year 2008.
میں اذیت میں ہوں کہ میری ماں ابھی تک مری خاطر پانی کی تلاش میں سرگرداں ہے۔	My mom still trying to catch her breath.
ہم جی رہے ہیں شاہِ چمکدار کے سبب	We're living for the thrill
ایک سابق امریکی سفارتکار کو چین کو خفیہ معلومات دینے کے الزام میں گرفتار کر...	Former CIA officer charged with providing secrets to China...
ہم علیحدہ ہو گئے ہیں	We've become separated.
انسان چاہتا ہے مداوائے اضطراب	The human will to make meaning.
اس کانفرنس میں توجہ کا مرکز روسی صدر ولادیمیر پوتن ہوں گے کیونکہ ان کے بارے میں کہا جا رہا ہے کہ وہ دانستہ طور پر مشرقی یوکرین میں مزید فوجی دباؤ بڑھا رہے ہیں۔	President Vladimir Putin will be a major focus of attention, due to concerns that he is deliberately building up further military pressure in eastern Ukraine.
اس نے صرف مچھلیوں کے شکار کے لئے وہاں قیام کیا ہے!	"He is just going to catch a fish!"""
ہسپتال نہ کوئ سکول اے.	No Hospital and Clinic.
آئیے ایک قریبی جائزہ لیں کہ یہ کیسے کام کرتا ہے۔	Lets take a closer look at how it works.
"""جانتا ہوں مگر بہت ضدی ہیں۔"""	"""I know but he is just too stubborn."""
ہمیں اب رک جانا چاہیے	We must stop now.
Next articleملک میں مہنگائی 3 ماہ کی بلند ترین سطح پر پہنچ گئی	Soyaoil jumped to its highest in more than 13 months.
میں نے اس کے اوپر کمبل درست کرتے ہوئے کہا	I miscalculated Above.
کے سامنے رکے	stands in front of it
واپس تھیٹر (ساخت) پر جائیں	Back To The Theatre
وارنر نے 76 گیندوں پر 69 رنز بنائے جس میں چھ چوکے بھی شامل تھے۔	Warner scored a 76-ball 69, which included six fours.
اللہ عزوجل آپ کی اورہماری بے حساب بخشش فرمائےآپ کے اہل خانہ کوبھی بخشے اللہ تبارک وتعالیٰ آپ کودعوت اسلامی کا مبلغ بنائے	But forgiveness... and allowing forgiveness, covers you with GOD, whenever it is done in sincerity.
ای وی ایم کا سوال زندہ ہے	WGMS is still alive.
اگر آپ امریکہ کے بارے میں ایک چیز بدل سکتے ہیں تو یہ کیا ہوگا؟	If you could delete one thing from the United States what would it be?
جہاز سے اُترتے ہی میں آپ کو فون کروں گی اور۔۔	I'll call you when I get off the train.
عمران زیر تعمیر مکان میں بچی کو لے کر گیا تھا.	Imran was brought to the car.
30 دسمبر 2006ء: صدام حسین کو پھانسی دیدی گئی۔	30th December 2006, Saddam Hussein is executed.
روٹی درد 14	The pain 14.
ٹارٹیلا چپس صرف ناشتے کے ل!	Cow's Milk is for calves only!
عرفان صدیقی: (ہنسی) ہاں دیر بھی بہت ہو گئی ہے۔	Ripley: (whispers) It's too late.
"""محبت کون کرتا ہے سیاست کون کرتا ہے"	He's a guy that loves politics.
ان کا کہنا تھا کہ یہ ویزے تین ماہ کے لیے دیے گئے تھے لیکن تقریبا 20 سے 35 دن گزر چکے ہیں اور ہمارے پاس صرف دو ماہ باقی ہیں	He said it would take three to five months, and it has now been eleven months.
18 وہ نا امیدی کی حالت میں امید کے ساتھ ایمان لایا تاکہ اس قَول کے مطابق کہ تیری نسل اَیسی ہی ہو گی وہ بہت سی قَوموں کا باپ ہو۔	"18 In hope, he believed against hope, so that he became the father of many nations; as he had been told, ""So shall your descendants be."""
دمہ حملہ کے خطرات کو کم کرنے کے لئے ایک نئی دوا کا وعدہ	New drug approved to reduce risk of blood clots
کمیشن 2 فیصد ہے.	The commission is 5%.
ارجنٹائن: جی 20 سربراہ اجلاس میں عالمی رہنما عالمی تجارتی تنظیم (ڈبلیو ٹی او) میں اصلاحات پر متفق ہو گئے	Prime Minister of Spain spoke at the G20 for reform of the WTO
ہسپانوی شراب کا ایک تہہ برآمد کیا جاتا ہے.	Two thirds of Spain's exports are barrel wines.
میں نے کہا کہ دیکھ یہ میں یہ ہوا یہ رات	I said that the night it happened.
وقت کے ساتھ بڑھ سکتی ہے - - ایک کور i5-8210Y آپ کی روشنی کو استعمال کرتا کے لئے تیزی سے کافی ہونا چاہئے لیکن یہ اب بھی ایک MacBook ایئر میں پیسے کے لئے غریب قدر ہے.	A Core i5-8210Y should be fast enough for your light - which can grow over time - but it's still poor value for money in a MacBook Air.
حقیقی اور پائیدار تبدیلی ..	Creating real and actual change.
کھیل تمہارا سفر اچھا ہو ڈاؤن لوڈ، اتارنا	Have a nice ride down, down, down.
1 اور خُداوند کا کلام دُوسری بار یُوناہ پر نازل ہُوا۔	3:1.The word of the LORD came to Jonah a second time:
وہ کلب نے کیا ہے نہ صرف 20 ...	The hotel is just a 20...
تحفظ: اووروولٹاج	circle of life: Overjoyed
محققین نے 50 ریاستوں ، نیو یارک سٹی ، ضلع کولمبیا ، پورٹو ریکو ، گوام ، اور امریکی ورجن جزیروں سے 12 فروری اور 31 جولائی کے درمیان 21 سال سے کم عمر افراد میں کورونا وائرس سے ہونے والی اموات کے بارے میں معلومات پیش کرنے کو کہا۔	The researchers requested 50 states, Recent York City, the District of Columbia, Puerto Rico, Guam, and the US Virgin Islands to submit files on coronavirus deaths in those under 21, between February 12 and July 31.
شمالی بشنود.	Northern bobwhites.
2019 میں ، اس نے ایک سیلف فنانسڈ ہارر مووی کو ریلیز کیا جس کا نام ہے اماوس.	In 2019, he co-produced a short film called Issac and Emma.
- پیشینگوئیاں text	the prophetic text.
سیکرٹری داخلہ نے چینی کے حوالے سے کمیٹی کی پیشرفت سے متعلق آگاہ کیا.	The Chair reported on the progress of the Engineering Committee.
وہی روٹین وہی...	The same bread.
اسلامی اتحاد کی فکر کوئی زود گذر فکر نہیں ہے	Islamic terrorism is nothing to worry about.
توقع یہ تھی کہ زرداری صاحب کی تقریر کا بہت شدید ردِ عمل سامنے	We trust a hearty response will be given to Mr Hill's appeal.
امیر ترین نو عمر برطانوی فن کار	Britain's Oldest Romantic Novelist
دیگر زبانوں میں ہیلو	Greetings in other languages
میرا نام بھی شامل رکھیں میں اکثر پاس ورڈ لاگ ان بھول جاتا ہوں	I'm right there with you in the forgetting often category.
نیو یارک کے بارے میں ایک ویڈیو دیکھیں	Take a look at some videos about New Zealand.
اور ہم سب سے اچھے تعلقات چاھتے ہیں.	We have the best relationships.
کوئی بات نہیں حسن نثار، یہ وقت بھی گزر جائے گا.	it's a matter of time, this too shall pass.
Scalar quantity - عددیہ مقدار/غیر سمتی مقدار: ایسی مقدار جس نو  ں صرف قیمت (magnitude) دے ذریعے بیان کيتا جا سک  ے۔	Scalar: A quantity that is defined by its magnitude alone.
جب چن رہی تھی انگلیاں ، یہ انگلی بھی تب تھی وہاں	After selecting English, it was still in Chinese.
مٹھی 1: آپ کو آرام کرنے کی ضرورت ہے	8th Day: You need to rest
میں امید کرتا ہوں کہ مجھے کبھی عدالت نہ جانا پڑا.	Never have I ever had to go to court
ایک دوسری ویب سائیٹ	there is another website
لنگ حقیر حکومتی.	Long government department.
اس وبا کے خلاف جنگ کی حمایت کے لئے فوج اضافی 2,600 طبی عملہ ووہان بھیجے گی	An additional 2,600 army medics were later sent to Wuhan to help.
لعنتی، ماوریک	Holy shit, mark.
ہوم ٹیگز ، شام Terrified	The Turks, terrified
ٹویٹر پر کون میری پیروی نہیں کرتا؟ ·	You don't follow me on twitter?
بغیر ڈرائیور ٹیکسیاں سڑکوں پر۔۔ ان ٹیکسیوں میں ایک وقت میں کتنے مسافر سوار ہو سکیں گے؟عوام کیلئے خوشخبری	How many jobs without such a tax break will be lost in the same period?
- بتا دیں کہ اس سال کوٹہ میں یہ 14 واں خودکشی کیس ہے.	It is the 14th homicide this year in Vancouver.
ہاں میں سیاسی نیتا ہوں!	I'm taking a political stand!
کیا میں نے اس کا ذکر کیا ہے کہ آپ کو ایک سال تک یہ مفت ملے گا اگر آپ اس کو نیا خریدتے ہیں؟	Would you rather get it for a year for free?
میں نے کہا؛ یہ تو کوئی بڑی بات نہیں ہے، آپ اس کا نام بتا دیں۔	Nothing's the same, I'll say it's name.
2020 طب اور طبی ڈگری کورسز اور داخلہ کی ضروریات کو یہاں ملاحظہ کریں	Uses the hospital and teaching certification of 2020.
کارٹر کا کہنا تھا کہ یہ فورسز عراق اور کرد پیش مرگہ کے ساتھ مل کر کام کریں گے اور شام میں یکطرفہ کارروائی کی صلاحیت بھی رکھیں گے۔	"Carter said the ""specialized expeditionary targeting force"" will work with both Iraqi and Kurdish Peshmerga forces in Iraq, and be capable of unilateral action in Syria."
وہ دوڑ رہی تھیں	She continued running.
تُجھے خبر نہیں یہ آگ ایسی ہے	You know that fire.
جی جی بلکل۔۔۔ نیکی اور پوچھ پوچھ	- It's very good. oy to ask.
داود نے ماں کی بات کا جواب نہیں دیا..	David didn't listen to his mother.
کیا واقعی امریکی سپریم کورٹ نے ان بہن بھائیوں کو آپس میں شادی کی...	of U.S. grandparents are married.
نصف صدی سے زیادہ کا قصہ	cemetery over a half century.
نه، فقط فیس بوک.	It's only Facebook.
ان کا کہنا تھا کہ شام ایک ہفتے میں اپنے کیمیائی ہتھیاروں کے ذخائر کی فہرست فراہم کرے اور نومبر تک عالمی معائنہ کاروں کو رسائی دے۔ انہوں نے بتایا کہ شام کے تمام کیمیائی ہتھیار 2014 کے وسط تک تلف کرنے کا ہدف طے کیا گیا ہے۔	The framework called for Syria to submit a comprehensive list of its chemical weapons within one week; for inspectors to return to Syria by November 2013; and for the destruction of all chemical weapons by mid-2014.
پاکستان ایک نعمت ہے...	Pakistan is a gift.
ستر سال کے بعد۔ ہم نے کہاں جانا ہے	Seven years later, where do we stand?
رات کا کھانا:آپ رات کے کھانے میں کیا چاہتے ہو ، سوائے تیسرے دن کے (ابلا ہوا کیکڑے استعمال ہوسکتے ہیں) ۔	Dinner:what do you want from dinners, except the 3rd day (boiled crabs can be used).
آپ کو پتا ھے میں نے سب سے ذیادہ کسے یاد کیا ۔۔۔۔	Do you know what I remember the most?
انہوں نے 2003 قاہرہ میں منعقدہ ورلڈ چیمپیئن شپ میں چوتھی پوزیشن حاصل کی تھی اور ایک سال بعد کوالالمپور میں ایشین شوٹنگ چیمپیئن شپ میں سونے کا تمغہ جیتا تھا۔	In 2003 he finished 4th at the World Championship in Cairo, and a year later claimed gold at the Asian Shooting Championship in Kuala Lumpur.
رک رک ۔۔۔ رک جا ۔۔۔۔ مجھے معاف کردے ۔۔ میں جارہا ہوں ۔۔۔	excuses, and left.
چین دنیا کیساتھ کشادگی اور باہمی تعاون کے فروغ کےلئے پرعزم	to strengthen the capacity and willingness of China to work with the United
میرے علم میں آج یہ با ت آئی ہے ، بے حد خوبصورت	I received mine today, it's REALLY beautiful.
خاک ہوں، سرکار صلى الله عليه وسلم !	i'm ready boss!
آفتاب پرست: October 2011	In the Sun: October 2011
"""یہ کبھی ٹھنڈے نہیں ہونے چاہئیں۔ """	"may not be cold."""
افراد ديابتی تيپ 1	Internally displaced persons 1
""" یہ ایک حقیقت ہے -"""	'It is a reality.'
جب کہ سویڈن کے اعداد و شمار 2013کے مطابق:	According to data from 2019:
محبت کے موسم میں Prose Poetry میں محبت کے اس موسم میں مرنا چاھتا ہوں	In this season's preseason opener, Love suffered
آزادی ٹرین نے اپنے سفر کا آغاز کردیا	The college started its journey
اس کے علاوہ، جہاں تک ممکن ہو اپنے تجربے کا اندازہ لگائیں.	Also, try to get as much experience as possible.
Milfa وہ سزا دے رہا ہے ان کی بیٹی	Kemal kidnaps his daughter.
دھاریاں ، لکیریں ۔	dots, and lines.
کون استعمال کرسکتا ہے eToro?	Who can benefit from the EOT?
کمپنی نے آئی فون سے مقابلے کے لیے نئے ماڈل میں کیمرے اور بیٹری کو بہتر بنانے پر خصوصی کام کیا ہے	The company continued to improve the performance of the camera on these phones to compete with the newer iPhone and Pixel models.
XRT توسیعات کے لیے حقیقی وقت	Real-time extensions for Ethernet networks
میرے سمجھانے پر وہ جانے کے لیے راضی ہو گئیں.	She told me she was willing to go.
والی لڑکی ایک مکمل جوڑی ہوتی ہے ❤️	They're a complete couple.
علی تم نے اچھا نہیں کیا	Olly, you have done well.
کسی ٹیم کے ساتھ رہتے ہوئے صورتحال کے مطابق فوری طور پر حکمت عملی طے کرنا۔	Instant response to problems by working as a team with the guest.
ڪمے فڪر میڪنم:راجع بهش فڪر میڪنم.	Body of work: Eminem.
USB-C بندرگاہوں کی آمد - MacBook ایئر کی ترقی میں ایک یقین کے علاوہ ہے، لیکن میں ذاتی طور پر ایسڈی کارڈ ریڈر کی کمی محسوس کریں گے.	Appearance of USB-C ports is a definite plus in the development of the MacBook Air, but personally I will miss the SD card reader.
انہوں نے مزید کہا کہ اس میں بین الاقوامی انسانی حقوق کی تنظیموں کے 32 اور پاکستان کے 14 حوالہ جات بھی شامل ہیں۔	He added that it also contains 32 references to international human rights organisations and 14 references from Pakistan.
T: اوہ ، بہت اچھا ہے۔ کیٹی آپ کے بارے میں کیا خیال ہے؟	D.R.: Kate, what you're doing is really, really cool.
میں اس مقام عجیب یعنی	I am curious about this place.
سنو میری پیاری ، میری اچھی دوست	"""Listen, my good friend."
Garcinia کیمبویا کے معاملے میں، یہ آسانی سے overused کیا جا سکتا ہے اور بہت اچھی طرح سے منظم نہیں ہے.	(7) With regards to garcinia cambogia, it can easily be overused and is also not so well-regulated.
رپورٹ میں کہا گیا کہ مشرقی افریقہ میں موجودہ صورتحال انتہائی خطرناک ہے کیونکہ نئی نسل پیدا ہورہی ہے جس کی وجہ سے مزید ہجوم اکٹھے ہورہے ہیں اور شمالی اور وسطی کینیا، جنوبی ایتھوپیا اور ممکنہ طور پر صومالیہ کے علاقوں میں پختگی اختیار کر رہے ہیں۔	The current situation in East Africa, the report says, remains extremely alarming as yet another generation of breeding has occurred with more swarms forming and maturing in northern and central Kenya, southern Ethiopia and probably in Somalia.
'اگر آپ کی 40 سالہ پرانی چھت ہے تو ، کوئی مسئلہ ہوسکتا ہے - یہاں تک کہ اگر یہ زمین سے اچھی لگتی ہے۔'	If your roof is 40 years old, there could be a problem - even if it looks good from the ground.
میں ایک سے کسی موسم میں نہیں رہ سکتا	I couldn't live a day
تلنگانہ انتخابات میں تین خواتین کی دھوم	The Life of Women in the Six Dynasties
ایک جن آیا اور بولا تم سب کوئی چیز دریا میں پھینکو .	"There's an old saying: ""everything ends up in the ocean."""
41 اور وہ پھِر خُدا کو آزمانے لگے اور اُنہوں نے اِسرائیل کے قدوس کو ناراض کیا۔	They again challenged God, and offended the Holy One of Israel.
▼ اکتوبر (46)	October (64)
آپ کی گاڑی کے لیے ٹھنڈی گیجٹ	A great fridge for the car.
اس کو بچے کہ علاج اور دوا کے پیسے مل گۓ	He needed money for medication and treatment.
کیا یہ شروع ہی سے ایسا ہے ؟	Has it been this way since the beginning of time?
'۔ ۔ ۔ گاڑی کھل چکی ہے پاپا۔ ۔ ۔ میں صبح پہنچ رہی ہوں۔ ۔ ۔ '	"""The car is OK, we are OK, tomorrow morning we are coming to the start line."""
LAZIO کے بارے میں مزید معلومات۔	There is more information about Peter Lacy.
جیسے کہ بچوں کو اکیلے باہرنہ جانے دینا۔	On leaving the children alone.
جیکسن کی تازہ فلم 'آئی' ہندوستان میں بننے والے سب سے مہنگی فلم ہے۔	Jackson's latest movie, I, is the most expensive film ever made in India.
ورلڈ فوڈ پروگرام نے بتایا کہ افغانستان میں ایسے بحران شدت اختیار کر چکے ہیں جہاں لوگ بھوک مٹانے کے لیے اپنے بچوں کو بیچنے پر مجبور ہو گئے ہیں۔	The situation has become so bad that the poor people of Afghanistan are forced to sell their daughters to avoid starvation.
سلسلہ اچھا اور ٹھوس ہے۔ اور خدمت بہت ہی عمدہ ہے۔	The service is solid and service is excellent.
دنیا تجھے خود چھوڑ دے گی ایک دن	The world abandons you.
اب میں آتا ہوں تو چاند نظر آتی ہے	Now that I see the moon.
میں نے کچھ وقت کے گروپ میں پاپ کر سکتے ہیں, بھی!	I'll be on skype for a while, too!
آخر تھک ہار کر ہم ایک دوسرے پر گر پڑے اور میں	Finally exhausted we fell against each other.
کیسی بڑی تبدیلی ہے!	What a great changeup.
حسین امانت نے بھی انقلاب کے بعد ایران چھوڑ دیا تھا اور پھر کبھی واپس نہیں آئے۔	Mr Amanat also left Iran just after the revolution and has not returned since.
کیا تم کافی دنوں سے یہاں رہ رہے ہو؟  Bạ- s--- ở đ-- l-- c---?	"""How long have you been involved with the vi---um, Mr. Cooper?"""
"اور بتائیں آپ نے کیا سیکھا۔ ""*"	'Tell me what you've learned.'
کمپنی کے ہر ملازم سے اس بات کا تقاضا کرنا کہ اپنی ذات، دیگر افراد اور ماحول کے نقصان سے بچاؤ کو اپنی ذاتی ذمہ داری سمجھے۔	Require every employee to exercise personal responsibility in preventing harm to themselves, to others and to the environment.
ہم ایک اتھارٹی ، ایک قانون اور ایک بندوق کے بارے میں بات کررہے ہیں	About freedom, a license and a gun.
اوراسی طرح دیگروساوس کا جواب (تصدیق) میں کیوں نہیں دیا ؟؟؟	Also why don't you give return labels anymore????
دہائی ہے تبدیلی سرکار کی!	A Decade of Change.
"مشہور مقولہ ہے: ""الرّفق رأس الحکمہ""۔ نرم روی حکمت کی بنیاد ہے۔"	"Delitzsch - The beginning of wisdom is: ""Get wisdom."""
امریکی حمایت یافتہ افواج نے شام کے شمال مشرقی قصبے باغوز پر اپنے جنھڈے گاڑ دیے ہیں اور اعلان کیا ہے کہ داعش کے دہشت گرد گروپ کی خود ساختہ خلافت آخر کار دفن ہو چکی ہے۔	U.S.-backed forces raised their flag over the northeastern Syrian town of Baghuz and said the self-declared caliphate of the Islamic State terror group was finally dead.
"""نہیں نہیں، کھانا کمرے میں ہی۔ """	"""Not in the file room."""
خوبصورت لڑکیوں کی ویڈیو محبت کرتا ہے۔ - Xvideos.com	friends who love each other - XVIDEOS.COM
۵۔ اور یہ مستقبل کے ساتھ بھی ایک رشتہ بناتی ہے	This exhibition also makes a connection to the future.
"کل سے بھوکا ہوں۔۔۔"" اس نے پھر صدا لگائی۔۔"	earlier that morning, he was hungry again.
سوال: آپ کے دونوں انسپکٹر ساتھیوں کا کیا ہوا؟ جو ابی سے آپ کے ساتھ ملنے گئے تھے ؟	Q: What happened to the other worshipers who were with you?
دیکھو !تم ناواقف رہی کہ جہالت اور پسماندگی ہی تہذیب کے سب سے بڑے دشمن ہیں.	Hunger and insecurity are the worst enemies of peace.
ہم تو سب کا مطالعہ کرتے ہیں یہی میرے والد کی نصیحت ہے	All this is my memory of my dad.
ارے نہیں ....تم شاید کہیں جارہے تھے ....؟	Oh fuck, where did you go?
اس بار حزب اختلاف نے بی جے پی کے خلاف مسلمانوں کے ووٹ حاصل کرنے کے لئے پورا زور لگا دیا .	This time around, the Church appealed to people not to vote for the BJP.
کسی کی بھی جان و مال عزت محفوظ نہیں.	No one's life is safe.
انسان، ایک پیچیدہ مشین	A complex machine.
خُداوند کے فضل نے اُسے خوفزدہ کر دیا تھا!	the Lord's compassion is on those who fear him.
س:موت سے ڈر لگتا ہے؟	CD: Are you afraid of death?
کم از کم یہ تو نہ ہوتا	At least, it wouldn't.
ہاں جی تو ایک برس قبل کیا گیا تجزیہ درست ثابت ہوا یا نہیں ؟	There was a study that came out a year or so ago?
انہوں نے کہا کہ براہ کرم بہت محتاط رہیں۔ نئی لہر تیزی سے پھیلتی ہے اور زیادہ جان لیوا ہے۔	Please wait for the new version, which should be faster.
وہ بس اسے جیتنے پر خوش تھا ۔۔	He was just happy that he won.
"٭ لفظ "" اِیْمَان "" 25دفعہ اورلفظ "" کُفْر "" بھی اتنی مرتبہ ہی استعمال ہوا ہے۔"	In this chapter, 'had' was used 25 times.
ابن رجب حنبلی کہتے ہیں کہ یہ حدیث درست نہیں.	Ms Berejiklian says that is not the case.
آپ نہ صرف ہمارے استاد ہیں بلکہ آپ ہمارے دوست ، اتھارٹی ، اور رہنما بھی ہیں ، سب ایک ہی شخص میں پائے جاتے ہیں۔ ہم آپ کے تعاون اور مہربانی کے لئے ہمیشہ آپ کا مشکور ہوں گے۔	you are not only our teacher, but also our friend, philosopher and guide, all molded into one person. we will always be grateful for your support.
میں اگر عدل نہ کروں تو اور کون کرے گا!	If I don't speak out, who else gonna do it?
اس وقت آسٹریلوی ہسپتالوں کو ہر علاج کے لئے ایک مقررہ قیمت پر فنڈز مختص کیے گئے ہیں.	Heretofore, hospitals were reimbursed for all reasonable charges.
غُصہ میں نصیحت کرنے والا زہر لگتا ہے	(This one comes with a warning that it may cause stomach upset.)
انھوں نے کہا کہ اگر سکھ باشندے اپنی پیدائش کے مقامات میں بھی محفوظ نہ ہوں تو پھر وہ کہاں جائیں یہ ملک چھوڑ دیں یا کیا کریں۔	"said: ""If it was not grown in the field or fished out of the"
'مجھے پہلی بار اپنے نام کی وجہ سے ڈر لگا'	"""I grieve to say that I hear his name for the first time."""
