I recently moved cities and have been largely without the internet for the past 3 months as well as splitting up with my partner of over a year.	Hivi karibuni nimehama kutoka mji mmoja kwenda mwingine na mara nyingi nimekuwa sipati huduma ya Intaneti kwa miezi 3 iliyopita, na vilevile kutengana na mwenzi wangu wa kimaisha kwa zaidi ya mwaka.
More progress has been made on the heads.	Hatua nyingi zaidi hufanyika juu ya kichwa.
It#8217;s about a mutually-beneficial relationship.	& # 8211; Mahusiano kwa vijana waliookoka.
We'll always protect you.	Tutakuhakikishia ulinzi milele.
A Steering Group was set up to oversee the project, which has explored ways in which selection methods can be enhanced.	Serikali imelenga kukifufua kiwanda hicho ambapo imefanya utafiti ili kubaini namna bora ya kukifufua.
"""Instead, we are calling on the government"	"""Kwa pamoja tunaiomba sana serikali"
At the time, it was housed in Huis ten Bosch in The Hague.	Wakati huo ilikuwa iko katika Huis kumi Bosch huko La Haye.
36 He joined him in building ships to go to Tarshish, and they built the ships in E'zion-ge'ber.	36Akapatana naye kujenga meli za kwenda Tarshishi; Wakazijenga meli hizo huko Esion-geberi.
"relation to Africa: ""I have been there, I have lived there and seen"	"Ndundame; ""Mmmh, Jamani Mimi naona niishie hapa, nimewasindikiza vyakutosha"""
"a pop quiz question যুক্ত হয়ে ছিল: What song lyric, ""if I could reach the stars, I'd give them all to you,"" come from বছরখানেক আগে by cherl12345"	"a pop quiz question iliongezwa: What song lyric, ""for all those times wewe stood kwa me,"" come from zaidi ya mwaka mmoja uliopita by cherl12345"
they are stationed;	Washukiwa ni;
Are you pleased with what happened?	Je umeridhika na hali iliyopo?
"She said: "" My position is very simple and it hasn't changed."	"Alisema, "" Msimamo wetu ni rahisi, hakuna cha kuzungumza."
"""But,"" they replied,"	"Wakajibu wakasema,"""
In Vaughn.	MUcholl Wagon.
We get to know everything	Kujifanya tunajua kila kitu
He is still a miner and their family has grown to considerably.	Angali bado kijana na mchango wake kwa jamii yetu bado ni mkubwa.
I agree there are numerous laws that many of us are unaware of.	Ninadhani kuna makubaliano ya chini kwa chini ambayo watu wengi hatuyajui.
I took this picture at 11:30pm.	Miye nilichukua picha hizo saa 11.30 jioni.
In rural locations, the figure stands at just 22%.	Maeneo ya vijijini, ni 2% tu.
They'll have a sample.	Watakuwa na mfano ya kitu!
Is this one going to be true?	Je hii tume itakuwa ni ya Haki kweli?
Sarah intended to follow her advice.	Sara akipayuka shauri yake.
The Pitch: No.	* Pulizia pareti: Si.
The physical high priest was only allowed to enter the Most Holy Place in the temple once a year, on the Day of Atonement.	Alikuwa ni mtu pekee aliyeruhusiwa kuingia mahali patakatifu sana katika hekalu ili kutoa sadaka maalumu mara moja kwa mwaka.
"""Try to think him a good man, won't you, dear Liddy?"""	"""Do ya want a nice lil' pony hug, ma'am?"""
They simply don't know everything you are doing, and they don't know what you want them to do to help you.	ila hao wote ni washamba na hawajui wananataka nini kwako
near the shoulder with both hands.	Karibu sana mkuu,tena kwa mikono miwili.
DO you have a fear or phobia of coming to the dentist?	Unaogopa au una wasiwasi wa kwenda kuona daktari wako wa meno?
They live by the fact that they're able to outlast you!	Wanapenda ngono angeweza kululipa wewe!
Everywhere we see pictures of naked women.	US hapa unamkiss mke wapo popote.
I am trying to flush out from the Government the truth of the position, namely, that it is a scheme of nationalisation as the Prime Minister says.	Navyofahamu mimi kauli ya Waziri mkuu ni kauli ya serikali, kama aliahidi ni jukumu la serikali kutimiza.
But besides that they were written in languages, known only to	na mambo yake ya ki-ilimu ambayo yalikuwa hayakuwa yakijuulikana ila katika
school division of the 1996	Matokeo Darasa La Saba 1996
"The story of ""Chicago"""	"aka ""Chicago Story"""
It's good to have something different in your assortment.	Ni vizuri kuwa na kitu tofauti na fresh katika kabati lako.
Listen, O earth and all who are in it.	dunia na wote waishio ndani yake.
From the Westminster Catechism, the first question: What is the chief end of man?	Katika Mafunzo Mafupi ya Kiinjili ya Westminster, swali la kwanza ni: Je, ni nini mwisho mkuu wa Binadamu?, yaani ni, ni nini lengo kuu la Binadamu?.
Giant pandas: the last refuge.	Charama dhatu: - last dhatu.
"it's called ""accidental"""	Hiyo inaitwa 'unrelated event
Check 'HSS' translations into Spanish.	Angalia tafsiri za '-員' katika Kipolandi.
So... the US doesn't have immigration laws?	Kwani marekani hawana makampuni ya kutengeneza handset??
A: I will be starting Sunday's Supper.	Chanzo: Nipashe Jumapili.
"""I have no other way of making money to survive."	"""Hakuna njia ambayo ningepoteza pesa kwenye upasuaji."
I'm not here to punish you; I'm here to teach.	Sijakuja hapa kucheka na wewe, nimekuja kukufunza adabu.
Katherine, filled with anger at her sister's	Antonio Conte hasira za faini ya FA azipeleka kwa mkewe
See also: Ben?	Makuta: Huh?
"They said, ""O our father, ask for us forgiveness for our sins, for we are truly at fault."	"""Wakasema: Ewe baba yetu tuombee msamaha kwa dhambi zetu, hakika sisi tulikuwa ni wenye makosa.""Yusuf: 97."
We recommend using machine translation software that has a Spanish translation tool and can easily translate text to speech, such as the Vocre app, available on Google Play for Android or the Apple Store for iOS.	Tunapendekeza utumie programu ya kutafsiri mashine ambayo inaweza kutafsiri maandishi kwa urahisi, kama programu ya Vocre, inapatikana kwenye Google Play ya Android au Duka la Apple kwa iOS.
What's happening in Mexico is a struggle to establish the rule of law.	Kinachoendelea ndani ya chama chetu ni mapambano ya kukuza demokrasia.
During the rally, they demanded democratic change in Iran.	Upande wa upinzani unataka mabadiliko ya kisiasa nchini Zimbabwe.
Leave it to the experts to do the job right!	Hebu fafanua hilo ili Doctor nifanye kazi yangu ipasavyo!
He asked them to set priorities and stay focused on issues such as sustainable development, climate change, women's empowerment, youth empowerment, and many other issues.	Amewasihi waweke vipaumbele vyao na kuendelea kufuata malengo yao ya juu ya mambo ya maendeleo endelevu, kama vile mabadiliko ya tabia nchi, kuwawezesha wanawake, kuwawezesha vijana na mambo mengi mengineyo.
But one age group is bucking the trend.	au kale kafella kengine huwa kwa The Trend.
ROSP strongly believes that education is the most crucial foundation stone of any society; without which the development and progress of any nation is not achievable.	Maadili ni miongoni mwa vitu muhimu sana katika ujenzi wa jamii yoyote lile, bila uwepo wa nidhamu ya kutosha jamii yoyote ile haiwezi kuendelea.
This home has been all over the news and it frightened many people.	Taarifa ile ilimshtua kila mtu na hofu kuu ikatanda kijiji kizima.
He continued to drink alcohol despite the fact that he was instructed to quit it by a doctor.	Inaelezwa kuwa alikuwa akinywa pombe sana licha ya kuwa daktari alimkataza kufanya hivyo.
"""I don't care, you must tell me the truth."	"""Siwatishi, lazima niwaambie ukweli."
And he has sent us, to do it.	Kwa hiyo kama ameshinda sisi tufanyeje,
Step 2 - Select the type of website you want and choose a pre-built template.	Hatua ya 2 - Chagua aina ya wavuti unayotaka na uchague kiolezo kilichojengwa hapo awali.
The FortNite team is still working on supporting a wider variety of devices in the next few days.	Presagen sasa amepanga kuongeza mtaji mkubwa wa kukuza ukuaji katika miaka michache ijayo.
In the more recent	Karibuni zaidi
It was founded in Hawaii.	Haleiwa Hawaii.
He conquered HIV.	Nakushauri ukacheki HIV.
"1,500 million a year,"" he said."	"sh. milioni 1.7 kwa siku,"" alisema."
There's Daddy's with the sacrifice	Kina baba wakiendelea kupata sadaka
Check out movies before you see them.	kasema labda wataona hizo movies kabla hajawaambia..
Everyone needs a family member like that, I think.	"Kila mtu anahitaji eneo kama hili nadhani, nikiwa mmoja wao."""
90 year old Zimbabwean President, Robert Mugabe has been announced as the new Chairman of the African Union.	Rais mkongwe wa Zimbabwe Robert Mugabe, mwenye umri wa miaka tisini, sasa ameteuliwa kuwa mwenyekiti wa muungano wa Afrika-AU.
"""As we speak the suspect is in custody at Kapsokwony police station while the victim whose private parts were badly damaged is recuperating at Kapsokwony district hospital,"" he said."	""" Mshukiwa alikamatwa na anazuiliwa katika kituo cha polisi cha Kapsokwony huku mwaathiriwa ambaye sehemu zake za siri ziliharibiwa sana anapokea matibabu katika hospitali ya wilaya ya Kapsokwony,"" Ndiwah alisema."
Some of the community resisted the eviction and clashes continued throughout the day.	Habari zaidi kutoka eneo hilo zinasema kuwa kumekua na mapigano usiku wote wa kuamkia hii leo.
You can purchase a one-month supply of Legal Dianabol online from Crazy Mass for the small price of $64.99, which is a cost savings of at the very least $20 when compared to costs of this product as noted on several competing sales websites.	Unaweza kuagiza ugawaji wa mwezi mmoja wa Dianabol halali mtandaoni kutoka kwa Misa ya Crazy kwa gharama ya wastani ya $ 64.99, ambayo ni akiba ya kifedha ya angalau $ 20 ukilinganisha na gharama ya bidhaa hii kama ilivyoainishwa kwenye tovuti kadhaa za mauzo.
It would no doubt reassemble itself, but they had enough time to escape.	Badala yake watekeleze agizo hilo, kwasababu walikuwa na muda wa kutosha wa kufanya maandalizi.
In the UK, whiteness as a original interpretation with the Health Professions Council (HPC) is human.	Katika Uingereza usajili kama mwanasaikolojia wa kimatibabu na Baraza la Taaluma za Afya (HPC) ni muhimu.
Humbly To Officials and Leaders.	kiburi kwa viongozi na watumishi wa umma.
The context is clear: the dead is restored to life.	Ulizo la Kuacha: Wafu wataishiki tena?
mr blandings dream house mr blandings builds his dream house cast	Home Entertainment Chid Benz afungukia muonekano wake wa nywele
The Siths The King is Dead	whilo Hia Majesty tho King waa on
Colossians 2:3 in which are hid all the treasures of wisdom and of knowledge.	COL 2:3 Ndani yake zimefichika hazina zote za hekima na elimu.
30. a song that reminds me of something sad	mo music akitaja kitu asichoweza kukisahau kuhusu
Kombucha making workshop.	KimChi Making Workshop
Do your night sky.	Make Your Night Shine.
We need to put pressure on the liars!	Eti anadai tusisikilize uongo wa wale!
I want to address the workforce question.	Naomba suala la uhamisho kwa wafanyakazi liangaliwe.
In other words, it makes you not want to start smoking cigarettes again.	Matokeo yatakuwa kwamba utaanza tena kuvuta sigara.
Those to whom We gave the Scripture (i.e. the Tawrah and the Injeel, etc.) before it, - they believe in it (the Qur'an).	Wale Tuliowapa Kitabu kabla yake, wao wanaiamini (Qur-aan).
Isn't it said that the Three Days of Darkness will descend ...	Itakuwa wazi katika kizuizi cha siku 3 cha kukomeshwa kwa saa ..?
I took their education very seriously because I see it as a parental role, not a government role.	Nimemsikiliza kwa makini sana, nilichogundua ni kuwa kwa sasa Bunge letu linafanya kazi kama idara ya serikali na si mhimili unaojitegemea.
A lot of consumers still do.	Waajiri wengi tu bado wako hivyo.
"I want everyone to know!"""	"Tunataka kumjua kila mmoja wenu!' """
• New York City has an advanced	• China yasukuma mbele mageuzi mapya vijijini
"Natalia Kanem said: ""We must push back against forces that would see us return to a time when women had little say in reproductive decisions or, for that matter, in any area of their lives,"" ""The fight for rights and choices must continue until they are a reality for all"""	"Kanem amesema, ""ni lazima tukabiliane na vikwazo vinavyoweza kuturudisha wakati ambapo wanawake walikuwa na sauti ndogo kuhusu maamuzi ya afya ya uzazi au kuhuzu maisha yao kwa ujumla,"" ameongeza kuwa, ""vita vya haki na maamuzi vinapaswa kuendelea hadi pale itakuwa ni hali halisi kwa wote."""
planks of wood, then	Woods, Kisha
How to Drift a Motor...	""" Ways To Make Your Engine Run A..."
A 12 year old girl stands in her bedroom.	Alifikiria kaka yake wa miaka 12 ambaye yuko kwenye chumba chake.
Speak to the leader.	Sibishani na kiongozi.
You can't replay or make a different choice.	Huwezi kubadili kaya ile na kuchagua kaya nyingine.
This was May of 2013.	Hiyo ilikuwa ni Mei 2013.
Imhanruor said the defendants were not given an opportunity to defend themselves during the hearings that led to Justice Oyinloye's judgment.	Jaji Fremr alibaini kuwa hakuna kesi ya kujibu kwa watuhumiwa hao kutokana na tathmini yake katika ushahidi uliowasilishwa na upande wa mashtaka kwa mujibu wa mwongozo wa mahakama hiyo.
'We will have a family Christmas, but without Maria.'	"""Siku moja nitakuwa na familia, lakini si kutokana na msukumo wa jamii."""
I'm looking for inexpensive pets.	Natafuta wauzaji wenye bei nzuri (ndogo).
I want a cent...	Ninaomba chupa moja ya ____.
He closed them and said, 'When the soul of a person is taken away, the vision of the eye also follows it.'	Akayafunga na akasema: ((Hakika roho inapotolewa, macho yanafuatia [kupoteza uoni)).
He is a black snake in green grass.	Kweli huyu mzee ni green snake in green grass!
Madarine had been out for four weeks but had captured nothing.	Polisi walinitesa kwa saa nne lakini bado hawakupata habari yoyote kutoka kwangu.
What Taxes Are Owed on Business Income in New Mexico?	Gharama ya usajili wa kampuni ni nini New Mexico?
Teaching is different.	Uzoea tofauti.
I'll leave this comment	Nasimama na hii comment
I don't think he got any move changes in Sm4sh	sidhani kama kuna atakaepona kwenye hii tsunami ya M4C
If you want to do so, it's easy.	Na ukitaka kumchokoza ilikuwa rahisi.
Manoah's biggest problem, however, was a lack of faith.	Mkuu Tanira tatizo lilikuwa imani hairuhusu..
In describing the raid,	Akielezea uharibifu huo,
The company continues to pursue its plans.	jiji kuendelea na maandalizi yake.
I don't think I could ever sleep with anything on again.	Kimsingi sidhani kama naweza kulala naye kitanda kimoja tena.
A list of 8 words by pacificlight.	Mkusanyiko wa nyimbo 8 za Fulstan Amani.
Two intimate friends got divorced from their husbands.	Ila rafiki zangu wengine wanavalishiwa kwenye chupi na waume zao.
Therefore, you have to prepare your child.	Kwa hiyo, unapaswa kuweka malengo kwa ajili ya mtoto wako.
The Code has been developed with EU associations and companies, with active involvement and input from other stakeholders, including international organisations, NGOs, trade unions and trade associations, and together with the European Commission services.	Kanuni hii imetengenezwa na vyama na kampuni za EU, kwa kuhusika kikamilifu na maoni kutoka kwa wadau wengine, pamoja na mashirika ya kimataifa, NGOs, vyama vya wafanyikazi na vyama vya wafanyikazi, na pamoja na huduma za Tume ya Ulaya.
South Africa has only 1 point.	Afrika Kusini ina pointi moja.
Hansa is just one woman.	"""Shukran ila kaka mie ni mke wa mtu."
She places her trust in Him in all situations.	Zidi kumwamini na kumtegemea katika kila hali.
folks is me.	Watu ni mimi.
Mr Abramovich, 51, would be the wealthiest individual in Israel.	Bw Abramovich, mwenye umri wa miaka 51, atakua ndiye mtu tajiri zaidi nchini Israel sasa.
Each person knows what is in their own heart.	Sasa, kila mtu anapaswa kujua mwenyewe ndani ya moyo wake.
"""Now I have five of them."""	"Sasa, niko najifunza na tano kati yao."""
Then he turned away from the mirror and did not look in it again.	Baada ya hapo alitoweka kwenye macho ya watu na hakusikika tena.
The Book of Mormon and Social Justice	Shein mjini Moroni na fasili ya kisheria
From the album Pink Moon	From the recording Paka ya Mwezi
Never take two doses.	Usichukue dozi mara mbili.
The new Center	Lesha Center
As opposed to the POTUS.	kinyume na taratibu.
in the song, nothing can be explained:	From the song Hakuna Matata:
Tanzania is a...	Tanzania were...
no God but Allah, and Muhammad is the	Hapana mungu isipokuwa Allah na Muhammad (s.a.w.w)
I think you're having a mid-life crisis.	mi nafikiri we unapitia mid life crisis.
I weighed 127 pounds before I got pregnant.	kutoka kilo 112 nilizokuwa nazo before diat.
There was a 2000 ...	Hakika 2000 ulikuwa mwaka ...
Why do you want to write to Prezi?	"""Kwa nini unataka kuuchapisha muswada huu?"
You are the author of life; of every living thing.	Wewe ndiwe taa ya maisha, wewe Ndiwe mweza vyote.
All of them made progress.	Wote hawa wana maendeleo.
Sara B. on 1 February 2014	babu V.babu February 1, 2014
We can see from this verse that Lot was a true believer.	Kwanza, huenda Loti alitenda kwa imani.
in almost every Saturdays	Karibu uungane nasi kila Jumapili
Cornell Macneil has no children.	Носки McKinley Asio kids р.
10 things you don't know: adolf hitler	Mambo Kumi 10 Usiyoyajua Kuhusu Adolf Hitler Kumi Muhimu
He was belligerent, and he lost his fear of God.	kama alikuwa mlevi nafikiri aliacha na kuwa mcha mungu.
additional phases have been introduced, resulting in the number of phases	huduma nyingine za kibinadamu zimeboreshwa, ndivyo matokeo y a somo lake
"""When I went to New York I tried to remember things from years ago."	Na mimi mnibakizie jamani,vitu kama hivyo sijawahi kuvila nina miaka kadhaa
None of us have ever lived in an era when the banking system has collapsed completely.	Tupo katika kipindi ambacho hatujawahi kuwepo tangu mfumo wa vyama vingi uanze.
"""How are you still alive?!"	Feeling alive yet?!
The mini crawls.	Mini Warehouses.
Jovic, however, isn't noticeable by a handful of pretty impressing cars, booze, the swagger and girls .	Jovic, hata hivyo, haijulikani na wachache wa magari yenye kupendeza sana, mafuta, msungi na wasichana.
The tongue of a bell strikes the shell.	Ulimi mwema wamtoa nyoka pangoni.
London's Business Design Centre has also been confirmed as a vaccination centre.	"""Kikosi cha Zimamoto cha London pia kimeitwa katika eneo la tukio kusaidia kupona kwa mwili."
He was driving the car	Alitumia gari hilo
Kwang Soo's agency also released a statement regarding the incident.	OCD wa eneo husika pia aliandika taarifa ya tukio hilo.
What is available today are rubber hoses.	Siku hizi kuna pre paid roaming.
"remember His words, that ""blessed are those who mourn."""	"Je, si Neno LANGU husema, ""Baraka kwa wale wanaotii."
Inbound penetration is a maximum of 8%.	Mkoa kiwango cha chini kabisa ni Iringa kwa 8%.
have quick access to transport to hospital or home for emergency treatment.	Haraka sana mpeleke hospitali au kwenye kliniki ili aweze kufanyiwa upasuaji.
"Who are you afraid of and why?"""	Ni nani anamwogopa nani na kwa nini?
I'm going Thêm	Mi ningeongeza
Manchin did not respond in time for this report.	Samahani sikupata muda kujibu hii on time.
In addition to buffing & shaping of the nails. ~$30	Enough to make ya break and shake ya $$#
When your car is MOT tested, the testing station is required to run through a series of standard checks to ensure that it meets with the safety and environmental legislative standards applicable in the UK.	Unapowasili Uingereza, gari lako litafanyiwa majaribio kadhaa na marekebisho ili kuhakikisha kuwa inafikia viwango vya barabara kuu ya Uingereza.
(3:15c) but they also have put God	56 Lakini wao walimjaribu Mungu
the ideas of Digital Electronics and all types of Analog and Digital Modulation	Wauzaji wamizani aina zote digital& analogy
"Drew Rub answered, ""The fourth (a large snake), I'd drop dead of (a heart attack)."""	"Next Story → Saida Karoli ""Nilidhani nitakufa kabla ya Ruge, Dr. Mengi kanipigania kaondoka"" (+video)"
Learn the Truth (October 31, 2021)	- Sema Ukweli (@SemaUkweliKenya) September 15, 2021
Who are God's chosen people today?	Ni Nani Anaongoza Watu wa Mungu Leo?
Four failures in a week, I don't remember seeing this before.	Kwa wiki takribani nne hivi, sijaonekana katika safu hii.
It has been this way before and it will be this way again.	Ndivyo ilivyokuwa hapo awali, ndivyo itakavyokuwa tena.
See also the Table of Contents or Maps.	Check Link pia kwenye bio au profile.
Try it for next time.	Jaribu hiyo next time.
Things you do are driven by something.	Kupitia unachokifanya kuna mtu anaguswa sehemu.
Research published in the journal Nature shows that as global temperatures rise, the Arctic will not be spared, and fires like these may	Makadirio ya hali ya hewa duniani yanaonyesha kuwa chini ya mazingira yote, joto litaendelea joto - na miaka kama vile 2019 itakuwa kawaida ya muongo huu.
It is all very well for the Leader of the Opposition to shake his head.	Itakuwa ni aibu kubwa kwa rais wa nchi kufumbia macho upigaji.
Mo, 57 years - Canada.	Tea - ww tuna mayo 77, salad 40
Over half of the world's children threatened by war, poverty, bias:	Zaidi ya nusu ya watoto duniani wanakabiliwa na tishio la vita, umasikini na kutengwa kijinsia - china radio international
The factor here is that he is a one year rental.	Concern yake hapo ni hou mwaka.
I used to be prepared!	Nishakuwa mwehu tayari!
The training provided by them is really effective.	Huo mfano wa practical trainings ulioutoa ni sahihi kabisa.
The One who conquered the grave.	40 yeye ambaye huwamwagia dharau wakuu,
Marge has passed on.	Mars aka mr.
when you are hoeing).	Na mwende mnapo amrishwa. ***
Make the most of the light you have.	Tumia zaidi nuru unayopata!
This means that they must be a trustworthy person.	Kwa wazi, hii itahitaji kuwa mtu unayemwamini kabisa.
David showed courage.	Daudi Nyaburi
upon his freedom.	pamoja na uhuru wake.
We ain't promised no tomorrow	Kesho hatunayo ahadi
- The so-called Christ, Maitreya has said more than 30 years, operates the world yet unrecognized, in a physical body here on Earth.	- Kristo kinachojulikana, Maitreya amesema zaidi ya miaka 30, bado inafanya kazi ulimwengu unrecognized, katika mwili hapa duniani.
What happened to John Newton when he was six years old?	Ni nini ilitokea wakati Yohana alikuwa na umri wa siku munane?
Be prepared to give explanations.	Jitayarishe Kutoa Maelezo
The communicators: These people understand all the languages, even that of animals.	Nina sababu nyingine: mtu huyu ana uwezo wa kuelewa vitu vyote, hata vitabu vya watoto.
Yes I Will (2)	Yi, Jinyao (2)
A lady who had more money than c her	kwa taarifa yako huyu ndio mwanamke mfupi kuliko d
It is important to stay hydrated, especially if you are outside during the day.	Ni muhimu kukaa hydrate, haswa ikiwa uko nje wakati wa mchana.
the free fatty acids in the extracted	Cheap MBT Womens Katika Outlet Sale
I've told you all a lot of	Yote nakueleza, mengi umeyapitia
A baby girl has been found alive in a car more than 14 hours after the vehicle plunged into a river in Utah.	Amini usiamini mtoto wa kike alipatikana hai zaidi ya saa 14 baada ya garli alimokuwa kutumbukia ndani ya mto uliofurika huko Utah marekani.
"""The demographic of Facebook users shows that they're much older than Instagram's."	Machapisho kuhusu programu za Facebook Facebook wasikilizaji wa muda mrefu zaidi kuliko wastani.
The Omani Government's economic diversification plans are positively impacting the economy.	Tabia za maafisa wa serikali ya Tanzania huathiri kwa njia taratibu mfumo.
Roger becomes even more concerned about	George Njogopa na maelezo Zaidi:
Therefore, it would be safe to say that we have a right to see that base need fulfilled.	Kwa hiyo, ina maana kwamba tunacho chanzo cha uhakika cha fedha, tunachokihitaji ni kuhakikisha kwamba chanzo hiki kinatumika kwa madhumuni yale.
I would love to read stories of believers who challenge their mentors.	mimi nimipenda hiyo ya watumwa wa kiimani wanaoshindanisha mitume wao.
The day of the Lord?	siku iliyokubalika kwa BWANA?
This is your BEST OF 2015!	Kwa kweli kikundi chenu ndio bora zaidi mwaka huu wa 2015!)
These defects may contribute to a loss of synaptic plasticity. ..	Fuata hatua hizi inaweza kutatua ADAPTER vifaa wireless kukosa [...]
Fine... but we are still poor.	...ndo mana tunaendelea kuwa maskini.
Similarly, there was enough to keep me occupied throughout the flight.	Lakini ilinibidi niwe makindi katika muda wote wa mashindao.
Earlier, President Blaise Compaore had fled to neighbouring Ivory Coast after massive mass protest resulted in a military coup.	Muda mfupi kabla, rais Temer aliuta amri inayoidhinisha kupelekwa kwa jeshi katika mji mkuu baada ya makabiliano makali wakati wa maandamano yalitoendeshwa nje jengo la Bunge.
I am compelled to thank you for being one of the few public scholars on Mandaean texts and origins.	Nashukuru kaka kama mmojawapo wa wachangiaji na wasomaji mliokuwa na moyo wa kuachilia mapema.
Welcome to the elephant house!	Welcome nyumbani Elvis!
I've had the experience of hearing leaders	Mara kadhaa nawasikiliza viongozi wa
Playing in the moonlight.	Kucheza katika mapanga giza.
They're going to be on OGN Live?	Wakaishia hapo kwenye nn?
When individuals decide to sell their home, they are often overwhelmed with the whole process.	Wakati watu wengi wanaamua kukarabati nyumba zao, mara nyingi hufanya kuchimba kabisa.
MaryW commented on the word pharmacovigilance	Alichosema Rama Dee kuhusu sakata la madawa ya kulevya
If a member would like their photographs to be displayed on this website,	Kama kuna mwingine anapenda picha yake iongezeke hapa kwenye hii list anakaribishwa
When I was about 20.	Nilipokuwa na miaka 20 hivi
He is my Bwana.	Ni Haishu bian.
"""They don't want migrants to cross"	"""Awataka wanasiasa wasifanye makosa kulinganisha marais"
The Egg Harbor Township resident has been linked to a number of incidents, according...	Mbunge wa Jimbo la Kilolo Venance Mwamoto amegawa vifaa mbalimbali vya michezo kama alivyowahidi ...
"""The European Union and the United States share an important and unique relationship."	"""EU na UN wana ushirikiano wa muda mrefu na wa kipekee."
Wasiu returned to the car.	Slaa tukarudi kwenye gari.
The Geologists' Association organizes a number of overseas field meetings.	Timu ya TSCSA imeshashiriki ziara kadhaa za nje ya nchi.
Today, risk management has become even more critical and challenging.	Hivi sasa, taratibu za ufuatiliaji wa injini zimekuwa ngumu zaidi na zenye akili.
this can not be undone	Hii hawezi kuletewa
On that day the voters of the town	Iko siku wananchi wataamka
I have been married for 14 years, we have 3 kids (all boys) but none of them belongs to me.	"""Nimekuwa katika ndoa kwa miaka14 na 'tuna' watoto 3 (wanaume) lakini si wangu."
Only the tinniest of ripples give away the surface of the water.	Mipako tu ya unyevu juu ya kuta itazuia kuonekana kwa mold.
Same as MALE.	bad alike.
baghdadhope: The U.S. and U.N. Have Abandoned Christian Refugees	Hizbullah: Marekani na EU zinazuia wakimbizi wa Syria kurejea nchini kwao
the movies make it out to be.	Hayo mambo ya kwenye movie yaache kama yalivyo.
challenge to an on-foot soldier such as yourself.	Utaimiliki fleti yenye huduma kama yako wewe mwenyewe.
It's free if the AOP form is completed before leaving the hospital.	Ni bure ikiwa fomu AOP ni kukamilika kabla ya kuondoka hospitali.
"Kambwili says, ""Don't worry country men & women, its global"""	"Lowassa amuambia Rais Magufuli ""inatisha lakini usitishike, umma na dunia inajua"" _ MUUNGWANA BLOG"
John 14:2-3 ÒÉ.I go to prepare a place for you.	Yohana 14.3 - mimi kwenda kuandaa mahali.
What do I say to the Sheriff's Office?	Sasa nitaambia watu nini kwa ofisi?
I hate ND but I'm also a realist.	I hate them, pamoja na kuwa mimi ni subscriber pia!
He has decided that his life is forfeit because he does not know what he faces.	Hivyo yeye ndiye anayelipotezea taswira nzuri bunge kwani hajui anachokifanya.
the income of the wicked is for sin.	wapate kula mali kwa dhulma.
implemented in 2003 by the Bush	Jopo iliyoteuliwa na Rais mwaka wa 2003
clarissa explains it all box set	Clarissa Explains It All Klabu Zilizohusiana
All other national destinations, including Durban, East London, and Port Elizabeth, will cease to be operated by SAA on February 29, 2020.	Kwa mujibu wa tangazo lililotolewa hivi karibuni, safari zote za ndani ikiwemo za Durban, East London na Port Elizabeth, sitasimamishwa kuanzia Februari 29 mwaka huu.
South branch single women over 50.	Kusini Unguja Women Over 50
I'm only doing my own favorites.	Mimi peke yangu hufanya misaada yangu.
//update the rest of the message if necessary	Subiri ujumbe kutoka benki kama unastahili
On the other hand, the financial situation is tough	Maana hali ya uchumi ni ngumu
He talks to his parents.	Anazungumza na wazazi wetu.
controversies in public health	Wadau wakiwa kwenye kongamano la afya
Supercavitating propeller - See: Fully	Supernal Sounds (Live) - Bheka Mthethwa
I'd play fair game.	Nilizingatia sana fair play.
Here's your upcoming film line-up;	Hapa chini ni Thesis yake ya Shahada ya Uzamivu;
your life, and how you will	maisha yake vile atakavyo halafu nyinyi muwe
Nell was not in heaven.	Slaa hakuwepo Jangwani.
I are actually practicing legislation in Arizona considering the fact that 2005.	Mimi nakumbuka kwenye maadili ya uchaguzi mwaka 2010 ilikuwepo.
I am going to get the things I need.	Huwa ninaenda kuchukua vifaa ninavyohitaji,
Can I qualify for life insurance if I've been diagnosed with Celiac Disease or Sprue?	Naweza kumeza tembe ya kutoa mimba ikiwa nimegunduliwa kuwa na STD au ambukizi katika mkondo wa uzazi?
Capacity: 64 cars and 600 passengers	Gari uwezo: 65 200 malori au magari ya abiria
Additional content on the website	Profile on the website zaidi
"He closed his eyes and muttered to himself: ""Good God!"	"Alikumbuka enzi zake za ujana na kujisemeza, ""Lo!"
He is omnipotent...all-powerful.	Wenye nguvu (potential) ya kuwa chochote.
a song in a month.	Mpina mwenyewe ndani ya mwezi mmoja sasa.
Sowore is the Publisher of Sahara Reporters, an online media organisation.	Sowore ni muanzilishi na mchapishaji wa Wanahabari wa Sahara (SR), ambalo ni gazeti la habari za uchunguzi la mtandaoni.
Summer nights have passed two young men but they did not return.	Juzi juzi wamepita vijana wawili lakini hawakurudi.
Tell me how often you get sick.	Unakasirika mara nyingi kadiri gani?
"Like the ""apple of my eye."""	"^ Ao ""uchungu wa nafsi yangu."""
Down, like five times.	Katika nyekundu kama ilivyo mara tano chini.
I received an email letting me know we had to pay them $18 to extend the preapproval...	Baada ya kutumia yangu rahisi No-Nonsense Fat Kiwango System , nimepata wanafunzi kuniambia wangeweza kuwa na kulipwa zaidi ya $ 1,997 tu kupata taarifa hizi mafanikio ...
"""Do you go to Breightmet?"""	'Kwani unaenda maternity?'
John Lovett III Carter (1) was born.	Jonathan Harshman Winters III (amezaliwa tar.
When the class is going to start?	darasa litaanza muda gani?
"""The new institutions of the open economy have been steadily improved."	"""Taasisi mpya ya uchumi wa wazi imekuwa ikiboreshwa kwa kasi."
The police said they are still looking for the driver.	Alisema polisi wanaendelea kumtafuta dereva huyo.
It was made for Americans, not for	Amerika ilifanya hivyo si kwa sababu ya huruma, bali ni sababu
It still hasn't hit us over here in Europe.	Bado haitusaidii kwa chochote katika nchi hii.
Many were enslaved along with the Africans.	Utumwa umefanywa na wote pamoja na waafrika wenyewe.
But it is fair to compare them.	Je ni haki kuwalinganisha.
And WE wrote for him upon the Tablets about everything an admonition and an explanation of all things.	Na tukamuandikia katika mbao kila kitu, mawaidha na maelezo ya mambo yote.
Do you wish to communicate with the world, without any linguistic barriers?	Unataka mazungumzo tu bila chaguzi za ujumbe wa kibinafsi?
The abridged audio of this title is absolutely awful, but for years it was inexplicably the only audio version available.	Wasifu wa L'O inakataa kabisa taarifa hii, Anya ndiye penzi lake pekee kwa miaka mingi.
Go back to your body and stop your expectations.	hebu nenda kwenye mgomo wenu na utuondolee ujinga wako hapa.
"It's their way of saying ""watch the the @#*% you say!"""	inanisumbua sana#) ama nilivyosema awali% ninyi ndiyo wau wa kwanza
He forgives those who truly repent.	Atawasamehe wote watakaotubu.
until the outbreak of the war.&quot;	"""Kabla ya Mkutano&hellip;"
"Presented a paper entitled: ""Engaging with Globalisation: Lessons from South Asia"""	"Chapisho jipya - ""Kusababisha Mabadiliko ya Hali ya Hewa: Masomo kutoka Asia Kusini"""
Turkish and Azerbaijani armed forces launched joint military exercises on	Iraq na Uturuki wafanya mazoezi ya pamoja kijeshi
Hint: it's not you or I.	Hint: It's not wewe au me.
I am not a doctor, nor do I play one on TV; so this is not qualified	Mimi sio daktari, wala sijacheza moja kwenye TV kwa hivyo hapa ni chini ya matibabu ya kila mmoja:
And we serve them with truth and honesty,...	Vile tumempa sheria na uwezo---
Especially for the fans of the ge...	Kwa Wajasiriamali hasa wa sekta ya Kilimo...
Search for The Town	Utafutaji wa jiji la jiji
If you like what I do, tell people via Facebook, Twitter, Google+, reddit, or however you get down.	Kama wewe kama wewe Nifuate Mtandao wa Twitter, Facebook, Google + au kushiriki na vitufe chini ya chapisho hili.
Hooray for fire and explosives!	Gumzo la video la moja kwa moja na warembo moto!
All of you are distinguished members of this steel frame.	Wewe kaokote vichwa vya kuku kwa lema sikuu hii
A lot of difficult work, but if you do it, it is manageable.	Ana kazi kubwa, lakini kama yuko makini anaweza kuifanya.
Uncivilized people make.	Na watu bila hiyana wanana nunua.
Miguel Cotto, of Puerto Rico, knocks down Sergio Martinez, of Argentina, during the first round of a WBC World Middleweight Title boxing match Saturday, June 7, 2014, in New York.	Bondia Sergio Martinez, kutoka Argentina, kulia akimpiga ngumi Miguel Cotto, wa Puerto Rico, katika mpambano wao wa ubingwa wa WBC World Middleweight Title boxing match Saturday, June 7, 2014, in New York
Their talk about school hadn't gone well at all.	Mahojiano yako kuhusu elimu yake hayakunirisha kabisa.
This happened in a Champions League last 16 game against Diego Simeone's Atletico Madrid.	Hii ilitokea katika Ligi ya Mabingwa ya mwisho mchezo wa 16 dhidi Diego SimeoneAtletico Madrid.
Moreover, the threat posed by cybercriminals is growing in	sasa hali ya usalama mtandao kwa mujibu wa twakwimu imekua ikiongezeka huku
Make your life more worth by adding value to your life.	Ongeza thamani ya maisha yako kwa kujenga maisha yako.
"""Why did the Emperor summon us?"	Huyu mukulu mbona anatuchanganya?
Tomorrow, I will give you the link.	Kesho nitaweka link yake.
One day you take me up and the next day you bring me down	And the inayofuata siku wewe bring me down
Since I'm clumsy, I need a case on my smartphone.	aisee huu ni msaada kwa wakati muafaka, mimi nahitaji ushauri kwenye website yangu.
For a start we shall understand what it entails with the Swedish massage in this case.	Kwa hiyo hapa tutaangalia yale mambo yaliyosababisha Kiswahili kitumike katika eneo kubwa.
He was born about 1952.	Alizaliwa Kivum mwaka 1952.
We do not lobby, vote for political parties or candidates, run for government office, or participate in any action to change governments.	Hatuwashawishi viongozi wa kisiasa wafanye mambo tunayotaka, hatupigii kura vyama au wagombea wa viti vya kisiasa, hatugombei vyeo katika serikali wala kushiriki katika harakati zozote za kutaka serikali ibadili mambo fulani au kubadili serikali.
Therefore, our political system	Mfumo wetu wa kisiasa Endelea
No good work should go unpunished.	Hakuna huduma bora unayoweza kuipata bila kugharamikia.
Anabolic steroids are illegal in the United States, كندا, المملكة المتحدة, وأستراليا, but when it comes to liability when you're caught doping, things can get complicated.	Anabolic steroids ni haramu nchini Marekani, Kanada, Uingereza, na Australia, Lakini wakati unakuja kwa dhima wakati ni hawakupata doping, vitu kupata ngumu.
It was much easier to get lost back in 19th-century America than it is today.	Ilikuwa rahisi kuiunganisha Afrika katika miaka ya 1960 kuliko ilivyo sasa.
Even in adults, orthodontic treatment has good chances of success.	Hata katika visa hivi, matibabu ya uzazi yanaweza kufanikiwa kwa kushangaza.
Living with bipolar illness.	Jinsi Ya Kuishi Na Ugonjwa Wa Kisukari.
"""I don't know if it will be successful, but we have to try."""	"""Sielewi mtakapomtoa lakini ni lazima tufanye majaribio!"""
Damitty, this is another one I need to buy...	Mheshimiwa Naibu Spika, jambo lingine ambalo nataka nizungumzie ni...
while others simply evaluate the materials that have been submitted.	Wengine ni waandishi wa kutoa habari tu walizokutana nazo.
Asap started the sh*t...	Moto wa Magufuli umeanza... aluuu! -
Now is not the time to focus on Growth !	Huu siyo wakati wa kuzungumzia sukari tena!
Aim for about 20 minutes a day - it doesn't need to be for long as long as it's daily.	Sio mbaya kwa sababu dakika 23 si nyingi kama ingekuwa siku nzima.
Is why I wound up at cpf, to get help.	Kwa mwenye sababu yake pls naomba nisaidiwe.
"She added, ""What else would you expect me to say?"""	"Aliongeza, ""Nikikuuliza yapi mengine utajibu nini ? ."
A Short Tour of the British Museum	Shorts Bikini Uk
I'm also trying to save up some money so I can get back into real estate and be more flexible.	Mimi pia, ninahitaji pesa za ziada kusaidia mfuko wa ndoto yangu na kuishi vizuri zaidi.
An estimated 6 million jews died in the holocaust during the 1933-45 nazi rule.	Mauaji hayo yaliangamiza maisha ya Wayahudi milioni sita wakati wa utawala wa Kinazi 1933-1945.
ability to govern and even causing them to question the sincerity	na uwezo wa kulishughulikia na hata kulifikisha katika vyombo vya kinidhamu vya
Lust is an evil spirit.	Uchawi ni roho mbaya .
And they are not worthy of it nor can they be able to do so.	(211) na hilo halifai kutoka kwao na wala hawaliwezi,
We have won a greats victory.	Tumepata ushindi mkubwa.
tees returned to their homes.	Masimba na Teddy wakarudi mpaka nyumbani kwao.
We need borders in order to be a country.	Tunahitaji mabadiliko katika dira ya uongozi ili tuwe nchi yenye uhuru kamili.
A human chain it symbolizes an act of human expression, performing a combined act among numerous children to make publicly visible in the street a position, in this case: ask for Peace and Nonviolence on the planet.	Minyororo ya Binadamu inaonyesha kitendo cha usemi wa kibinadamu, kutekeleza kitendo cha pamoja kati ya watoto wengi kuibua hadharani msimamo mitaani, kwa hali hii: omba Amani na Usijali kwenye sayari.
The purification is carried out 1 time a week.	Kusafisha hufanyika mara moja kwa wiki.
[Greek names] 6These seven were presented to the apostles, who prayed for them as they laid their hands on them.	"(trg) =""98""> 6 ambao wakawaweka mbele ya mitume , na walipokwisha kuomba wakaweka mikono yao juu yao ."
was as if he hated his father.	Akawa ni kama anamchukia mumewake.
Adam, though, was floored.	ijapokuwa Adamu alikuwa ameanguka.
Not only do we ensure...	Sio tu kuhakikisha kwamba...
We have a great group of kids who want to Obey right away.	Kuna kundi kubwa la watumishi wa serikali wanaostahili kufukuzwa kazi mara moja.
He saw my face and said he would be careful.	Akaniangalia na kuniambia nina macho makali.
we have to thank God on everything.. bad and good stuff..	Ahsante Mungu maana imeandikwa tushukuru kwa kila jambo......mbivu na mbichi zitajulikana tu
It truly is the one thing I can't live without because it does everything that I enjoy.	Yaani siwezi fanya kitu chochote akiwa karibu kwa maana atafikisha ripoti chochote kile nimefanya
TGP: How much do you interact with the players on a day to day basis?	BC: Kwa siku huwa unatumia muda kiasi gani kufanya masuala yanayohusiana na blogs kwa njia moja au nyingine?
Amazon was twice the price.	Mshahara wa ajira ile ulikuwa maradufu wangu.
The Annunciation by the Angel Gabriel to Mary.	Ujumbe wa Malaika Gabrieli kwa Mariamu.
China's launches in 2016:	Mambo yaliyotafutwa sana Tanzania 2016:
"The complaint filed Monday with Nils Melzer asks for an immediate investigation to make sure Rusesabagina, long an outspoken critic of Rwanda's government, ""is still alive"" after being accused of terrorism."	"Malalamishi hayo yaliyowasilishwa siku ya Jumatatu na Nils Melzer yanataka kufanyika kwa uchunguzi wa mara moja kuhakikisha kuwa Rusesabagina ambaye ni mkosoaji wa wazi wa muda mrefu wa serikali ya Rwanda ""bado yuko hai. """
"""They do what they said they did!"	Na wakatokea hao wanaosema wanaweza wakafanya
+4 more St Leonards (9)	wa + li4 (untruths)
He saw on TV that the authorities are recruiting volunteers to help, and he immediately decided to go.	Alisema ameona kwenye televisheni watu wakitoa maoni yao juu ya kampuni hiyo ya ndege kuwa ni nzuri kwa sasa na yeye akaamua kusafiri na ndege hiyo.
the city of Ma'alot,	Ms all del Chamizal,
You be damned, the murderer even listen to me,... but sad, private whom I told you.	Bibi karudi chini, lakini bwana, hasira zikampanda...utapata talaka, kwanza nani kakupatia haya maradhi, na mimi mgonjwa, hata unyumba wenyewe wanishinda!.
The aims of The London Community Flower Show are:	Makusudi ya Chama cha Usambara Citizen Union ni:-
This church has helped me love Jesus more today than yesterday.	joel lwaga yesu nipende leo kuliko jana
Those who choose to live close to Eindhoven Airport will have to take account of the possible nuisance of overflying aircrafts.	Wale ambao wanachagua kuishi karibu na Uwanja wa Ndege wa Eindhoven watalazimika kuzingatia akaunti ya uwezekano wa usanifu wa kupita kiasi.
They do, however, often use the blunt instrument of funding	Lakini mara nyingi wanaonufaika na punguzo la kodi
God provided yet again.	Mungu ampe nini tena.
I know that he can speake well.	Najua ya kuwa yeye aweza kusema vizuri.
The Afghans are still trickling into Pakistan.	Mafuriko yaendelea kutishia Pakistan.
The next step is to engage in action.	Hatua inayofuata ni kushiriki hatua za utambuzi.
"He also said this year's exam was ""very easy,"""	Alisema kauli mbiu ya maadhimisho hayo mwaka huu ni 'Mikono safi kwa
Sorry i can't explain more.	Sorry, siwezi kufafanua zaidi.
"invite you."""	Tu akupenawai.'
What are you participate.	unashiriki vipi?
Yes, it takes effort to get your work into the product, but when it's out there, it's rewarding.	Ni hakika kukusaidia kupona baada ya workouts yako, lakini kwa bei, kuna bidhaa bora huko nje.
"""A particularly pleasing aspect for me is that the building is carbon neutral, which I think sends a real message about our commitment to being an organisation that not only cares about its people and its communities, but also about the environment around us."	Mabadiliko ya hali ya hewa yanatufanya tushindwe kuwa na uhakika wa mustakabali wetu, hata hivyo jambo moja ni dhahiri kuwa jamii yetu inalo jukumu la kugeuza hali hii, si kwa ajili yetu pekee bali kwa vizazi vijavyo pia.
Today the members of the media aren't even embarrassed that they have allowed themselves to become an arm of the Democratic Party.	Na hata watu wenye heshima zao naona sasa hivi wanaona hata aibu kuwa associated na serikali ya sasa.
Everyone's afraid of something, but only the brave conquer their fear.	All in all, they sometimes gain something ila cha kuhofia ni kuexpose kila kitu kwa hawa majangili.
Most importantly, she proved that you could be a woman and do all that.	Lakini la muhimu zaidi mkeo aridhike, akisharidhika mnaweza kufanya hivyo.
Cooke and the other two by H. Moses.	Kwa Mfano wa Bwana Yesu na WanafunziB Y W f i Wawili wa Emmaus.
When he wakes up tomorrow, let him forget everything that happened today.	Ukiamka kesho hautakumbuka uliyoyaandika leo.
That is where this government has left us.	Hivi serikali yetu inatupeleka wapi.
Cheers at the end of the road	mwisho wa mwaka tuwe makini barabarani
For the first time in the racing and driving genre,...	Kwa mara ya kwanza katika spishi ya saizi hii na rangi [Zaidi ...]
Hope lost had now been renewed over the last 40 days.	Inayoahidi leo ingekuwa imeyatekeleza katika miaka 40 iliyopita.
This space is hosted by Nanci Monthly.	Ni hapa kila mwezi hoteli ikigaiwa Sh.
Shaunti: All at the same time - and all the time.	- Mtodos: OnKey; OnTime.
The implication is: what are you doing to add value?	mwandishi: Kitu gani kinakuongezea kipato?
This is particularly bad trade.	Hii biashara mbaya sana.
Be careful - it's catchy!	Karisha - So Cute!
The family divulged that since December 2020, the deceased had been on a life support machine.	- Familia ilifichua kuwa tangu Desemba 2020, marehemu alikuwa kwenye mashine ya kumsaidia kupumia
Fact #1: WWII would not have taken place if the USSR had not signed the Molotov-Ribbentrop pact with Nazi Germany.	Ukweli # 1: WWII isingefanyika ikiwa USSR haikutia saini mkataba wa Molotov-Ribbentrop na Ujerumani ya Nazi.
Research done at the University of Kansas shows that being able...	Utafiti uliofanywa na Chuo Kikuu cha North Carolina umehitimisha kuwa wanawake vijana wanaweza...
it could make a decision.	iweze kutoa uamuzi.
Dani is right of course that having doubts about the current multilateral arrangements does not make you a protectionist.	Mheshimiwa Naibu Spika, kwa hiyo, siyo kweli kwamba marekebisho haya sasa yanataka kutambua mifumo ya Kimataifa, siyo kweli hata kidogo.
Chad: I'm really not interested in discussing my relationship with my brother.	Rugangazi: Nisingependa kuzungumzia mahusiano binafsi ya viongozi wangu.
20 min from Copenhagen airport.	Dakika 20 kutoka pwani ya Copacabana.
The eyes of the demon light up.	nuru video wake up fuck
B) Not being able to see	(b) Yeye Hawezi kuonekana
Thank God there were people of all races that agreed with the civil rights movement.	Baba, asante kwa umati wa Wakristo ambao walitoka katika mataifa yote kupata kadi zao za wapigakura.
M1012: Building a Website from the Ground Up	Mbinu #1: Kujenga tovuti kutoka mwanzoni
Keep your photos and information up-to-date and respond to questions and reviews quickly.	Hakikisha namba yako ya simu na barua pepe zipo kwenye tangazo, na pia toa majibu ya maswali yao haraka.
Christians are being persecuted in Muslim countries.	Wakristo wanashambuliwa nchini Msiri.
19 In the eighteenth year of the reign of Josiah this passover was kept.	19 Katika mwaka wa kumi na nane wa kutawala kwake Yosia ikafanyika pasaka hiyo.
I was the first one to be arrested.	Nilikuwa wa kwanza kuchukuliwa.
BCAAs are essential amino acids such as L-isoleucine, L-leucine, and L-valine that cannot be made in the human body and therefore must be consumed in the diet (15).	BCAA ni muhimu amino asidi kama vile L-isoleucine, L-leucine, na valine ya L ambayo haiwezi kufanywa katika mwili wa binadamu na kwa hiyo lazima itumiwe katika mlo (15).
C'mon, wine, take me	Kalita, Jitumani M
Hence, research in this field can be related to both the organizational and technological aspects.	Hivyo, maelezo yake katika makala hii YANAWEZA kua na upungufu wa kitaalamu hapa na pale.
Take me out fwh the ballgame.	Jameni wana jf.hubu nitoeni taka za machooooh!.
The fruits of Vatican II have been bitter for the Catholic Church.	Marekebisho ya Liturujia yaliyoamuliwa na Mtaguso wa Vatikano II yalijitahidi kuwaandalia Wakatoliki chakula cha Biblia kwa wingi zaidi.
It's another MSI MB.	Hizi study tour nyingine mmhh.
"The social and environmental debt owed to the poor of cities can be paid by respecting their sacred right to the three Ls: Land, Lodging, Labour."""	"""Deni la kijamii na kimazingira ambalo maskini mijini wanadai linaweza kulipwa kwa kuheshimu haki zao tatu kuu ""za L tatu (Kwa Kiingereza) "": Land, Lodging, Labour."
The little schemer	The Kidogo Method
I try to not bring it up the first time we meet people.	Ntamuaminije mtu wakati Ndiyo kwa mara ya kwanza tu tunaonana.
Anabolic steroids were created in the late 1930s mainly to deal with hypogonadism, a problem where the testes do not produce enough testosterone for regular development, development, and sexual performance.	Steroids za anabolic zilianzishwa mwishoni mwa miaka ya 1930 kimsingi kutibu hypogonadism, hali ambayo majaribio hayatengenezi testosterone ya kutosha kwa ukuaji wa kawaida, ukuaji, na utendaji wa uhusiano wa kingono.
out the above-mentioned work	kufanyia kazi hayo yaliyotajwa hapo juu
Also, maybe they're just trying to avoid obesity.	Pengine wanajikinga na vumbi tu.
Are you optimizing ROI and...	Unathubutuje kumsihi mfalme kwa tabia ya kiburi na kwa ...
"significance in the performance ""smile."""	"inayopendelewa performance in ""Michael""?"
You sure we aren't married to the same woman!?!	Huoni wivu kuwa the other woman???
The question is whether somebody has written such a thing.	Swali,je kuna mwenye aliyepata tetesi kuhusiana na habari hii?
8When the lepers arrived at the edge of the camp, they went into one tent after another, eating and drinking wine; and they carried off silver and gold and clothing and hid it.	8Wakati wale watu wenye ukoma walipokuja sehemu ya mwisho wa kambi, wakaenda kwenye hema moja na kula na kunywa, na kubeba fedha na dhahabu na nguo, na kwenda na kuzificha.
The message-thing is just a waste of time.	Huyo hana cha message anapoteza wakati tu.
It does not exclude any class of	Haubadilishi aina ya mazoezi
He said He ate.	Alisema Nya.
And then there are always your parents.	Halafu wazazi hao wote wanakuwa wazazi wenu.
"""We've been working some long days."	"""Tumefanyia kazi sana kwa siku nyingi."
And listening to the album with fresh ears, I can see why.	Yaani nikiusikia huu mwimbo,nafreeze ghafla,cjui kwa nini.
The Chicago Teachers Union supports this education champion.	Muasisi wa Jumuiya ya Bunju Community Support Profesa.
You have got to clean your own house first before you tell other people that they aren't doing it right.	Weye bwanamkubwa hebu kuwa unafanya homework kabla haujawambia wengine hawafanyi yao.
"""By faith in the name of JESUS, this man whom you see & know was made strong."	16 Kwa imani katika jina la Yesu, huyu mtu mnayemwona na kumfahamu ametiwa nguvu.
The area needs to be a location that can easily be found by the attendees.	Ofisi inapaswa kuwa mahali rahisi kwa wateja wenye uwezo.
Don't plan on that has a hectic agenda, and adjust the work plan when needed.	Hakuna chochote kinachohitaji kutafutwa kwa kina sana - ingiza programu-jalizi na uweke wijeti mahali unapoihitaji.
He got speaking to another man.	akizungumza na mwanaume mwingine.
They are hopeless and look to someone to love them.	Hawana tumaini, kwa hiyo wanapenda mutu fulani awasaidie.
I could have at least got a soap box.	Least I Could Do karatasi za kupamba ukuta
"""I hate you so much,"" Shawn said into the phone."	"""Nimekukumbuka sana Dickson,"" alisema Linda kwenye simu."
This applies again to the hero's journey.	HAYA MENGINE TENA Usafiri wa Mchungaji.
I am spending a LOT of time learning to change my relationship of money.	Natumia muda mwingi kujifunza kwa namna tofauti maisha ya ndoa yalivyo.
Or was it the luck of the Irish?	Kumbe hiyo ilikuwa raha ya wanafunzi?
I have children 29 years old.	Nikaona ana miaka 29.
"send them to jail."""	"wajiandae kufungwa."""
come down from the cross, and we will believe in him.	Ashuke kutoka msalabani nasi tutamwamini.
Thats the first and most important step.	Hii ni hatua ya kwanza kabisa na muhimu sana.
3:26 When Joab had come out from David, he sent messengers after Abner, and they brought him back from the well of Sirah; but David didn't know it.	26Yoabu alipoondoka kwa Daudi, alituma wajumbe kumfuatia Abneri, nao wakamrudisha kutoka katika kisima cha Sirah, lakini Daudi hakulijua hili.
For best results with monitoring AD, read and understand the following:	Kwa manufaa zaidi,jitahidi usome kwa makini na uelewa haya:-
Kelloggs have created a new strategy to engage with the customers via text.	Whatsapp wameanzisha njia mpya ya kukaribisha watu kwenye group kwa kutumia link.
"""It directly ties to absolutely everything that happens in your community."""	"""Vizuri sana na pole kwa yote yaliyotokea hapa nchini kwenu."""
But the message needs to be sent.	Lakini ujumbe ni lazima upelekwe.
Then you can view the results in your browser.	Kisha unaweza kuona matokeo ya mwisho ndani ya akaunti yako ya Akaunti ya chombo.
"""It was an experiment that didn't catch on but we do think there's a fun game there."	"""Huenda ulikuwa si mchezo mzuri , lakini tumeona kwamba kulikuwa na hali bora kiasi katika mchezo wetu."
The centre aims to bring together people	Nia ni kugawanya watu
we are confident we will be able to help you.	Tunaamini tuna uwezo wa kukusaidia.
Therefore, you increase your chance to find employment.	Kwa kufanya hivyo unajiongezea nafasi ya kupata kazi ya kuajiriwa.
I'm now on the third stage of the 2016 Tour de Fleece.	Nasema hivi NITAKUWEPO kwenye robo fainali ya Sprite BBall Kings 2018.
However, he continued to promote the art without rest.	Hata hivyo, aliendelea kuhudumia mtaani pasipo kuwa na kibali.
Jesus will come one day to fulfill His promise to us.	Tunamsubiri Yesu ili siku moja aje atupeleke kwenye hiyo haki.
An acronym derived from American Standard Code for Information Interchange (pronounced as-kee).	ASCII - (American Standard Code for Information Interchange) ASCII (Msimbo Sanifu wa Marekani wa Mabadilishano ya Habari)
HOw is it possible to be born again?	Hata hivyo, mtu anawezaje kuzaliwa tena?
11to bring Queen Vashti before him with the royal diadem on her head, to show her beauty to the people and the officials, for she was very beautiful.	11 wamlete Vashti, malkia, mbele ya mfalme, amevaa taji ya kifalme; ili kuwaonyesha watu na maakida uzuri wake, maana alikuwa mzuri wa uso.
With the advance of science and technology, ...	Pamoja na maendeleo ya sayansi na teknolojia, ...
I'm looking for spiritual friends.	Natafuta marafiki wa kiroho.
The weeds are growing as fast as the plants.	Madume yanasifa yakukua haraka kuliko majike.
"23 And someone said to him, ""Lord, will those who are saved be few?"""	"23 Mtu mmoja akamwuliza, ""Bwana, ni watu wachache tu watakaookolewa?"""
Now more than ever as companies and organisations look to the future, they are going to look to analytics to help them charter their way.	Huduma kwa wateja - Sasa, zaidi ya hapo awali, watumiaji na wafanyabiashara sawa wanatarajia mashirika kujibu maombi yao ya huduma kwa wateja kupitia njia za kijamii.
and war being you know, just people going to war...	Na ikifikia hapo basi ujue tu kwamba wanawake huwa wanaadhibu kimyakimya...!
What our users have to say.	Nini wateja wetu wanapaswa kusema
In 2001, in a landmark case, nearly 40 pharmaceutical companies ended their challenge to a law that allowed cheaper versions of AIDS drugs to be sold.	Mnamo 2001, katika kesi kubwa ya kihistoria, takribani kampuni arobaini za dawa ziliacha kupinga sheria iliyoruhusu dawa za bei nafuu za Ukimwi kuuzwa.
This is a contrast between	Hilo y contrahilo
Some have had the code beginning with 2111.	A ndogo mizabibu kwamba ulianza 1121.
Is being used to de-block content from Youtube.	Inatumika kufungia yaliyomo kwenye YouTube.
Another one is wall-hanging stick.	Mwingine katika Picha ni Kingunge Ngombale Mwiru.
Cervical cancer is an important health problem in women living in developing countries.	Lishe duni ndio tatizo kuu linalokwaza afya za wanawake katika nchi maskini.
Please Forgive Me (S)	Kika Nicolela (BR)
Just how are we going to do Thanksgiving this year?	Vipi basi tutajiandaa kwa mwezi huu uliobarikiwa?
Studies have shown that yoga offers a variety of benefits to those that live with cardiac disease.	Uchunguzi wa matibabu umethibitisha kuwa Pregabalin hutoa matokeo bora kwa watumiaji wake wote wanaofuata maagizo ya kipimo.
Baby Michiko: (he hiccups and stills as if he was in shock himself).	Mwanawima: (Kimya anaona aibu hata kuinua kichwa chake.)
It stands to reason that the number of merchants selling products online is also growing.	Hivyo ni kawaida sana kushuhudia biashara ya vyakula mtandaoni ikikua pia.
The Scriptures are replete with admonishments for believers to persevere.	Na wala wasiyatilie shaka hayo walio pewa Kitabu na Waumini.
Here's your mule - Wikipedia	Naoki Wako - Wikipedia
my wife, Janette.	Nikiwa na mke wangu, Janette
I will go back . . .	Mimi nitarudi baadae. . . . . .
"Two men in white (angels in disguise!) ask them, ""Why are you men from Galilee standing here looking up into the sky?"""	"Wanaume hao wawili ni malaika wenye kuvaa miili ya kibinadamu, wanauliza hivi: ""Wanaume wa Galilaya, sababu gani munasimama na kuangalia katika anga?"
Men and women with mild to moderate	ni wanawake na wana mioyo myepesi sana kusamehe
And don't let out water after weeding.	Usije mtapisha baada ya kumpa maziwa.
There is a news feed at the bottom of the page that's automatically populated by news from Google, but I won't be manually adding anything.	Post yoyote itakayo ongezwa yenye link ambayo inatoka nje ya tovuti hiyo itakuwa na matangazo automatically bila mimi kufanya kitu kingine chochote.
Behind the Scenes: The Music of Films	Behind the scenes: muziki ubunifu
How Are You Doing, After School	Nini iwapo, baada ya shule
Now they've added three more deadly bats.	Sasa wanatakiwa kupiga 3 goals more vinginevyo wameula wa chuya!
Financial institutions need to find a way to access this new technology and incorporate quickly.	Teknolojia mpya zinahitajika kujaza pengo hili, na haraka.
"""We have a lot of work ahead to rebuild trust,"" Ms Marin told reporters."	"""Tuna kazi nyingi za kufanya ili kujenga upya uaminifu"" aliwaambia waandishi wa habari."
reminding her family that she is proud of her grandfather.	Ikumbukwe mama huyu anasema alikuwa na hamu sana na mume wake.
Love at first sight (hopelessly)	upendo At First Sight (One-Shot)
don't have a diploma in social engineering	Usikimbie nafasi ya Diploma na Elimu ya Umbali
That means there is a lot of work.	Yaani kuna kazi kubwa sana.
1st-day collection of Thugs of Hindostan: 52.25 crores	Baahubali 2 4th Day Hindi Collection: 35 Crore
Sex Thief, The (1)	Mfaume Mlawa, Hasa (1)
What kind of battle was fought here?	Amepigana vita ipi hapa nchini?
"Indeed, we felt that we had received the sentence of death"" (2 Corinthians 1:8-9, ESV)."	"Kwa kweli, tulihisi ndani yetu wenyewe kwamba tulikuwa tumeipokea hukumu ya kifo."" - 2 Wakorintho 1:8, 9."
the Mighty One of Israel, says:	Mwenye Nguvu wa Israeli, asema hivi:
That is what our government promised, and that is what we are going to do.	Hiyo ndiyo Serikali na hivyo ndivyo tulivyoahidi.
I do not ask you to take them out of the world, but to guard them from the evil one.	Mimi siombi kwamba uwatoe katika ulimwengu; bali uwalinde na yule mwovu.
She formerly led four ministries in the Norwegian government.	Hata hivyo bado hajafanya uteuzi wa mawaziri katika wizara nne ikiwemo wizara ya fedha.
I is more.	mimi zaidi.
"The Bible says ""The end of all things is near."""	"UTAJIRI WA NENO LA MUNGU ""Mwisho wa Mambo Yote Umekaribia"""
What comics are listed in the database?	Ni data gani inapatikana katika dashibodi yangu ya mshirika?
carry out this priority by collaborating with one another and with	kwa pamoja katika kutekeleza jukumu hilo kwa pamoja, pamoja na mashirikiano
Déby came to power through a rebellion in 1990.	Rais Deby alitwaa madaraka kupitia mapinduzi ya kijeshi mwaka wa 1990.
Running water is a good choice.	Kuuweka kwenye mafuta, ni uamuzi mzuri.
We try to keep the heat out as best as we can.	Tutajaribu kumaliza msimu vizuri kadri tutakavyoweza.
"""should the enemy declare samad is dead! i will put my hand..."	Ikiwa Faatwimah mtoto wa Muhammad ameiba basi nitamkata mkono wake)) [Al-Bukhaariy]
I have travelled all over the globe, often to exotic places.	Nilisafiri kotekote nchini, mara nyingi nikitembelea makutaniko yaliyo mashambani.
hhhhhhhhhhhhhh:)))) mesh tsadgy	My Shisha (@myshishastwendel)
He wants to help the Filipinos.	anataka iwasaidie watanzania.
I'm not talking about living like a monk.	Hapa sijasema ni kama boflo msije mkanitupia marungu.
all that is in the world, the lust of the flesh, the lust of the eyes, and the	kila kilichomo duniani, yaani tamaa ya mwili, na tamaa ya macho, na kiburi cha
Do you want to get news?	Unataka Kupata Habari Mpya?
What they are looking for on the Web?	Nini anatafuta katika hiyo internet?
We saw them set fire to it.	Tuliwaona wakiliteketeza moto gari.
See all homes in St. Joseph, WI	Angalia migahawa yote ya San Jose, CR
And even those who believe in Evil must do so for a reason.	Lakini waumini wengine hata nauli hawana, wamechoka ile mbaya!
These are local parties in the Libertarian Party of Arkansas.	Hawa ni wanasiasa katika Landtag kwenye jimbo shirikishi.
But Joseph wasn't through.	Lakini Yusufu hakufa.
Why don't they just call it something other than Cartoon Network?	Kwa nini kwa mfano TV isiitwe tu TV na badala yake wanaitwa eti Luninga?
were for Eastern Europe and not against the Soviet Union.	Kuhusu Magharibi na sio dhidi ya Magharibi.
It can be both and be beyond.	Inaweza kuwa chini ya hapo na si vinginevyo.
I have good access to community resources or activities (2019)	Ninatafuta nafasi ya kazi ihusianayo na sheria au huduma za kisheria (kuanzia mwezi August 2011)
Drink of it, all of you in remembrance of me.	"Fanyeni hivi, kila mnapokunywa, kwa kunikumbuka."""
"Who told you about that, or were you there?"""	Ndio unavyoongea hivyo au unamlegezea nani hapa?
Every damn thing amounts to them.	Yaani Madhambi yoyote ni Mali kwao
God has given you the spiritual gifts you need.	Ewe Roho Mungu ndiwe uliyewapa waumini vipawa vyako kwa kadiri unavyotaka.
The National Violence Against Women survey found that the user level.	Uchunguzi wa kitaifa kuhusu visa vya ukatili dhidi ya wanawake umeanzishwa kama alivyoamuru rais.
#366 is a true story	365# Ni Kutamu Sana Kwangu
Deep down we all know we were not born to suffer.	Sote tunapaswa kukumbuka kwamba hatukuzaliwa na ujuzi.
They see their mind and soul as superior to everyone else.	Atajaa moyoni na mwazoni mwako kuliko kawaida na wengine.
Just walk in and we will get you taken care of.	waende tu. wakimbie. we dont care.
Ronaldo has also received a proposal from former club United and the 35-year-old wants to restore the glory days at Old Trafford, though it depends on UEFA Champions League qualification.	Nyota huyo wa Ureno pia amepokea ombi kutoka kwa klabu yake ya zamani ya Man United na mchezaji huyo mwenye umri wa miaka 35 anataka kurejesha ufalme wake pale Old Trafford, ingawa inategemea kama United itafuzu ligi ya mabingwa - Diario Gol.
Each gives a lot of support to each step.	Wengi wanalaumu kila hatua.
Yes, 5 HTP ship anywhere in the world.	Ndiyo, Phen375 meli mahali popote duniani.
What you need to create a good information	Unachotakiwa kufanya kupata akaunti inayokufaa
Below are the San Marino Village public school districts:	Sehemu nyingi za kukaa San Bartolo District:
My prayer stopped there - as if I don't even deserve God's help.	Mungu amenipigania... Kama si mkono wa Mungu nisingefika hata hapa nilipo.
"your life will be exchanged for his life, and your people for his people.'"" 43 Sullen and angry, the king of Israel went home to Samaria."	"Kwa hiyo ni uhai wako kwa uhai wake, watu wako kwa watu wake.' "" 43 Kwa uchungu na hasira, mfalme wa Israeli akaenda kwenye jumba lake la kifalme huko Samaria."
"him, ""Lord, if you had been here, my brother would not have died."""	"Akamwambia, ""Bwana, kama ungalikuwapo, ndugu yangu hangalikufa."""
Not one of them was bought.	Hakuna anayenunuliwa hata mmoja.
If you want to get jacked, how do you do it?	Kwa hivyo ikiwa unataka kuvuruga kitengo, unafanyaje?
You ask them to stop fighting.	Waambie waache kugombana.
Al-Saadi Qaddafi fled to the neighboring country of Niger in September and the government there has given him refugee status.	Mnamo 11 Septemba 2011, al-Saadi alikimbilia nchi hiyo jirani ya Niger, ambapo serikali imeamua kumpeleka kwenye mji mkuu wa Niamey na kumshikilia.
Join the legions of players who turn to the AS-50 shuttlecock to maximize their level of play on the court.	Hakikisha kuangalia kwa Michezo ya Michezo ya Kubahatisha kwa Viongozi wetu bora wa Mods kwa wahusika wa 150 + kwenye Galaxy ya Star Wars ya Majeshi ili kuhakikisha kuwa orodha yako imara iwezekanavyo.
View from the top of Lisbon	Go Juu Lisboa View
Judges as well.	Mahakamani pia.
He placed his right foot on the sea, and the left on the earth, and cried out with a great voice, as a lion roars; and when he cried out, seven thunders uttered voices of their own.	Kwa hivyo yeye kwa nguvu zote juu ya bahari na dunia analia kama kishindo cha simba: akisababisha ngurumo saba kusema.
It is advisable to deal with ending music.	Hivyo, ni vizuri kuacha mara moja kusikiliza wimbo usiofaa.
Bryzgalov was willing to retire, but he's happy in Anaheim	Wojciech Szeczesny amepoa jeraha kama hilo na sasa anatarajiwa kurudi katika goli
I don't think anyone is anti-love	Siamini kama kuna mtu anapenda ubaya
Rich and poor were all in the fold.	Wote mbwa na maskini walikuwa nje ya lango.
On the evening, slipped 10.68KM.	Jioni, imeshuka 10.68KM.
The most successful..	Bora zaidi ya mafanikio ..
St. Paul gives us the	Skye Alitupa
Not to wander around aimlessly.	kama si kwa Drift aimlessly.
"They were simply called ""Christians."""	"Anasema tu kwamba waliitwa ""Wakristo. """
The attack by Fateh al-Sham had threatened to wipe out the FSA groups which have also received backing from countries opposed to Syrian President Bashar Assad such as Gulf Arab states, Turkey and the United States.	Mashambulizi ya Fateh al-Sham yametishia kuyaondoa makundi ya FSA, ambayo yamekuwa yakiungwa mkono na nchi zinazoipinga serikali ya Assad kama vile Uturuki, Marekani na Ghuba ya Kiarabu.
What is the contribution of the developed nations to the climate catastrophe, including the burning of the Amazon?	Taifa lilipoteza fedha kiasi gani kuagiza mafuta including capacity charges za wamiliki mitambo ya kuzalisha umeme?
Before purchase a machine, maybe you have a lot of questions and confusion.	Kabla ya kufunga kamera, unaweza kushangaa maswali kadhaa ya kiadili na ya kisheria.
Organisations often need to procure goods or services to support their business.	Vikundi na watu hawa mara nyingi huhitaji mikopo ili kuendeleza mitaji ya biashara na shughuli zao.
A professor at King's College explains why the terrorism of Nusrah is not that bad	Shule ya Starehe yadhihirisha kwa nini utundu shuleni ni nadra
I saw him when he toured	Nimemwona wakati anaingia gesti
After enlightenment of God's Essence, I do not know anything better than The Prayer.	"""Baada ya kuelimika kuhusu kuwepo kwa Mwenyezi Mungu, sikijui kitu kingine bora zaidi kuliko Swala."
Te amo in english	mimi nakupenda wewe English
A story about life, a story about death.	Simulizi kuhusu watu, simulizi kuhusu maisha.
"""Why are you talking like that to me?"""	"""kwanini unaongea hivyo sesi?"""
95 percent of the cases are pertaining to complaints/appeals.	90% ya malalamiko haya yanahusiana na ziada au yanahusiana na malipoingen.
"Doctor says he met the Santas ""last Christmas"")."	Daktari wao aliwaambia watapata 'ujauzito na Krismasi'
You know that the Northern Mariana Islands are part of the United States?	Kwani hamjui hapo Korea Kusini kuna ngome za kijeshi za Marekani?
The call centre rep was empowered to make decisions.	SERIKALI ya Chama Cha Mapinduzi imebobea katika kufanya maamuzi tata.
I believe the promise.	Naamini katika ahadi.
He might have been a big help.	Huenda angeweza kuwa msaada mkubwa kwangu.
Try to remember the unstressed e	Guess ya feel kinda inadequate????
protests against the persecution of the Jews in Russia.	Jitihada za kupambana na kirusi cha corona nchini Iran.
You can't break a promise to a dead friend.	huwezi kufanya ahadi anayependwa unfulfilled.
My mother had often declared that she would go	Mara nyingi mama alisikika akisema kwamba alingoja
Playing two nights: November 26th and 27th.	Sajenti Arobogast: Siku mbili, tarehe 26 na 27 Machi 2015.
When you're married and you're happy you just ... you gain some weight.	Kweli ukioa au kuolewa mnakua kitu kimoja...hii kali
"""Question: Did he ask you a number of questions concerning the application?"	Wakili Kibatala: Alikuuliza chochote kuhusiana na watu kutekwa?
For example, two of Denmark's political parties are represented in the ALDE group.	Kwa mfano, hapa Tanzania kuna mambo yaliyodaiwa na Dk.
An ultimate goal that the discharge of pollutants into Puerto Rico's waters	MRADI mkubwa wa maji Madaba utakavyomaliza kero ya maji kwa wananchi
What may account for these differences?	Nini kinaweza kueleza tofauti hizi?
What Is God's Spirit?	Je, huyu Roho wa Mungu ni nani?.
It may also cause cramps.	inaweza kusababisha impasses vilevile.
Stoke-on-Trent City Council news Feed	Tanzania Hy-Vee Food Stores News
This is before I've even committed to an order!	hii kabla hata sijaingia ndani ishakuwa ndoano!
have a Birth Certificate that is not less than a year old;	wawe na uzoefu huo kwa kipindi kisichopungua miaka kumi na tano;
A practice which takes full advantage of modern technology will facilitate prompt service.	Teknolojia ya kisasa itafanya iwe rahisi kuunda haraka ofisi inayofanya kazi kikamilifu.
I think we went to about 8 countries.	Nadhani tulikuwa tunafika watu wanane.
Christmas wishes for little sister	Mambo ya Furaha Kuhusu Dada
Other people perceive them as someone who can take control over the situations.	Wafanye wengine wakuone kuwa mtu wanayeweza kumfikia katika hali walizonazo.
the lion king i just can't wait to be king lyrics youtube take	Hakuna Matata Lion King Ukulele Tutorial Youtube
lips were greeted with enthusiasm	Walengwa wakimsikiliza Naibu Waziri kwa furaha
Or you are longing for God.	Au yatakayo kufanya usisimame imara kwa Mungu.
Would you like to know how to translate jack up to German?	How would wewe tell Jacob wewe upendo Edward?
Law Enforcement Among Top 15 Most Dangerous Jobs in the U.S.	Makala inayofuataSekta ya ujenzi Hesabu za Nusu ya kazi hatari zaidi huko Merika
When looking at this map, this is something to consider.	Ukitazama picha hii, inabidi ufikirie.
Take a look at Krishna Kaul's social media posts!	Angalia ukurasa wa shabiki wa Facebook wa YATS!
So that's a fairly big thing to learn, I hope you'll agree!	Then am sorry kwa uzi Mrefu i hope mtajifunza kitu!
Concern has been expressed about the weight gain among youth.	Kumekuwepo na wasiwasi kuhusu athari ya uraibu huo kwa vijana.
In his victory speech, hon.	Aidha katika hotuba yake ya ufunguzi, Mhe.
They saw and learned much more than one might have expected.	Lakini hata hivyo waliipata na watakuwa wamejifunza na wamepata somo kubwa sana kuliko walivyokuwa wakidhani.
And what is going to be his fate?	Na avatar yake itakuwaje?
Hold the Shift key and define a region in one of the images.	Bi Verdiana Mizengo,akitoa ufafanuzi katika moja ya majukumu ya jinama vijijini.
The alsa driver does.	Alisha Driver
Matthew 9:33 When the demon was cast out, the mute man spoke.	MT 9:33 Mara tu huyo pepo alipotolewa, mtu huyo aliyekuwa bubu akaanza kuongea tena.
What if you want a good marriage, but your spouse is not cooperating?	Nini kama unataka kufanya kazi na kampuni inayofaa niche yako lakini haitoi fursa kupitia ushirikiano wako uliopo?
How do we make a foster child feel at home?	Jinsi ya kulisha msichana mdogo kupatikana nyumbani?
At around 4:00 pm the National	9:00 PM Habari za Kitaifa
So they began moving out to the suburbs.	Na walianzisha kujitandaza, kutoka katika jimbo hilo.
rights movement; they were people who wanted social change.	Wananchi; huo ndiyo ukweli kwamba ilifanywa makusudi kubadilisha mambo.
Or at least stinky.	Angalaka anao Shyn
identity theft are frequently the result of single-factor	thawabu za kuzidia mara nyingi, ni kama hali ya mwenye kuatika punje moja
20 looked at.	20 Na tazama!
A number of fishing vessels, along with Russian and the United States coast guard helicopters are assisting with rescue operations.	Helikopta za jeshi la Marekani na jeshi la Singapore pamoja na walinzi wa pwani, wanafanya shughuli za uokoaji.
It is suitable for the party.	Ni jambo jema kwa chama.
You might have failed at some point or another in your life.	Labda umeshindwa wakati fulani au mwingine katika maisha yako.
But now I feel the pressure.	Lakini leo nitatilia mkazo maombi.
I Will Tell of All Your Wonderful Deeds.	Nitayasimulia matendo yako yote ya ajabu;
After the flood, the then Congress-National Conference government sought a financial assistance of Rs.	Kufuatia upungufu huo, Serikali kupitia Wizara ya Fedha na Uchumi ililazimika kuomba msaada wa dharura kwa nchi wahisani.
We are a family who believe in God.	Sisi kama familia, tunaamini Mungu yuko
thank you very much , you saved me	Asante kaka ,umenifungua sana
Use an appropriate planting method for each type of food you're trying to grow.	Tumia kila aina ya trafiki unayotaka kukuza.
"""Have I not obeyed you?"""	"""si nilikwambia ukabisha??"
We are not brothers and we are not one.	"""Sisi ni ndugu na hapana tofauti baina yetu."
Remember, you need to set up your phone for email.	Kumbuka kutuma namba yako ya simu kwa ajili ya mawasiliano.
Say, you are only a warner and for every generation there is a guide.	Hakika wewe ni muonyaji tu, na kila kaumu ina Kiongozi.
"""You want me to go get a doctor?"""	"""Je, ungependa nimwite daktari?"""
"""I want everyone who is here now to stay... but anything can happen right up until Aug. 31. """	"Nataka kila mmoja aliye hapa abaki, lakini chochote kinaweza kutokea hadi Agosti 31,."""
The population has hit more than seven million over the past one decade.	Ripoti hiyo inaonyesha idadi ya watu imeongezeka kwa watu milioni saba katika mwongo mmoja uliopita.
We're told by law enforcement authorities that he was arrested at JFK Airport trying to get out of the country.	Polisi waligundua kuwa mkuu huyo wa IMF alikuwa katika ndege uwanja wa JFK ikiwa tayari kutoka nje ya nchi.
Are you going to be able to keep that promise?	Je waweza kuidai ahadi hiyo?
The fans pick: Indiana Jones and The Temple Of Doom	mashabiki wanachagua: Indiana Jones Temple of Doom
"""At this time, the only confirmed positive cases are staff members and they have been in isolation since September 20, 2020,"" Burt said."	"""Punguzo hili litakuwa chachu ya kuwavutia wakuliwa na wadau mbalimbali na litaanza kutumika kuanzia Februari 20, 2020"" amesema Hasunga."
Many global companies operate in our nation.	Kampuni nyingi za kimataifa hufanya uzalishaji katika mji wetu.
This film is a hope for those who feel demotivated and dejected.	Ni methali ambayo inatia matumaini kwa watafutaji na waliokata tamaa.
I do think there are pros and cons to the simulator.	Naamini kuna figisu na msigano fulani katika halmashauri ya Bukoka.
The fishing is notable here, too.	Jambo hilo la Kiislamu linaonekana zuri huko, pia.
It would have been a lot of work for no good reason.	Ingekuwa safari ndefu isiyo na sababu yoyote.
time to build a county jail.	Ni wakati wa kuleta ili nyumba ya wafungwa wa kifalme.
Don't forget first and second step of this article.	Usikose sehemu ya pili na ya mwisho ya makala hii.
I trust you and your word.	Ninakuamini na neno lako.
"Walt Disney Screencapture of Flounder from ""The Little Mermaid"" (1989)"	"Walt Disney karatasi la kupamba ukuta from ""The Little Mermaid"" (1989)"
Young men in group portrait.	Watoto wa kiume wa marehemu katika picha ya pamoja.
But if God tells them that He will rescue them, and they believe that, they have chosen what cannot be known over what is certain.	Waumini hao walipoulizwa kuhusu sehemu wanapolalala, walijibu kuwa Mungu ndiye anajua wanapolala hata wao hawaelewi.
Ecocoast was founded precisely to prevent damage and pollution to our coastlines and waterways, and over the last decade, we, as well as our subsidiary Bolina, have developed a range of innovative and industry-leading technologies that have been demonstrated to reduce water pollution from construction-related activities.	Ecocoast ilianzishwa kwa usahihi kuzuia uharibifu na uchafuzi wa mazingira katika ukanda wa pwani na njia za maji, na kwa miaka kumi iliyopita, sisi, pamoja na tanzu yetu Bolina, tumetengeneza teknolojia anuwai na zinazoongoza kwa tasnia ambazo zimeonyeshwa kupunguza uchafuzi wa maji kutoka shughuli zinazohusiana na ujenzi.
When removing people, change the passphrases	Binadamu hupotoka, huonesha udhaifu,
Carrot is well known for their health benefits.	Vitunguu vinajulikana kwa mali zao za faida.
Here we become aware of what we don't know.	Tupo hapa kujuzana yale tusio yajua..
I would like to think that I can make a change so my sons don't grow up to be whiny bitch excuses for men.	Ninataka kuamini kuwa watoto wangu wanaweza kukua bila ya kuomba msamaha kwa kuwa weupe.
Or is it that she's only charming when she wants to be?	lakini huyu dada ataka nn wakati ana kwake?
"In the picture, he was looking at his daddy saying ""cheese."""	"Katika video hiyo, Princess huyo anaonekana akimshitaki baba yake kwa ""kumteka"""
"v.24 So Joab went to the king and said, ""What have you done?"	"24 Kwa hiyo Yoabu akaingia kwa mfalme na kusema: ""Umefanya nini?+ Tazama!"
It is a complicated journey.. but it is God's will.	Ni ngumu kuikubali hali hiyo lakini ni mapenzi ya mungu.
This is a powerful video converter that has a wide range of file compatible.	Hii ni nguvu video converter ambayo ina mbalimbali ya faili compatibilities.
He's your Provider.	ni mwokozi wenu.
(c) provision about the interpretation of this Chapter (see section 598).	c) Fafanua umuhimu wa msemaji wa kauli hii katika riwaya hii. (alama 8)
Many people love to talk about their childhood.	Watu wangapi wanaopenda kutaja umri wao waziwazi?
Let's keep the free for all going until we really have a winner	kutosha wachezaji wetu hivi sasa ije timu yeyote tuu sisi sawa
12So Hiram came out from Tyre to see the cities that Solomon had given him, but he was not pleased with them.	12 Basi Hiramu akatoka Tiro kwenda kuyaona majiji ambayo Sulemani alikuwa amempa, nayo hayakuwa sawa machoni pake.+
I have no problem with benchmarking against comparable jobs in the private sector if it involves resultant pay reductions.	Ninavyofahamu sekretarieti ya utumishi wa umma hawahusiki na ajira za private sector so sidhani kama wanafanya kazi hiyohiyo ya TAESA.
He has overcome many challenges and has become one of the best batsmen of his time.	Ameshinda tuzo nyingi, na amekuwa mmoja wa wasanii wa kulipwa maarufu zaidi.
Fourth military coup in Nigeria.	Mapigano yaingia siku ya nne nchini Nigeria
'What do you want, kid?'	"""What ya want, kid?"""
morning's successful agreement.	Habari ya asubuhi Mwanamafanikio.
There were also a lot of mosquitos and keeping the windows closes was not an option because of the heat in summer.	Kuweka nafasi tena ilikuwa ndogo, na kwa sababu ya maumbile ya bidhaa, upepo haukuwa shida kutunza blanketi kwenye kaa.
It was a journey of 7 hours.	Ilikuwa safari ya masaa kama saba.
Then, he moved around to the adjacent side.	Kisha iache pembeni ipoe.
3 It was he who built the upper gate of the house of Jehovah, and on the wall of Ophel he built much.	3 Yeye alijenga lango la juu+ la nyumba ya Yehova, naye akafanya ujenzi mkubwa katika ukuta wa Ofeli.+
It's actually the first photo.	kweli hasa hiyo picha ya kwanza.
They do it because they care about me.	Nafanya hivi kwa sababu nawajali.
Without money you're in prison.	Na wewe huna pesa ju utaenda jela
There has been no hostile action in Korea in 54 years.	hakuna kilichofanyika katika miaka 54 ya Uhuru.
Their arrogance isn't even thinly veiled anymore.	Tena bado nguvu yao haijaonekana hasa subiri tu.
night when the policeman said to use it.	Mkuu usikurupuke hao kinadada walijiita wenyewe hilo jina.
The whole thing has been so obnoxious and devaluing of women.	Yote haya yamejikita katika hali nzima ya mwanamke kutojiamini na kutojithamini.
"""In the past seven years, I can count on one hand, and still have leftover fingers, how many instances I've seen of this"" kind of issue, he says."	"""Sitaki kuwa kahaba tena, nimefanya biashara hizi kwa miaka saba sasa na siwezi kumbuka ni wanaume wangapi nimeshiriki ngono nao "" Mwanamke huyo alisema."
• It's non-caustic	News _ Hakuna Casting
"""You look like a bum, why are you with my daddy?"	"""Unaonekana kuwa na pilikapilika nyingi, kwa nini hujionei huruma mpenzi wangu?"
I think the unborn baby does have some rights but a born living child.....Not sure you can say they are equal.	Sioni hata pointi yako hapo...huyo ni Mtoto wa kizungu na analiliwa na Wazungu wenzake kwa matatizo ambayo hajajitakia, nadhani wana haki ya kufanya hivyo.
Time ticked by and still I had not found the religion that seemed to speak to my heart.	Muda ulisonga mbele na bado sikuwa nimepata dini inayo onekana kuzungumza na moyo wangu.
The Prophet replied, 'I did not give	"Mtume (s.a.w.w.) aliwaambia: ""Sikuja kupigana."
God wants to heal you and help you.	Mungu azdi kukutumia na kukuinua.
I hardly live when I am away from you.	Mimi si kushoto wewe wakati mimi kuvuta mbali.
Hester is ungrateful.	Hester Udani
I would love to purchase your app, but I don't have a smart phone that can use it.	Ningependa kukujiunga Lakini laptop Sina je sitoweza kukuiga?
It's only when I blow	Ni kitunguu tu nikatapo
A lot of you tell me that:	"""Baadhi yenu mnatuambia kuwa,"
Whereas we do not sin.	kama hatutendi dhambi.
Health insurance: OeAD scholarship holders need to have health insurance that is accepted by the Austrian authorities for the duration of their stay in Austria.	2) Bima ya afya: Wamiliki wa elimu ya OAD wanahitaji kuwa na bima ya afya ambayo inakubaliwa na mamlaka ya Austria kwa muda wa kukaa yao huko Austria.
The educational program encourages ...	Programu ya elimu inalenga watu ...
synced in 14 days	Kama inajulikana, ndani ya siku 14
In fact, reading is the first step.	Kusoma ni hatua ya kwanza.
Do not seek to save your lives, for he that is afraid to die for the truth, will lose eternal life....	"Msikiogope kifo, kwani yeyote yule aogopaye kufa, hupoteza heshima."""
Freedom from worrying about food all the time.	Neema ya kuwa na njaa kila wakati ya vitu vyako.
Get home and trying to get this recipe	Uje huku wewe kibendera Njoo ujibu hii
Let's go back to your original question.	Tukirudi kwenye swali lako la msingi.
We are not told what they did.	Hatujaambiwa zimefanya nini.
No can be dumped from a 3DS	Hatumi Kudo 3some fuck
I love to read the JW publications.	Nami hufurahia kusoma vichapo vya Watch Tower Society.
-Full House is currently airing on Nick at Nite	hahaha saje je boring la nick tu
"Many times he told me, ""This is the best country in the world."""	"alfajiri: ""Hizo ni bora zaidi kwangu kuliko dunia yote."""
She's been working as an aide for the past 20 years, I'm in year 4, but it doesn't matter, I am the teacher.	Rais alikuwa Waziri kwa miaka 20, mimi ndiyo kwanza mwaka wa nne...bado najifunza!
We wanted to do it for Michigan.	Lakini tulitaka kuijua Michigan.
It's a matter of going there and working	huo, ni bora kuingia kazini na
and encircle the republic of San Marino.	hizi linaunda Jamhuri ya San Marino.
In ________ number of weeks we will be celebrating the Lord's Supper again.	Karibuni...sana..tusherehekee Pasaka ya Bwana...
through the sheep.	na mazizi ya kondoo.
How do you sell what you don't have?	Tunarudishaje ambacho hamjakinunua?
She was one of the invited speakers at a All-Women Forum held in Penang recently.	Ni miongoni mwa walioshiriki kwa namna moja au nyingine katika mkutano wa kidunia wa haki za mwanamke, maarufu mkutano wa Beijing mwaka 1995.
Likewise, we would like to thank	Aidha, tunapenda kuwashukuru
The trip was hugely successful for me.	Hii ziara ilikuwa ya MAFANIKIO saana kwangu.
Consultants have been working on this for 30 years.	Watu wamekuwa wakifanya kazi hapa kwa miaka 30 kwa suluhisho.
Not worth trying to figure out.	Hakuna maana katika kujaribu kuificha.
He's lost his dead-end job, ...	Ameacha kazi kubwa sana ya kumalizia, h ...
Bush didn't have a good relationship with Iran.	China hawakuwa na yoyote kubwa ya mahusiano na dunia mpaka.
Voice cast for the main characters	Sikiliza Kwa Wahenga Main Title
arresting and prosecuting them	Kubainisha na kuvitumia katika sentensi
Goodness and Peace in Your life forevermore!!!	Upendo na amani vitawale mioyoni mwetu daima!!
"Jesus told this parable in Luke 13:6-9: ""Then he told them a story: ""A man had an apple tree planted in his front yard."	"LK 13:6 Kisha, Yesu akawaambia mfano huu: ""Mtu mmoja alikuwa na mtini katika shamba lake."
The suffering that comes through poverty is not God's plan.	Umaskini sio mpango wa Mungu.
This is not the first time that McGregor has announced his retirement.	Hii sio mara ya kwanza kwamba McGregor ametangaza kustaafu kutoka katika mchezo huo.
I have pondered the days of old, The years of ancient times.	Nimezingatia siku za zamani, Miaka ya nyakati za zamani.
He had no money, and little backing.	Alikuwa hana fedha za kutosha, na alikuwa hana ujasiri wa kutosha.
I am travelling from Amsterdam.	Mimi ninatoka Amsterdam.
"""Maple Leaf doesn't need the money."	"""Daktari WST si mjinga kiasi hicho."
I know about public domain.	Mi najua kuhusu notary public.
Their little ones will be dragged off.	Menyu ndogo itafunguliwa.
Can you imagine on the above.	Unaweza kufikiria jinsi ilivyo chini?
Thank you for the recipe, I have been craving Pudin for a very long time!	Nashukuru mkuu majimoto, nimetoka Brela muda si mrefu!
It's immutable once the JVM starts.	Haiwezi kujitenga wakati YHT itaanza
It is a great opportunity to have people like you in the BlogoSphere.	Ni bahati kuwa tunao watu wa aina yake katika blogu.
Often groups were formed to practice.	Ilikuwa mara nyingi shule zinajengwa ovyo ovyo.
It was not to learn.	si ndio amekuja kujifunza.
The fact that men want someone with whom they can be free emotionally isn't a surprise.	Huyo rafiki yako anayeomba kuzaa na mumeo si ajabu wana uhusiano wa kisirisiri.
He demanded the owners to lower the prices.	Mugabe awataka wafanyabiashara kupunguza bei za bidhaa.
Evaluate the short- and long-term implications of every decision	Faida za muda mfupi na muda mrefu wa kila maamuzi atakalofanya
Here is a gracious promise for the season of conflict and trial - a promise, oh! how often realized by the children of God.	Jawabu: Hukumu ya kutoa Zaka ya nafaka na matunda ni wajibu, kwa kauli ya Mwenyezi Mungu Mtukufu:
On the other hand, if you earned less than expected, you may have been	ukipata wastani kuliko ulivyotarajia, pengine umekuwa ukipata kidogo kuliko
Prophet Muhammad (Pbuh) commanded knowledge upon all Muslims, and urged them to seek knowledge as far they could reach, and also to seek it at all times.	Muhammad (amani iwe juu yao wote) Hawa wote walitumwa kwa jamii zao wakiwa na muongozo wakiwafundisha watu yote anayoyataka yeye (Muumba) pia asiyoyataka.
What you've fed to me?	Umekuwa chakula changu nikupe nini?
A girl who's for real all the time	Muungwana yeye ni mtu wa matumaini siku zote
azealia banks is back	Bahia Hotels Bathinda
Phone numbers must be 10 numbers.	Nambari ya simu inatakiwa iwe na 10 tarakimu.
I'll kill my darling	fubuki my waifu
So we are a non-profit specialist clinic - and act accordingly.	Kwa hivyo tunataka kuwa kliniki ya wataalamu isiyo ya faida - na kutenda ipasavyo.
The one everybody watches on tv or other media.	Watu wengi wanakesha usiku kwenye TV au katika mambo mengine.
Me and Keith and a couple of other people	Marley and Me Kura Za Maoni
156 Teaching What You Don't Know	Somo 15 - Usiyeonekana na uliyo mjuvi
it's only pain	Ni huzuni tu
Tom Dugan... you know it.	Dah Mwanang unajua.....Nimekuelewa.
It is enough to say that you aren't yet quite ready to make a decision on such a big step.	Tatizo ni kwamba watajua kwamba umechukua hatua kama hiyo ambayo sio nzuri sana.
Abridged Version - Wish it wasn't	Make a Wish _ uNgatawwa
The majority of them only wish a better life with no political involvement.	Asilimia kubwa wanafikiria zaidi kuhusu maisha mazuri yasiyo na mikwaruzano.
My device is 64-bit but it's not!	dah wangu mie ni 1st n last lakini hayuko hivyo!
And this is going to create all sorts of problems for our state.	Tutafanyaje tufanikishe hilo ni changamoto yetu sote Serikalini.
Houses at Beacon Hill in Boston.	Nyumba katika Beacon Hill katika Boston.
How to Find The Courage to Move On	lile ,atapata wapi tena ujasiri wa kusimama
The Engine Comes to Life	Engine Comes Alive
It's not a homerun... that will be when we're production ready but the bases are definitely loaded.	Sio homerun... hiyo itakuwa wakati tunapokuwa tayari kwa uzalishaji lakini besi hakika zimebeba.
We can not see that this passage from Isaiah ever before have been fulfilled.	V katika hawezi kuona kuwa sura hii ya Isaya hapo awali utakamilika.
Then she gave up trying to maintain the facade, and she leaned into him.	Kisha akajilaza kwa kujiegemeza kwenye tumbo la Mwasha huku bado amemkumbatia.
"""Bring your own soda"""	"""Kunywa sumu yako mwenyewe yaliyotolewa na"""
When the trial drugs stopped, she was sent home.	Mara tu kupona katika kliniki kumalizika, mwanamke huyo hupelekwa nyumbani.
OEM/ODM are welcomed, we can produce products according to your requirements.	tunakubali OEM & ODM, Kampuni yetu inaweza kukuza na kutoa bidhaa kama wateja mahitaji maalum.
Close-up view of a beautiful butterfly	Beautiful Images of Anarkali Dress
this year's Mt.	Mbio za mwaka huu za Mt.
I've read their story.	Nimekubali kusoma hadithi yako.
Your problem is that he didn't come out an apologize for having bad information?	Si ameomba msamaha kwa picha kushindwa kuupload?
who wants to be a millionaire online game says:	Embed mchezo Ambaye anataka Millionaire dunk katika tovuti yako:
"""They fight against those who combat corruption."	"""Wasjifanye wao ndio wanapigana na vita dhidi ya ufisadi."
And you are, indeed, good people.	Na baada ya haya mtakuwa ni watu wema.
The technology allows you to enter a virtual world where everything is possible.	Sisi kuwapa nafasi ya kutimiza yako kinks katika dunia virtual ambapo kila kitu ni iwezekanavyo.
"""Modern education cannot be imagined without the fast and reliable Internet."	"""Siasa za kisasa za Uropa haziwezi kuwepo bila vyombo vya habari huru na vya uaminifu."
How did you learn to use these?	wewe umejuaje katumia hizo hela?
Do not mix religion with politics.	Mwiba acha dini twende kwenye Siasa.
It was through these kids that I found my sense of purpose.	Kwa kupitia hadithi hizi nilipata hisia ya urithi wangu.
His vice president was John Breckinridge.	Kaimu Rais wake alikuwa John Breckinridge.
Another type of in-vivo dosimeters are diodes.	Aina nyingine mbili za hibiscus ni bustani.
The criminal justice system must be strengthened.	Kuimarisha mfumo wa utoaji haki ni jambo la lazima.
And the best one is what you have pointed out here.	Moja ya maarufu zaidi ni ile ambayo tutakuambia hapa chini.
It's important to always maintain your property.	Ni muhimu sana muda wote kulipa mikopo yako.
"""It""s the [ ði: ] best book I've ever read."""	Hii ndio (ya kupendeza) .......... kitabu ambacho nimewahi kusoma.
Percents Greater Than 100% or Less than 1%	cha asilimia 0 badala ya asilimia 100 au
So, what's your favorite Region of Pokémon?	What Is Your inayopendelewa Pokemon Region.
America is going...	Marekani itajuta kui...
O prophet ! rouse the believers to fight, if there are twenty patient ones of you, they shall overcome two hundred and if there are a hundred of you, they shall overcome a thousand of those who do not believe because they are a people who do not understand.	Wahimze waumini wende vitani; wakiwepo miongoni mwenu ishirini wanaosubiri, watashinda mia mbili; na kama wakiwa mia moja miongoni mwenu watawashinda elfu moja katika waliokufuru, maana hao ni watu wasiofahamu.
Ultimately, the water comes down to the surface in the form of rain or snow.	Hatimaye, mvuke huo hurudi duniani ukiwa theluji au mvua.
It appears from the verses of the Qur'an that change of qiblah was not due only to the objection of the Jews, but there was also another reason for it.	Kutokana na aya hii ya Qur'ani inaonekana kwamba kubadilika kwa Qiblah hakukufanyika tu kwa sababu za upinzani wa Mayahudi, bali kuna sababu nyingine za mabadiliko haya.
People seemed surprised that we found them, but we knew we found something special.	Watu waliokuwa eneo hilo walishangazwa na tukio hilo, lakini sisi tulijua hiyo ni mojawapo ya kazi za majasusi.
This often leads to conversations about faith and opportunities to pray for people.	Mara nyingi inafuata hotuba, halafu ungamo la imani na maombezi kwa ajili ya watu wote.
Should we eat them raw or cooked?	Au ndio tutakula nyasi au kupiga mbizi?
Sir, sporyshev and then urged them to know.	Mheshimiwa Naibu Spika, baada ya kuyasema hayo naomba niwasilishe.
3) You need to let everyone know a minimum of 10 times per day that you are on a diet.	Tafadhali kumbuka kwa kila mtu ataweza kupiga kura mara 10 kwa siku kwa kila akaunti aliyoisajili.
Father, in the name of Jesus, enthrone the reign of justice and equity in Mauritius so as to secure her glorious destiny. - Daniel.	Baba, kwa jina la Yesu, enesha enzi kuu ya haki na usawa huko Gambia ili kupata hatima yake tukufu. - Daniel.
It still energizes, and it is still explosive.	Bado ina joto, na inatoa gesi.
Paradise was lost and there was no way back.	Paradiso ikapotea, na hakuna mtu ambaye amefanikiwa kuirudisha.
I think there are 2 possible reasons:	Nadhani kuna mambo mawili yanayoweza kuwa sababu:
Poverty is an enormous social problem.	Social phobia ni tatizo kubwa sana.
We've heard the Force called:	Hakika sisi tumemsikia mwenye kuita akiitia Imani kwamba:
Daner told the investigator that he had borrowed it.	Padre Edward akamweleza yaliyomsibu.
32 If he can't, then while the other king is still far away, he will send some people to speak to him and ask for peace.	"Ikiwa kwa kweli hawezi kupata ushindi juu yake, basi wakati ule mufalme mwingine angali mbali, yeye anatuma baraza la mabalozi na kuomba amani."""
19th Days of Croatian Film	11 Septemba Waongozaji wa filamu wa Uhispania
In the Kingdom one enjoys the presence of God and His heavenly beings, and past sins are forgiven.	Kwa hiyo Mbinguni ni nchi iliyopo katika ulimwengu wa roho na utawala wake ni wa kifalme ndiyo maana Mungu ni mfalme wala siyo Raisi.
it's the Virus	Vitakuwa ni virus hivyo
He said: (then) I'm the most miserable one, O Messenger of Allah.	Akasema: Nikasema: Ewe Mtume wa Allah, mimi hakika naweza kufanya vizuri zaidi ya hivyo.
Do you remember the new guy who just moved into the family of ladies?	Unakumbuka Wakati Wale Waombolezaji Wanampeleka Kumzika Mwana Wa Pekee Wa Yule Mjane?
Art with the South Shore Art Center - Pen & Ink	Mtengano ndani ya Dayosisi ya Kilutheri ya Kaskazini mwa Tanzania - Inventaires et archives en ligne
The United States is looking at intelligence reports that suggest North Korean dictator Kim Jong Un is in serious danger after undergoing a surgery.	Serikali ya Korea Kusini inaangalia undani kwa taarifa zilizoripotiwa na Vyombo vya Habari vya Marekani kuwa Kiongozi wa Korea Kaskazini, Kim Jong Un ana hali mbaya baada ya kufanyiwa upasuaji.
Put a picture, it will be better	Ila ungetupia na picha ingependeza zaidi
a link was added: BB to be inducted into the Rock and Roll Hall of Fame! over a year ago by ediebutt	a link iliongezwa: BB to be inducted into the Rock and Roll Hall of Fame! zaidi ya mwaka mmoja uliopita by ediebutt
The way of untruth and lies and falsehood is the way down into it.	sababu lilikhiari njia ya baat'ili, nayo ni ukafiri na uasi!
It is very hands free.	Kuna mikono mingi kila mahala.
A mother of Methodism	Mama Mia Methodologia
The Shoshones won't hurt	Beers won't hurt ya
Since the additional cost of a Party Pass is so small, why not go for it?	Na kwa kuwa bei ya poda ya Lycopene sio juu sana, kwa nini usitumie?
Will they be able to know?	Watakuelewa basi?
This isn't just another case for Adam.	Na ndoa hiyo si nyingine Zaidi ya ile ya ADAMU.
They were not the major targets of the Stingers.	Hata hivyo, hayakuwa haya ni malengo makuu yaliyokuwa yakiaminika kuwa na athari kwa wenye kuonewa.
Share your ideas and suggestions about the game here.	Nitumie maoni au mapendekezo yako kuhusu kampeni hii hapa
Are you a true God?	Je, Wewe Ni Muumini wa Kweli wa Mungu?
Atlético Madrid have the best defense in the championship with 16 goals conceded (including 7 conceded at home) since the start of the season.	Atlético Madrid ina ulinzi bora katika michuano hiyo ikiwa na mabao 16 yaliyofungwa (pamoja na 7 yaliyofungwa nyumbani) tangu kuanza kwa msimu.
located where there is the main road.	Je eneo liko upande gani wa main road.
Defenders of the doctrine of the Trinity often claim that it is a mystery which cannot be properly understood.	Watu wengi wanaoamini Utatu wanasema kama fundisho hilo ni fumbo, yaani, haliwezi kufasiriwa.
Smith and Thorson were very close.	Jolie na Thornton walikuwa mkali pamoja.
You will be able to get answers and even ideas.	Tyta hata ww waweza kuwa na majibu au idea!
solely on the impact	Minimiza tu impacto
The door was open, but everything was gone.	mlango, lakini yote ilikuwa imefungwa.
Our development team has put a lot...	Timu yetu ya uhandisi ilifanya mengi kushinda ...
A good representation of rock genres.	Good Riddance watu wa Nyamagana.
Camembert - Living in the Fields	Garaj Mahal - Live at Kuumbwa
KW - spin dephasing	KW - wake detection
We made use of the Provençal BBQ on a couple of the nights.	Tulitumia kwa kutumia betri ya WPA2 ya CMOS kwenye bajeti ndogo.
"""My health is really well."	"""Huyu wa kwangu kwa kweli yuko vizuri."
"11 So I swore in My anger, ""They will not enter My rest."" a"	"11 Kwa hiyo niliapa kwa hasira yangu, 'Hawataingia+ katika pumziko langu.' ""+"
Also, given the different opinions of fans, it is very difficult to have a perfect list.	Lakini pia kupungua kwa idadi ya wanaopimwa, kuna maanisha kwamba vigumu kupata picha kamili ya jinsi ilivyo.
favored a society under the control of sociologists!	Msaada kwa anayefahamu sociology!
The Migratory Route	Ndutu Migration Safari
This is the same with maintaining our appliances.	Inakuwa sawa na kuramba matapishi yetu.
This story describes everything.	This time mtaeleza kila kitu.
Title page from An Apology for the Life of Mrs.	Barua ya Mark Kuomba Msamaha Kwenye Kurasa nzima ya Gazeti
If you're outdoors in bright light, you can use the sun as your key light.	Ikiwa uko nje kwa mwangaza mkali, unaweza kutumia jua kama nuru yako muhimu.
Comptoirs: the political geography of small-scale gold mining labour in Burkina Faso	AJIRA: Nafasi za kazi Geita Gold Mining Jobs in Tanzania
So it depends on what you want	So inategemea wewe unahitaji kipi hapo
1 The Apostles and the brothers who were in Judea heard that the Gentiles too had accepted the word of God.	Siku zile, mitume na ndugu waliokuwako katika Uyahudi wakapata habari ya kwamba watu wa Mataifa nao wamelipokea neno la Mungu.
In effect, Satan claimed that his rule would be better than that of the Creator.	Hivyo, Shetani alidai kwamba utawala wake ungekuwa bora kuliko utawala wa Mungu.
stand in judgment of God.	Na mt'iini Mwenyezi Mungu katika hukumu
This must always be arranged according to the mandate of the victim.	Hii inapaswa kusambazwa kila wakati pamoja na dhana ya waendeshaji.
He's even trying to feed himself with a spoonful!	Anadiriki hata kuapa uongo kwa jina la Swaumu!
In the meantime, you tell falsehoods.	Hapo mnadanganyana.
By the time I got old enough to do it myself, I knew what I was doing.	Basi mtu mzima nilijiona mwepesi mwenyewe utadhani nilikuwa najua hata nilichokuwa nakifanya.
The withered towns are empty, but not uninhabited.	Mji ulio neemeshwa lakini hauna fadhila,
As someone who has classes, I am grateful for the weekly challenges.	Mzee ES na choveki, nashukuru kwa challenging questions.
"As an example, the Noble Prophet Muhammad (p.b.u.h.) said: ""Nothing will weigh more heavily in the balance of the believing servant on the Day of Resurrection than a good attitude (towards others)."	"Kutoka kwa Mtume Muhammad Mustafa (s.a.w.w.) amesema: ""Hakuna Muumini (yeyote) isipokuwa mimi ni bora kwake zaidi kuliko watu (wote) katika dunia na akhera."""
put your name on the list and win prizes!!	Kuwa Bet On hila yako ya Mkono And Win Tele Cash!!
"He hadn't passed away yesterday but two years ago in September 2017."""	"Halikujitokeza wiki chache zilizopita bali lipo tangu mwaka 2000"""
But they're just happy.	Wao ni furaha tu.
when we stop to die...	tusipoziba ufa...
One of the ducks was banded in Maryland.	Vipeperushi laki moja vilitawanywa jijini London.
Prescription drug abuse and misuse is a national and local problem.	Tatizo la vijana kutumia na kuathirika kwa dawa za kulevya ni njanga la kijamii katika ngazi ya kitaifa na kimataifa.
He had left behind his luggage and a note saying he wanted to stay in Japan and work.	Aliacha kijikaratasi chenye ujumbe pamoja na mizigo yake akisema anataka kubaki Japan na kufanya kazi.
I've met his two sisters, and I know of him.	Alinitambulisha kwa wadogo zake wawili wa kiume, na ndio nilikuwa nawaona.
American English: self-inflicted	English: Kujitha
Some people want food.	Kuna mtu yeyote anayetaka chakula.
How magical it is to come back to a world I love and to visit characters I've come to know and enjoy seeing them again.	Nilisisimuka kama nini kurudi tena Betheli tulipohudhuria shule na kukutana na watu wengi ambao nilikuwa nimewapenda na kuwaheshimu!
"I'm coming along and I suggest that there's no time to lose."""	"""Tutaangalia, naona muda hauniruhusu"""
"""It's very difficult to get supplies from farmers."	"""Ni vigumu kuwafungia wauzaji chakula biashara zao."
Stringing the blues.	jinging the blues
Also If someone does take his place, or if he does come back...	Hata kama mtoto wako atarudiarudia, au
and ask for help or money.	Omba Msaada Na Fedha
"God this is so long"""	"""Mungu wangu mpaka saa hizi?"
Just two hours for a little sleep.	Hata kama ni kulala kwa sekunde chache.
Today, we're witnessing history.	Leo tunashuhudia historia.
Don't forget the wild animal lover	umesahau kipenzi cha wengi kiroba
The top four teams from each group will move on to the next round.	Timu zitakazoshika nafasi nne za mwanzo katika kila kundi zitaingia katika hatua inayofuata ya mtoano.
The McDonald's website also	Pia Mia's Website
Here's immediate help!	Upatikanaji wa Papo hapo!
18:36-38 When he heard the crowd going by, he asked what was happening.	"18:36 Aliposikia umati wa watu ukipita aliuliza, ""Kuna nini?"""
I see you are a neighbor to me!	Nadhani hapo wewe ni jirani yangu!
Concept of business start up.	uzalishaji wa kibiashara unapoanza.
These same rebels are fully backed by Israel's government.	Kutokana na mazungumzo haya, kulikuwa na msaada kamili kwa serikali ya Iraq.
You can easily:	Unaweza kwa urahisi:
Move towards or away,	aidha uende, au ukubali kuwa mnyonge,
An Egyptian flight student is facing deportation from the United States after posting on Facebook that he would not have a problem serving a life sentence for killing Donald Trump and the world would thank him.	Mwanafunzi mmoja raia wa Misri anakabiliwa na makosa ya kurudishwa nyumbani kutoka Marekani baada ya kuchapisha katika mtandao wake wa Facebook kwamba yuko tayari kumuua mgombea wa urais kwa tiketi ya chama cha Republican Donald Trump na dunia itamshukuru,kulingana na chombo cha habari cha AP.
You're a good person, sheepdog.	Wewe ni mtu mzuri, Bwana Doug.
"3 And Joab answered, ""The LORD make His people a hundred times more than they are."	"3 Yoabu akajibu, ""BWANA na aongeze jeshi lake mara mia na zaidi."
[36:33] And a sign to them is the dead earth: We give life to it and bring forth from it grain so they eat of it.	[36.33] Na Ishara hiyo kwao - ardhi iliyo kufa, nasitukaifufua, na tukatoa ndani yake nafaka, wakawawanazila!
I'm also amazed at the precision of your artwork and writing.	Nimependezwa pia na staili yako ya kuja na kitabu ulichoandika.
I knew I'd heal and life would go on.	Nilidhani nitavumilia na maisha yatasonga mbele
Two minutes, three seconds.	Dakika ya 3 kipindi cha pili.
(+) New feature: What's News feed: A real-time news feed, curated by The Wall Street Journal's award-winning journalists--featuring the must-know global news across business, finance, politics and the economy throughout the day.	(+) New kipengele: Nini Habari kulisha: habari kulisha muda halisi, iliyoangaliwa na Wall Street Journal ya kushinda tuzo-waandishi wa habari-akishirikiana lazima-kujua habari duniani kote biashara, fedha, siasa na uchumi siku nzima.
If the patient is in serious danger, he will be monitored continuously.	Ikiwa mgonjwa yuko hatarini kwa ugonjwa wa sukari, basi anapaswa kukaguliwa mara kwa mara.
"what sort of man is Mr. Kennedy?"""	Aina keje kat maner?'
Modern slavery must come to an end.	Mpira wa kisasa unahitaji hela.
"""I've just had a son, my son is five months old, he had breathing difficulties, so I don't want to come home to put him in more danger."	"""Mtoto wangu ana miaka mitano tu, ana tatizo katika mfumo wa upumuaji, hivyo siwezi kurudi nyumbani kumuweka katika mazingira ya hatari kupata virusi hivyo."""
overgrownhobbit on Don't Fear The Wu-F...	Alafu kwa bahati mbaya sina ninaye muogopa hapa jf...
It also stimulates the physical activity of the body.	Hii pia huchochea utendaji wa mwili huu.
We are also looking at the shoulder seasons as areas that we can expand our growth.	Pia, tumekuwa tukiangalia soko linaloongezeka kwa huduma za wingu kama eneo ambalo lina uwezo mkubwa kwetu tunapanga kuchunguza zaidi.
I am married to Davy Crockett - king of the wild frontier	Niko tayari kuolewa na Wizkid - Lulu la Diva
Thanks for having me, Grant.	Asante kwa kunikaribisha, Mkuu.
in Germany and other European countries visit European Centre for Disease Prevention and Control	Tag: Nchi za Ulaya na Zilizoendelea Uchunguzi wa Kliniki Ubia
You are dead while you live.	Mnaokufa huku mkiishi.
Get-up, it is clear	wanyonge, ni wazi kwamba
This is the story of 6 people.	Hiki ni kiasi cha watu 6 takriban.
However, as God's children, we have the assurance that Satan is a defeated enemy.	Sisi mbele za Mungu ni watoto wa Mungu na Mungu hutenda sawa na vile vile unavyoamini, ukiamini nikimfunga shetani anafungika na inakuwa hivyo hivyo ulivyoamini.
If you hear a propeller-like	Ukisikia mguu wa bia ndio kama huu
The second I walked in he said I was a Type 1.	Nilipokuwa naingia form I yeye alinipokea akiwa Form III.
1990: You... and your sense of touch (1990).	*smiles* You, and your attitude. zaidi ya mwaka mmoja uliopita
What's your problem women?	Wanawake, mna matatizo gani?
"""If art is a crime, may God forgive me."" - Ramo"	"""Kama kuna mwenye kinyongo na mimi tusameheane"" - DIMPOZ"
Brazilian Samba in front of thousands of Latin	lowassa alivyowasili mbele ya maelfu ya watanzania
There are plants, trees, herbs, fruits and vegetables for all kinds of ailments.	[16.11] Kwa hayo Yeye anaizalisha kwa ajili yenu mimea, namizaituni, na mitende, na mizabibu, na kila namna yamatunda.
"He said: ""There were two or three little iffy starts there [from the rest of the field] but we got there in the end."	Kisha akataka kuadhini akamwambia: ((Subiri papoe)) mara mbili hivi au tatu mpaka tukaona kivuli cha vilima.
It is taught from elementary school up to university.	katika kusoma kwake, kuanzia shule ya msingi hadi chuo kikuu.
The accused were first arraigned in 2008.	Kwa mara ya kwanza washitakiwa hao walifikishwa mahakamani hapo mwaka 2008.
Medical research is vital to the populous of the USA.	Dawa ni kitu muhimu sana kwa wananchi wetu wa Tanzania.
16Truly, truly I say to you, a slave is not greater than his master, nor a messenger greater than the one who sent him.	16 Kwa kweli kabisa ninawaambia ninyi, Mtumwa si mkuu kuliko bwana wake, wala yule aliyetumwa si mkuu kuliko yule aliyemtuma.+
He was a German philosopher and...	Alikuwa mwanafalsafa Mjerumani ambaye ...
Nimoy's voice was a hook as well.	Huo uwekezaji wa NICOL nayo ilikuwa kama upatu.
Lastly, I added a new photoshoot.	Hata hivyo nami nimefungua gazeti tando jipya la picha.
the Old French	Kifaransa cha Kale
The Blog That Dripped Blood: January 2009	Video: Ajali ya kutisha iliyotokea Arusha mwezi Januari 2009
Peeping Tom details:	MBT Womens kisumu Shoes Details:
The front porch is across the entire length of the cabin!	Kifo cha kusimama kina soko kubwa katika sekta yote ya simu za mkononi!
Q: I would like to do the verbal introduction to our customers...	t:oa kuwa nsaada wetu wa kuongoza ka kaikama hizo atake shauri kwetu -
Media is an important agent of change in Bhutan.	OKEx ni ubadilishanaji mkubwa wa fedha wa Hong Kong.
Definition: a person who does not stop talking	Title: Meseji ya kumwambia mpenzi wako kuwa hutamuacha
"We have agreed to sign him until the end of the season,"" the Town boss told Ipswich Player HD."	"Tumeamua kulivalia njuga swala hili hadi mwisho ,"" alisema msemaji wa polisi wa Fort Portal Tumushabe."
Yes, civility is important.	Yes technologia ni muhimu sana.
Choose to be FREE.	Tume ya uchaguzi iwe huru..
Translation: They are not suitable to have at home.	Translation:Hawaji nyumbani leo.
The best thing about this TV?	Best huielewi hii TV?
"""If He will, He can be rid of you and bring (instead of you)."	Akipenda atakurehemuni, na akipenda atakuadhibuni.
Say, when are you going to start your blog?	Utaanzisha blogu yako lini?
It was speculated that one of the two men were going to have to leave as they were struggling to work with one another.	Wengine walidai kuwa wawili hao walikuwa na kitu walichokuwa wakiendeleza ikizingatiwa kuwa hushinda pamoja nje ya kazi.
Is it difficult for her to find a man?	Mwanamke ni ngumu kupata bwana mpya?
My name is, help, remember....	Rafiki yangu sio kweli, kumbuka...
Are you one of the runners trying out?	Lakini umeshawahi kuwa miongoni mwa abiria wanaojaribu kufanya hilo?
sacrifice of a virgin?	Kisa cha kumchungulia mwanamke mwenzio?
Don't be fooled and remember that you and your affections come first.	Usivunjike moyo wewe na Chama Chako endeleeni na jipangeni na mwishowe mtafika.
Keep them, don't toss them, time will tell the condition.	Jamaani, msikonde, visa zitapatikana.
After all, no business could be able to run without customers.	Hakuna biashara ambayo itaweza kujiendesha bila ya kuwa na wateja.
Then there's a good chance for help.	Basi uko mahali pazuri kwa msaada.
God created the creatures of the sea and the birds of the air and every living species.	Lakini Uislamu ni jumla ya hakika zinazo weka nyanja sahihi baina ya watu na Mola Muumba wao, kisha baina ya watu wote, wao kwa wao.
shorty drop.	Trudi Shortis.
Jews to strike coins of their own.	Wayahudi wanataka wenyewe hati miliki kutoka.
For who is able to govern this great people of yours?...	"Kwa maana ni nani awezaye kutawala watu wako hawa walio wengi?"""
However, despite this, before deciding to purchase it is necessary to weigh everything and be careful.	Lakini kabla ya kununua, unahitaji kufikiria na kupima kila kitu vizuri.
That's not the example of our Lord.	Hiyo sio 'style' ya Mungu wetu.
Oxandrolone can be the hero for people that shed remarkable weight after any type of surgical treatment, injury or any serious medical condition.	Oxandrolone inaweza kuwa shujaa kwa watu ambao hunyonya uzito mkubwa baada ya aina yoyote ya utaratibu wa upasuaji, kuumia au aina yoyote ya shida kali ya kliniki.
The Bible clearly states: God has given us eternal life, and this life is in His Son.	"Na tena katika hiyo sura ya tano tunasoma kuwa , ""Mungu ametupa uzima wa milele na uzima huo u ndani ya Mwanawe."""
The Nuvi 1690 has a suggested...	NYCkid69 ametoa maoni...
• Spread wealth, through interventions that directly reduce the concentration of wealth and power.	• Ukuaji wa kiuchumi nchini Ecuador imekuwa umoja, ambayo ina moja kwa moja kupunguza umaskini na kukosekana kwa usawa ngazi na kuongezeka kwa tabaka la kati.
women but now it's speaking	Wanawake Pemba wasema sasa basi
85% of respondents believed journalists had become less safe in the past five years.	Mkurugenzi huyo alisema asilimia 85 ya wananchi walisema rushwa imepungua kulinganisha na miaka mitano iliyopita.
She was a young lady who should not have died.	Lakini ni mwanamke ambaye hawezi kuuwa nyoka akafa.
Practicing smart money management encompasses many techniques and skills, intertwined with the trader's reasoning.	Kufanya mazoezi ya usimamizi mzuri wa pesa hujumuisha mbinu na ufundi mwingi, uliofungamana na hoja ya mfanyabiashara.
We don't always remember what we know.	Siongei jambo ambalo silijui siku zote.
We pack and ship to Germany.	Tunatuma Au Pair kwenda Ujerumani.
country for medical care.	nchi kwa ajili ya matibabu.
The Land Divided.	Nchi igawanywe.
Here are the Current Rules!	Hizi ni sheria za wapi zinazofuatwa hapa!
Get the correct quantity of drinking water on a daily basis!	Kwahiyo jiweke utaratibu wa kunywa maji ya kutosha kila siku!
Whatever, listen kid, I don't know what kind of game you're playing here...	Wake up folks! sijui wewe unayesoma hapa huko unajiweka fungu gani?
"I want Alaric and Keeley to be happy."""	"Natamani barabara hiyo iwe nzuri kwa Alaçam na Kestel. """
Bone broth: It's soup, but it's more than just soup - SooToday.com	welcome to samvande.blogspot.com: Suala la Mtwara ni zaidi ya Gesi asilia - Kutumia nguvu ya dola sio njia pekee ya Amani - Zitto Kabwe
It is these social causes that must be considered because they occur in an atmosphere of moral despair.	Hakika ni kuwa kama tunavyokariri mara kwa mara katika masuala ya kijamii ni kuwa matatizo haya yanatokea kwa sababu ya ukosefu wa maadili mema.
name three of them.	kwa jina la watu hawa watatu.
We don't miss out on life.	hatutajuta maishani.
government are compelled to listen to the	Serikali kuwa tayari kusikiliza na
"But it has never done so."""	"Lakini hajawahi kufanya hivyo."""
International Day of the African Child - June 16, 2009	African child day - Siku ya mtoto wa Africa June 16th, 2016
The Chosen One -- watch The Family folks....lol.	awwww ya folks? aka the fat man...two.
IsiXhosa is the first language of 25% of the population, while English is the first language of 20%.:25 .....	Kiswahili ni lugha ya Kibantu yenye misamiati mingi ya Kiarabu (30%), lakini sasa ya Kiingereza pia (10%), ...
My ancestors lived in this area prior to leaving for Dayton Ohio.	Babu yangu mzaa Baba yangu alikuja katika nchi yetu hii kabla haijaitwa Tanganyika.
Shouldn't we all speak, and act, and make our decisions with the same in mind?	Je, sisi sote hatupaswi kukubali na kufuata himizo hilo tunaposhughulika na wengine?
All things, therefore, whatsoever you would that men should do to you, do you also to them; for this is the law and the prophets.	Basi yo yote myatakayo mtendewe na watu, nanyi watendeeni vivyo hivyo; maana hiyo ndiyo torati na manabii.
part thereof, and will be declared	kwa mpango wao na watapata taarifa,
Many of Capote's stories were semi-autobiographical in nature.	Wengi wa lugha inapatikana kwa Avibase walikuwa ukarimu Tafsiri kwa kujitolea.
You don't need to re-sharpen the teeth, as they are durable and don't lose the quality for a long time.	Usipoteze, kwa sababu misuli ya nyuma imechoka, na huwezi kufanya kazi kwa muda mrefu.
He is one of the Civil War Veterans.	Huyu ni mmoja wa washiriki wa vita vya majimaji.
Make sure you and your household do not neglect the assembly of worshipers.	"""Rudi wewe na watu wa nyumba yako, na wasikubabaishe watu wa Al-Kuufah."
Do your children know anything about it?	Je hawa watoto wanajua lolote kuhusu baba yao?
Listen to others, but make your own decisions.	Sikiliza wengine lakini chukua maamuzi yako.
"""If the light which is in you be darkness, how great it is."""	"Kama taa iliyoko ndani yako ikibadilika kuwa giza,giza hilo litakuwa kubwa sana! """
I am very grateful that I can help.	Ninashukuru sana kwamba niliweza kuwasaidia.
keep us with the developments on Earth in order to be	Itoshe kusema tupo duniani kusurvive
"Many usually called ""Charlotte's internet,"" it's also known as ""Realm Oil"" or ""Alepsia."""	"Mara nyingi inajulikana kama ""Sheria ya Kimataifa ya Kibinadamu (IHL),"" lakini hujulikana pia kama ""Sheria ya Vita"" au ""Sheria ya Mgogoro wa Silaha."""
I will send you a PM and we can have more detailed discussions.	Kwa mwenye nia anaweza kuni PM tutawasiliana zaidi.
Close Back Unrounded Vowel	Split moja kuwa upande mmoja Sleeveless Skirt
The scope of the Fund includes support to internally displaced persons in Iraq and support in the Western Balkans to non-EU countries affected by the refugee crisis.	Upeo wa Mfuko huo ni pamoja na msaada kwa watu waliohamishwa ndani ya Iraq na kusaidia katika Balkan za Magharibi kwa nchi zisizo za EU zilizoathiriwa na mgogoro wa wakimbizi.
"his wife was baptized."""	"Alibatizwa na familia yake. """
Visit the John Rylands library	Visit the Waunakee Public Library
Pornography is meant to arouse.	porn kizlini aliyor..
"""How many security guards and bodyguards do we have?"""	"""Kuwa makini na kuna walinzi wangapi?"""
Chapter 1: Why Pray?	Shiriki Shiriki 1 Kwa Nini Tusali?
"""Do not speak of what you know not!"""	Msidanganyike kusema msichokijua!
"If you are overwhelmed in your struggle with sin, read it to be reminded of God's grace and goodness."""	Mkikutana na jeshi, basi kueni imara, na mkumbukeni Mwenyezi Mungu sana ili mpate kufanikiwa. ***
All of it worth about $700-$800.	Inagharimu karibu $ 700- $ 800.
Which parts are past, present or future?	Pili matango gani, ya kisasa au ya kienyeji?
Published in 1972, it has been revised seven times.	25 ya Mwaka 1972 kama ilivyorekebishwa mara kadhaa.
This will help you to decide whether your business will be viable.	Itakusaidia kujua kama biashara yako inatengeneza faida.
Give each of them a shot before settling on your favorite.	Mtilie mume yeyote haya mafuta kabla ya tendo umkomeshe.
With Rexona you know your deodorant won't let you down.	Kama umeharibu jua kwamba Chadema haitakuacha tutakuumbua
