fresh milk).	nosey nose nose)
You can sign-up for the Dota 2 Reborn beta right now by paying a visit to the official website or just learn more about the new features that Valve implemented into the popular free-to-play MOBA.	Ungakwazi ubhalisele the Dota 2 Beta Reborn manje ngokukhokha evakashele main web site noma bamane uthole okwengeziwe mayelana izici brand-new ukuthi Valve ababulawa singene ethandwa free-to-play MOBA.
We hope this article will help you understand how important taking care of your feet is when you have diabetes.	Siyethemba ukuthi le ndatshana ikuchazele ngokuningiliziwe okufanele ukwenze uma imilenze yakho ilimala ngesifo sikashukela.
I wanted to share my system.	Ngangifuna ukwabelana inqubo yami nawe.
Italian Luxury boutique: the top 5 of the most important in Italy	Levanto La Spezia - phezulu 5 kakhulu romantic isitimela amade Europe
"She sweetly said, ""Mommy, tomorrow is your birthday."	"""Lethabo,"" kusho uMama, ""kusasa usuku lwakho lokuzalwa."
Big question is what is PBN and how...	Umbuzo womugqa wephethiloli we-PTFE ukuthi hlobo luni futhi yini ...
His songs are the kind of music you blast out if you want to have fun.	It izici iculo enkulu yezwe bokuthi niyoshabalala nithanda!
I can't give you any specific answers of what you can do.	Ngabe anginazo ngempela izeluleko ezisebenzayo kulokho ongakwenza.
It's critical you understand your brand and how you should start a relationship with your customers.	Kubalulekile ukuthi uqonde ukuthi ungubani umkhiqizo wakho, nokuthi kufanele ngabe uqala kanjani ubudlelwane naye
Everyone keeps on keepin' on in their own way.	Wonke umuntu oqhubeka ephila ngendlela yalo.
I don't consider companies my clients.	Futhi angithandi ukuncoma lezo zinkampani kumakhasimende ami.
Why did you not answer this question?	Kwenzeka kanjani ukuba ningawuphenduli lo mbuzo?
How to make Gummy Bear edibles	kanjani ukwenza rose gummy amabhere
I might try this on my Nexus 5 if it wasn't going to void the warranty.	Usebenzisa i-motherboard yakho yakudala eneRyzen 5 ngeke ikwenze uma kungekho ukusethwa kwe-bios kufakiwe.
A lot of people are getting benefits from this government scheme.	Abantu abaningi bakithi bathola ukusizakala kakhulu ngalo luhlelo lwamatoho emisebenzi kahulumeni.
"To that, I would direct you both to Psalm 68:6, which states ""God sets the lonely in families."""	"Omunye wemiBhalo eyamsiza iHubo 68:6 elithi: ""UNkulunkulu ubangela abahlala ngabodwa ukuba bahlale endlini."""
An autoinjector would be very useful in such situations.	Zisizakala evenini ezimweni ezinjalo kunzima.
Ask students to identify the meaning of the family members' names and respond to the questions:	Sibuze abafundi ukuthi bakholwa wukuthi kubalulekile yini ukwazi imuva lomuntu othandana naye, baphendule kanje:
In general, the programs can be divided into two types.	Ngokuvamile, uhlelo kungenziwa ihlukaniswe ezimbili izinhlobo.
The Silent But Deadly Betrayal	Idi Vishwanne Bali Chesthunda, Tholichesthundha
From the outside through to the interior; it is a cornucopia of visual delights.	Kusuka ngaphakathi kuye ngaphandle, yilezi: ungqimba lomjuluko-ungqimba lokushisa-ungqimba ongangeni umoya.
and walk in righteousness before Me, I will open their eyes that they may see the danger approach.	"Zihlomiseni ngeqiniso, nize phambi Kwami ukuze nginivule amehlo omoya khona niyobona zonke izimfihlakalo ezingaphakathi kumoya...."""
Together with A Collation of the Critical Texts of Griesbach, Scholz, Lachmann, and Tischendorf, with that in Common Use (1856)	Kanye nokuhlanganiswa kwemibhalo ebucayi kaGriesbach, Schloz, Lachmann, noTischendorf, esetshenziswa ngokujwayelekile.
I want to talk to Cassie.	Ngifuna ukukhuluma nale Cassie.
Hard working, down to earth, and worshipers of God.	bekulokhu kuvuke umbhejazane emhlabeni futhi kuvimbe intando kanye nemizamo kaNkulunkulu, kwenza izinto zaba nzima.
we've been told by the leadership on our side, Mr. Chairman,	Sixoxe lesiphathamandla se Tajamuka Sesijikile, uMnu.
You will see it move down the trough.	Uzobona inqubo iqhubeke kancane phansi.
There are a few matches that you cannot miss under any circumstances.	Sika nge sikelo izingxenye akukwazi kunoma isiphi isimo.
Teacher's Day is coming.	NoSuku Lothisha kuyeza?
Punishment is just a word.	Ukukujezisa kuthatha izwi nje.
Loving you doesn't mean I am a fool	Ukuthanda akusho ukuthi ngiyisi phukuphuku
But he would never forget his mission and purpose.	Kodwa Voznyi akayikhohliwe injongo yakhe futhi kuziwa woo.
Ask students what they would like to learn about the topic.	Buza abalandeli ukuthi yini enye abangathanda ukuyazi ngalesi sihloko.
The Messiah's identity is constituted in the mission of his disciples.	Umndeni wakwaMesiya ungowesigaba sokusebenza.
Learn the meanings of the verses through translations of the meanings of the Noble Quran in several languages.	Funda ngezinselele zokuhumusha amagama ezingoma ngezilimi eziningi.
Social and Economic Development of South Africa	yomphakathi nakwezomnotho waseNingizimu Afrika
Dinner traditionally begins with a tossed salad.	Ngokwesiko, isidlo sasemini siqala ngesaladi yokukhanya yemifino.
Athena has a driver's license.	Agnes Asimawe Ithungu
A few metres walking from the hotel there is a nice shopping centre.	Vele amakhilomitha ambalwa ukusuka maphakathi nalesi sigodi elalihlala isikhungo ukuzijabulisa.
This is the first aggravation of their fn and misery.	Lokhu kungumphumela omkhulu kakhulu wokuwa kweNhlangano Yezizwe Ezihlangene kanye nezicelo ze-United States.
"The first questions that people will ask is ""what can I do?"" and ""how can I help?."""	"Imibuzo yokuqala eBay nabathengisi kufanele bazibuze kukhona: ""Yini engingayenza ukuthengisa?"" futhi ""Ngingalutholaphi ukuthenga?"""
My Father sent me	Baba thuma mina
Your work and efforts are truly unmatched.	Kodwa ukuzinikela kwenu kanye nalokho enikwenzayo, akukho nokuncane.
I didn't vote for a number of reasons.	Angizange ngishintshe ngenxa yezizathu eziningana:
This is called Astronomy.	Kubizwa esiNgisini nge- astronomy .
Don't think you need new shoes?	Wayefuna izicathulo ezintsha?
3 For some reason...	3 njalo ngoba
Youth unemployment is a lot higher than it used to be.	Amazinga entsha entula imisebenzi makhulu kakhulu kunokujwayelekile.
It's especially helpful with congestion.	Iwusizo kakhulu uma usebenzisa i-console kakhulu
With our children, maybe it will be computer games and the Internet.	Abadlali kungaba ukudlala kuphi nge ikhompyutha ne-Inthanethi.
Orsay's story resembles HaydarpaÅŸa Train Station: 1939 is a useless building that has lost its station character because it is not suitable for long trains.	Indaba ka-Orsay ifana neHaydarpaÅŸa Isitimela sesitimela: I-1939 yisiteshi esilahlekelwe umlingisi wayo wesiteshi futhi ayisebenzi ngoba asifanele izitimela ezinde.
Though, he will continue to lead the students in prayer each morning.	Ngaphezu kwalokho, njalo ekuseni, bahlangane bakhuleke ndawonye phambi amakilasi.
I will go back to play it in prime season.	Ngizofika ukuba dancing kuso okwesikhathi zomkhosi.
Product of the year 2020 with a special license plate KVP 2020!	Ikhasino eNtsha eneLayisensi ye2020!
Although Kerry's campaign did not return phone calls, the Senator told the New York Times in its Tuesday edition that he is sympathetic to the union's complaint.	Lanxa umsakazo weStudio 7 wehlulekile ukukhuluma lesikhulumeli sikaRamaphosa, iphephandaba leSunday Mail libike izolo ukuthi iqula leli lizafika ngoLwesibili.
These are the new names	Nathi New Amagama
Users can set up a new account easily.	Abasebenzisi abangenayo bangenza i-akhawunti entsha kalula.
"He who understands it, earns it; he who doesn't, pays it."" - ALBERT EINSTEIN"	Abayiqondayo, bayayithola; abangayikhokhi, bayikhokhe - Albert Einstein
Once he asked his questions, she answered.	Uma bembuza umbuzo, wayephendula.
This is either due to the loss of evidence or due to insufficient evidence.	Futhi lokhu ixhunyiwe, noma ngenxa yokuntula amaqiniso noma ukuhlanekezela ngenhloso ubufakazi ezithile.
How do I get a scholarship to the University of Calgary?	Ngingayithola kanjani imfundo eCalgary?
Hey you, I am not a coward....	He:- em ayindi ivvala niku...
Many of those who take it also praise the mk 677 supplement because it does not suppress the existing levels of testosterone and growth hormones, which is a huge bonus if you consider the benefits.	Abaningi balabo abayithatha bancoma futhi isengezo se-mk 677 ngoba ayicindezeli amazinga akhona e-testosterone nama-hormone okukhula, okuyibhonasi enkulu uma ubheka inzuzo.
A mirror does not give relief.	Futhi isibuko asisho ukulotha.
"must have a staff for each of the following ""instruments"": the lower lip;"	ijika ukufunwa inhlangano ngayinye ihlukile, 'kokuwa' uhlamvu;
Let my heart rejoice in the fear of your name.	Kwangathi inhliziyo yami ingajabula, ukuze yesabe igama lakho.
107:38 he blessed them, and their numbers greatly increased, and	38Wababusisa, banda kakhulu,
From May until October south & west winds prevail.	Kusukela ngoMeyi kuze kube sekupheleni kukaSeptemba, umoya we-ningizimu-mpumalanga neseningizimu uyashaya.
This adds to the needed body protein on a daily basis.	Futhi kwendikimba evamile amaprotheni nsuku engayitholi kuyadingeka.
We can only communicated by whatever means we have available to us.	Bonke oxhumana nabo kungenzeka kuphela ngezindlela zokuxhumana ezinikezwe yithi.
The court will now pick trial date before the end of July.	Abameli babamangali manje bacela usuku lokuqulwa kwecala ngasekupheleni konyaka noma ekuqaleni konyaka ozayo.
This is done through prevention and the use of bat doors.	Lokhu kwenziwa ngokusebenzisa nokwethulwa kwale imisebenzi zokuxhumana idatha.
This is particularly important in the era of Covid-19.	Loku kumqoka ikakhulu esimweni samanje se-COVID-19.
The dispute also concerned the question of the economist's role, and whether this should be as a detached expert or a practical adviser.	Umbango futhi ukhathazekile umbuzo indima Economist sika, futhi ukuthi lokhu kufanele kube njengoba isazi bathinteka noma umeluleki esisebenzayo.
The entire pack participates in the protection and care of the pups.	Iqembu lonke lidlala indima ekunakekeleni nokukhulisa imidlwane.
Now it is time for working.	Isikhathi sokusebenza manje.
cities have surrounded the city.	La bantu bashe bangqonga nomuzi.
According to him, it can generate the same amount of light energy as the sun.	Nguye yedwa owayengenza into etshengisa amandla amakhulu njengelanga.
They married two weeks after Paul graduated.	Zishadane emva kokwazana amaviki amabili izitshudeni zase-Rhodes
"What's more, Jesus gave His disciples ""power and authority to drive out all demons and to cure diseases, and he sent them out to preach the kingdom of God."""	(Luka 8:46) UJesu wanikeza abafundi bakhe amandla afanayo negunya phezu kwawo wonke amademoni nokwelapha izifo ezazibathuma ukuba bashumayele umbuso kaNkulunkulu futhi baphilise.
Worst case scenario, the answer is no.	In the okubi kakhulu umbukwane ithi no.
For further reading, there are many	Further Reading on Ndabaningi Sithole
I love what all of you have done with Books & Quills, and I've loved the features so far.	I love you all guys ningenze ngathanda ukufunda namaPics sengiyawathanda
As, for instance, one who desired to convey a piece of property to another which he had possessed during life by trickery.	Njengokuthi, ngokwesibonelo, umuntu owayefisa ukudlulisa ucezu lwendawo komunye ayenalo phakathi nokuphila ngobuqili.
How to find the best online cannabis dispensary?	Ngemuva kwalokho, ungazithola kanjani imbewu engcono kakhulu ye-cannabis online?
All three have stayed silent.	athula ethu siranthathu..
This section further states that no provision may impede the state from taking legislative and other measures to achieve land, water and related reform, in order to redress the results of past racial discrimination, provided that any departure from the provisions of this section is in accordance with the provisions of section 36 (1).	Asikho nesisodwa isiqalelelo sesigabesi esingavimbela umbuso ekuthatheni umThetho namanye amagadango ukwenzela bona bothole inarha, amanzi nokhunye okukhambelana namatjhuguluko la, ukuze kulungiseke imiphumela yebandlululo ngokwebala kwangesikhathi esadlulako, ngaphandle kwanyana ukutjhida okhunye nokhunye eenqalelelweni zesigabesi kukhambisana neenqalelelo zesigaba 36 (1).
In other words, we are caused to live, thanks to the support we continue to receive from all existence in the universe.	Ngaphezu kwalokho, siyathokoza bona bahlala bakulungele ukusisiza nesizizwa siphelelelwa mamandla ngebanga lokugandeleleka esikufumana ephasineli.
Is there anyone who has never been to a big bead show before?	Kambe ukhona owake waya esithenjini ngenkani?
In the case of the deceased	Emhlenikweni wafayo u
Now the family is complete.	Umndeni wami uphelele manje.
People are losing their jobs, and entire companies are going bankrupt.	Abantu bakithi bayahlupheka imisebenzi iphelile zonke izinkampani zikaHulumeni ziwile.
Have you ever teamed up with a friend to lose weight or get fit?	Uke wahlangana nomlingani wokuphila ohlosiwe ukuba naye noma kufanele yini umnike umthwalo?
A little bit about the club...	Okuncane mayelana nehhotela ...
"The ""bad"" mother has been identified."	"A Mallard besifazane ""egqoke"" ahlotshiswe."
And I'm going to fight to clear my name.	Ngizobanga umsindo ngoba ngifuna ukugeza igama lami.
and I see you walk with me	Ngikubonil' uhamba nami
On the other hand, this can continue for two days, so players should make the most from time they've.	Angakwenza futhi lokho kodwa kulokho abadlali badinga ukulinda izinsuku ezingama-21 ezizayo.
I decided to challenge what I believe was the limit of God's love for me.	Ngathola ithuba lokuba ngikhiphe lokhu okwakusenhliziyweni yami engangizizwela ukuthi uNkulunkulu uyangisola ngakho.
It really is an addiction.	Kuyinto umlutha ngempela.
Everything else I can barely remember.	Engingakusho nje siyikhumbule kabanzi.
This is one of the reasons why it's important to routinely undergo check-ups.	Lesi esinye sezizathu ezenza kubaluleke ukuthi ube khona njalo emihlanganweni yebandla. - .
convulsive wanting	Ikhebula ngezifizo
What do you think about your gift?	Wena Sipho uzizwa unjani?
If your cookie dough is too soft, you can place it in the fridge.	Uma i-herring inomusa kakhulu, ungayifaka emanzini.
Europe, while this period lasted from 2 to 5 years in South-East	nkathi kokuhlala kwabo eGibhithe ingasaphathwa amabili nanhlanu namashumi
The police were called but didn't find a gun.	Amaphoyisa abe esebizwa, kodwa abatholanga ingane emfuleni.
Can you tell us why you want to keep your identity a secret?	Ungasitshela imfihlo yakho yokuthi kungani uthanda ukugqoka ngale ndlela kusukela kudala ungashintshi?
felicien meaning of life	samukelisiwe meaning of life
Voight: She's not ruled out.	Silinda: Akaxoshwe
Is there a prescribed method for teaching?	Ingabe kukhona ukufunza ngemfundiso ethile ngokuphoqa?
Facebook provides the website and the advertisers pay the money.	Facebook gives people the. izithakazelo zakwaMazibuko.
Many children will thrive in this environment.	Izingane eziningi zizokhula zikuleso simo.
ico, Texas, Nebraska, Kansas and others of the western states	I-Iowa, i-Nebraska ne-Kansas amazwe aseMelika emaphakathi
By providing information to the MPG through this website, the user is consenting to such transfers.	Ngokunikeza ulwazi kwabe-GCIS ngale website, umsebenzisi uvumela ukudluliselwa kwalolo lwazi.
There are no daily puzzles because you can generate a new one by clicking the desired difficulty level.	Awekho amaphazili ansuku zonke ngoba ungakha entsha ngokuchofoza ileveli yobunzima oyifunayo.
Your company's:	Inkampani Yakho:
The obvious reason is the purity of my relationship with God.	mangilinganiswe ngesilinganiso esilungileyo, ukuze uNkulunkulu azi ukuphelela kwami.
7 God was also offended by it, so he attacked Israel.	7 Kwaba kubi emehlweni kaNkulunkulu; ngalokho washaya u-Israyeli.
The solutions are designed to make decisions based on a thorough analysis.	Kukhethwa izixazululo kusekelwe kucutshungulwa ethile ulwazi substantiates isinqumo ukuze kwenziwe.
Sometimes I wasn't even right.	Ngezinye izikhathi bekungekho futhi ngithathe isinyathelo.
Get on With It (gift given)	Make U Stay (gift given)
This system allows you to quickly go from one exercise to the next.	Kukuvumela ushintshe ngokushesha kusuka kokunye ukuzivocavoca uye kokulandelayo.
It means to love one another	Retha Kundanani
When we read about the tourists coming to the island, teachers and students dressed like tourists.	Ngesikhathi besendleleni bezwe umsindo wengoma obusho phezulu esikoleni, abafundi bakamatikuletsheni nothisha bezijuxuza.
And he said to me, To measure Jerusalem to see what is its breadth, and what is its length.	Wathi kimi: Ngiyalinganisa iJerusalema, ngibone ukuthi bungakanani ububanzi bayo lobude bayo.
There is no better way to experience tasmania.	Ayikho indlela yokuphunyuka Berlin inakekelwe ezingaphezu kuka Potsdam.
How do I pay back the federal loan.	How do I pay Sizwe mthabela?
The ease of access and proper information that helps a user is key.	Ikhono lokuthumela umyalezo ofanele kanye nesaziso esifanelekile kumsebenzisi ngamunye kubaluleke kakhulu.
"""I'm sorry for all"	Ngiyazifela by Zonke
Death of a translator	Tshabalala Sakhumuzi
5 - No one will be able to stand against you all the days of your life.	1:5 Akekho oyokwazi ukumelana nawe phakathi nazo zonke izinsuku zokuphila kwakho.
Tempu wordpress.org, and thanks for all the fish.	Wordpress.org eside kangaka, nokubonga ngakho konke izinhlanzi.
"A fetus also doesn't become ""viable"" (which is the ability to live outside the womb) until at least five months after fertilization."	"A fetus futhi akubi 'iphila "" (okuyinto ikhono aphile ngaphandle kwesibeletho) kuze okungenani izinyanga ezinhlanu emva kokukhulelwa."
However, I discovered that after I had made the order, it was very difficult to get support.	"""Eqinisweni elimsulwa ngathola ukuthi ngemuva kokushiya iTS Records, kwaba nzima ukukhangisa ngomsebenzi wami."
LG is the king of Yawn.	U-Shaka kwakuyinkosi ya.semashobe-ni.
Such an arrangement will give you a greater measure of freedom.	inkampani enjalo ikunikeza Ukuzivumelanisa nezimo xaxa futhi inkululeko.
Three Two-year-old Zoe Murphy from Ireland, was born with a PVL brain injury causing quadriplegic Cerebral Palsy.	Three Zoe Murphy seminyaka emibili ubudala ovela e-Ireland, izalwa PVL okulimala ebuchosheni okubangela wonke umzimba-Cerebral Palsy odokotela.
(Dependent on length and time taken to process)	(Lula umsebenzi futhi ukuthuthukisa (ukunquma kumele isikhathi eside kangakanani
For many web host providers, the purchasing decisions are made within a matter of minutes.	Kubahlinzeki abaningi be-web host, izinqumo zokuthenga zenziwa kungakapheli imizuzu.
26:31 (Pharaoh) said: Show it, then, if thou art of the truthful.	[26:31] He tshela Ngalesosikhathi khiqiza it you are truthful.
The same applies to ordinary people.	Lokhu kusebenza futhi kubantu abavamile baseTurkey.
There's a new boyfriend - he's amazing.	One New Man - Amazing!
"Not so long ago, it was found that the English Springer Spaniel may suffer from the so-called ""syndrome of anger."""	"Akunjalo kudala kwembulwe ukuthi Springer Spaniel bangase bahlupheke izifo sezinzwa ezifana ""intukuthelo syndrome."""
When things are really bad, they're poachers.	Uma kunokuthile okubi noma akukuhle kangako okufanele sikusho, ngukuthi bangamahhashi ahamba kancane.
I need to call my mother.'	'I need to phone my mother' - Ngidinga ukushayela umama wami ucingo.
It's best if you map it out on paper.	Ngakho-ke kungcono ukubonakalisa ephepheni.
Sylvana Vijn has registered the following areas of law in the register of the Dutch Bar Association:	UMaxim Hodak ubhalise lezi zindawo ezilandelayo ezingokomthetho kwirejista yezindawo zomthetho zeNetherlands Bar:
by the Barna Group, a Christian	Ukulalela iKoran, umKristu
He remembers that we're dust.	Uyakhumbula ukuthi siluthuli.
The prize here is also the best as you would be buying directly from the manufacturer.	Leli qiniso waphinda kuqinisekisa ukuthi into engcono - nguye uthenge ngokuqondile nomakhi.
How long they reign is often up to them.	koda kube nini ezidla ngokungcola kwawo?
I thought they were renegotiating the deal with me at the last minute and that I would not be able to trust them, so I walked away.	Ngithanda ukutshela ngokwami   agciniwe they kimi labo imizuzwana yokugcina ngakho ngangingakwazi belondekile win.
As soon as the voting is over, a committee of 40, including representatives for all candidates, will assemble in the Senate Chamber to tabulate the votes.	Emuva kwehora lesine, kuzovalwa ukuvota zihlangane zonke izinduna zamaqembu kubalwe amavoti.
Swiss football player	Abadlali bebhola laseSwitzerland
23I will kill her children.	3 abantwana bakhe ngizobabulala.
Falling into sin (which we do every [...]	Lagu Ungu - Cududu (All I Wanna Do) [feat Lala Kar...
The damage caused by grey squirrels is enormous.	Ukulimala kwama-sweeteners wokufakelwa kukhulu kakhulu.
Hair have always been regarded as a significant part the masculinity.	Hair bezilokhu njengengxenye ebalulekile abesilisa ababhekwa ngayo.
The shopping mall sector, which is growing day by day, will reach an average of 2020 shopping malls by the end of 445.	Umkhakha wezitolo, okhula usuku nosuku, unesilinganiso sama-2020 ukusuka ngasekupheleni kuka-445.
Air conditioning, analytical instruments, workbench, and other components can be adjusted according to customer needs.	Amakhona ayindilinga, imiphetho ebunjiwe, izinyathelo nezinye izinhlobo ezikhethekile zingacutshungulwa ngokuya ngezidingo zamakhasimende..
I never went back to the Church.	Angiphindanga ngabeka umcondo wami esontweni.
It's a celebration of the birth of Jesus!	Uhambo olubheke osukwini lokuzalwa kukaJesu!
These practices have deep ancient roots, and have been relied on for centuries.	Atholakala emanzini ajulile kakhulu futhi ngenxa yalesi sizathu ahlala engaguquki amakhulu eminyaka.
I said he needed stitches.	Lathi siyazifuna izidetails.
So what can you do in England from today?	Yini ongayenza abuyise esuka eJalimane okwamanje?
The electric heating element is entirely enclosed inside the unit, so the risk of contact burns or fires is almost non-existent.	Ukuphepha kwezinkuni okushisa iziko Indawo yokubasa izinkuni iyashiswa ngokhuni lwemvelo, futhi igumbi lomlilo livaleke ngokuphelele, ngakho-ke abukho ubungozi bokuvuza kwegesi noma imisebe kagesi.
(and I love my kids)	(but I do love my kindle)
All these changes affect the existing processes.	Yonke inkimbinkimbi yalezi zinqubo ithinta imiphumela yokuhlaziywa.
indian government has decided to sell 100 percent stake in air india	IChina ithembisa ukuba seqhulwini kwezobuchw epheshe
Why Do I Love It?	Kungani ngikuthanda?
When that is accomplished, Abu Dhabi will then have completed its transition from a 20th Century, carbon-based economy into a sustainable 21st Century high-technology economy.'	"UB Brufau uthe lokhu kuzoba ngenye izinguquko eziphakathi nesikhathi eside ezenzeka emakethe wegesi, i-hydrocarbon ""eyamandla ekhulu lama-21."""
Lance Hernandez has the story....	UAnnastacia Ndlovu usethulela loludaba ...
"""How to talk"	Indlela Yokukhuluma
time to read the documentations, to learn and understand:)	Kuyakufanelekela ukuyiguqula, ukusabalalise futhi ufunde okuqukethwe kwayo ðŸ™‚
cleanse, exfoliation	- Inhumation, exhumation
Originally, I have studied International Business in Germany.	Ngaqale ngafundela umsebenzi wokuhwebelana namabhizinisi akwamanye amazwe eBerlin.
How do you get a Gmail account.	Ungayakha Kanjani i-Akhawunti ye-Gmail?
They just kept bringing down wounded and there wasn't any more room.	Wayemane nje isusiwe futhi ayisekho nabo amapuleti ngalendoda.
A countdown of the 17 best New Year's Eve performances	Hlela ngokwezifiso Amathempulethi angu-17+ Unyaka Omusha Ikhava ye-Albhamu
In the US, certainly not.	Impela akunjalo e-US.
It is a planned city and was founded on 21 April 1960, to serve as the new national capital.	Yasungulwa ngo-Ephreli 21, 1960, ukusebenza njengenhlokodolobha entsha kazwelonke.
Christmas at the Bird's Nest - Wanderlodge Owners Group	Ngwelezane Empangeni Kwa Zulu Natal - Billboard Finder
SoFi was founded in 2011 and quickly became known for its lending products.	IBazooka yasungulwa ngonyaka ka-2011 yathola izithameli zayo ngokushesha.
The song is set to premiere to radios next week.	Umucu wakhe uzoqala ukuzwakala emisakazweni ngesonto elizayo.
The Serbs are most dissatisfied.	Abantu ubambe kweqembu elinganeliseki kakhulu.
While these are a great source of good fatty acids, not everyone is able to consume these, like pregnant women.	Naphezu kweqiniso lokuthi ama-beets abhekwa njengomkhiqizo owusizo kakhulu, awukwazi ukudliwa yibo bonke abantu abanesifo sikashukela.
The tomb of St. Martin was destroyed	Ukuhaha kukaTom Cruise kwabhujiswa
As a result, breastfeeding is possible.	Ngenxa yoko, ukukhulelwa kwamanzi kungenza.
I decided to create a web site for the church that Katie was serving as a minister at the time.	Kumele ngikhulume ngabantu base-UAE bakhetha uPhillipin njengendodakazi yendlu yabo ngaleso sikhathi.
Daraz is a 3D Secure enabled website.	Iwebhusayithi yethu inikwe amandla ngokuphepha kwe-3D ku-intanethi ye-intanethi.
The aquifer also extends under the ocean at this point.	Amapuleti ama-Tectonic ahamba njalo futhi kule nkathi lapho i-Atlantic Ocean yanda khona.
The ones in the TTSP video are my real ones.	Real mzansi pussy videos igolo lami elimnandi.
Following this, it is viewed as a very promising dietary supplement for athletes, and anyone else who wants to support their brain and at the same time foster their physical strength.	Ukulandela lokhu, kubhekwa njengesengezo sokudla esithembisa kakhulu kubasubathi, nanoma ngubani omunye ofuna ukuxhasa ubuchopho babo futhi ngasikhathi sinye akhuthaze amandla abo omzimba.
The Ups and Downs of Life - Life Without Les	Khuzwayo, Nokuphila - Kienda, La
"""I say to every one of you: Do not think of yourself more highly than you ought, but rather think of yourself with sober judgment, in accordance with the faith God has distributed to each [...]"	[3 Ngoba ngomusa engiwuphiweyo, ngithi kuwo wonke ophakathi kwenu ukuthi angacabangi ukuthi mkhulu kulalokho afanele ukukucabanga, kodwa acabange ngokuqonda, njengalokhu uNkulunkulu abele ngulowo lalowo isilinganiso sokholo.
Baldwin is expected to make a decision soon.	ISundowns kulindeleke ukuthi ithathe isinqumo ngaye maduze.
The fast is broken by partaking of wheat-based food.	Lutho okusanhlamvu kungukuthi kwehla kusuka ezingxenyeni ezidliwayo.
Christ is the lamb of God, and the Bible tells us that Jesus will come to separate the sheep from the goats.	INkosi uJesu yathi izimvu zikaNkulunkulu ziyakwazi ukuzwa izwi likaNkulunkulu, nokuthi ukubuya kukaNkulunkulu kuzohlukanisa izimvu nezimbuzi.
Two groups were at war with one another.	Kodwa base amaqembu amabili in impikiswano omunye nomunye .
My wife had saved it but mistakenly tossed the envelope.	Unina angimbonanga kodwa ungcolise I cover yombhede
MIND - Lascivious	sonke - thode
All the basic equipment was at home.	Zonke izinto zokwakha wayebuye yasekhaya.
But not all of George's life was spent during these years in domestic pursuits.	Akuzona zonke izinto ezibahambela kahle abafana beWillock phakathi neminyaka yabo yokwakha ne-Arsenal.
The girl said her teachers don't understand.	Umlingisikazi wacabanga abangane bakhe babengeke baqonde.
beautiful of all the angels.	Nkosikazi enhle, yezingelosi zonke,
Even if the starting credit is used up, you can cancel at any time.	Ngisho noma uhola imali encane ukuchofoza, ungakwazi ukuhoxisa ke nganoma yisiphi isikhathi esikahle.
need on a hot summer day.	Lena okudingayo usuku ehlobo kushisa.
"But you ain't undressed yet, and the matches are out in the bathroom."""	"Noma ungasagezanga kodwa bangene babes!"""
So I can't post as much as in would like To.	Ngakho-ke, angikwazi ukuhambisana nezincwadi ngendlela engingathanda ngayo.
At the same village there is also a Venetian castle from the Venetian occupation of the island during the medieval years.	Kukhona futhi i-Enetician Castle yaseZakynthos eyakhiwe ngesikhathi sokuba khona kwe-Enetician esiqhingini iminyaka engamakhulu amane.
The climate has been and is always changing.	Izinguquko zesimo sezulu bezilokhu zikhona futhi zizohlala zikhona.
Black people do not have any interest in harming white folks, it has always been the other way around.	Utshomi lo ngaze simzwele kasithandi thina bantu abansundu, njalo wakuveza sobala.
Some news from China.	Alibaba News China.
This is clear glass, there is no warping or special effects:)	I-gdebi-kde ingcono kakhulu ngaphandle kokungabaza futhi azikho izingqinamba zokuzinza ðŸ™‚
Ken is screwed.	Ken Okuyama.
Gronk on the A.T.: Sounds of the AT	Masihambisane: Ibanga R: Izinhlamvu Zemisindo
"""Without fear"" (Lida)"	"wasabi (legemd) """
ly visible.	Mantengase visible.
The resolution specifies that the new casinos must be at least 72 miles from Atlantic City.	Ukuvota inkinga idinga ukuthi abavoti vumela amakhasino ezimbili zokuphelelwa umoya okungenani 72 amamayela Nord ngoba Atlantic City.
Fires are, for animals (including people), a very serious problem.	Imililo ingeyezilwane (kufaka phakathi abantu), inkinga enkulu kakhulu.
04O 14 43 For the Amalekites and the Canaanites [are] there before you, and ye shall fall by the sword: because ye are turned away from the LORD, therefore the LORD will not be with you.	16:43 We never wathumela kodwa amadoda phambi kwakho (Prophet Muhammad) kubani We phendla, cela abantu Remembrance, uma ungazi .
Trying to Murder	mzanywa dladla
Airports in new-york	Izikhumulo zezindiza eNew York
For I have heard from the Lord God of hosts, A destruction determined even upon the whole earth.	Ngoba ngiwuzwile, kuvela eNkosini, uNkulunkulu Sebawoti, mayelana kwesiphelo kanye abridgement ngokuphathelene umhlaba wonke.
The main function of the headdress is protection from the sun.	Umsebenzi oyinhloko lesi sakhiwo - ukuvikelwa endaweni ethile elangeni.
"I answered ""I dunno"""	""" I dunno - I dunno nothin' 'bout"
This has become a secret addiction and I have been unfaithful to my wife. '	"Lokhu kwaholela ekutheni ngiye emicimbini yasebusuku exokozelayo futhi ngingathembeki kumyeni wami."""
This week: Voter participation.	Viki ezayo: Ukukwamukelwa njengolungileyo lomthetho.
uncle, and waited.	Sokhulu, Linda
It might be someone you love.	Kumele kube ilo omthandayo.
Or, how do you know, husband, whether you will save your wife?' (1 Corinthians 7:16).	"Loba, wazi njani, ndoda langabe uzasindisa umkakho?"" (1 Khor."
Moreover, since 1872 various residential colleges have become affiliated with the university.	Kusukela 1872 amakolishi zokuhlala ezehlukene babÃ© abasemaqenjini nyuvesi.
At present, there are seven identification codes, except for We know the plastic material by coding, and the most important thing is to assist in recycling, which can be subdivided and reused.	Okwamanje, kunamakhodi ayisikhombisa wokukhomba, ngaphandle kokuthi Siyayazi impahla epulasitiki ngokufaka amakhodi, futhi into ebaluleke kakhulu ukusiza ekwenzeni kabusha, okungahlukaniswa kusetshenziswe futhi.
Winter time is a real test for the body.	Ubusika luvavanyo lwangempela lwempilo.
the challengers	walesi - nzima
In some ways, but there are also benefits as well.	Ngandlela-thile, kodwa izinzuzo uthola.
She was a crazy women...	Vietnamese insane woman...
The Holy Spirit not a person.	Umoya ongcwele kawusiwo muntu.
Now you can easily remove it from the TV.	Manje usungasakaza ku-TV yakho ngaphandle kwenkinga.
Aside from cracking down on the main opposition party, civil society groups, NGOs and some media outlets have come under pressure from the ruling Cambodian People's Party.	Ngaphandle kwenkantolo isimo besimanzonzo amaqembu ezepolitiki namalungu omphakathi wabantu abamnyama bebhikisha bephethe izingqwembe.
Now She's Crying Sexism	saniy liyona sex imeshe
If it is meant to be picked up,	"""Uma ebhalwe ukuthatha impango,"
Viable Ways of Making Money in 2017	Ezinye izindlela zokutshala imali ngo-2017
For Company formation in New Mexico: We are one stop service provider for company formation New Mexico, Bank account opening New Mexico, starting business in New Mexico and setup business in New Mexico or 109 Countries in the world.	Ngokwakhiwa kweNkampani eNew Mexico: Singumhlinzeki wenkonzo eyodwa yokumisa inkampani eNew Mexico, ukuvula i-akhawunti yasebhange eNew Mexico, ukuqala ibhizinisi eNew Mexico nokusetha ibhizinisi eNew Mexico noma emazweni angu-109 emhlabeni.
4 15 And it came to pass, when our enemies heard that the thing had been told us, that God defeated their counsel.	4:15 Kwathi ukuthi, lapho izitha zethu babezwile ukuthi selubikiwe nathi, Nkulunkulu wahlulwa iseluleko sabo.
Fishermen's boats are no longer what they used to be.	Kodwa pacifiers asetshenziswa njengakuqala.
If you agree with us, join the Socialist Party.	Uma uvumelana nathi - Joyina i-WSF
"""Do not worry,"" he says."	'Ungakhathazeki,' kusho yena.
She knows that today is a special day.	Abantu bathi luqakathekile usuku lolu.
The weight loss on the other hand does motivate a lot of women.	Izizathu yokuncipha kokubaluleka libido owesilisa baningi.
The University works towards and achieves its strategic objectives by developing ways to engage students - and by pursuing best-practice inductions and student experiences.	Inyuvesi usebenza towards, athole ngetinjongo tayo tekusebenta ngokuhlakulela izindlela zokwenza abafundi - futhi ngokuphishekela best-practice inductions kanye nakho student.
compares every man, including her ex-husband, to Ben.	Wonke umuntu uyamuhlonipha uBenni, ngisho nababengozakwethu, bonke bayamhlonipha uBenni, ngisho nami.
His body was found in a burnt-out car in the woods.	Isidumbu sakhe satholakala ebhuthini lemoto ngemuva kokubhulwa komlilo.
The cash value can be used as collateral to secure a loan.	I-DAI oyenza kuMenziDAO ingasetshenziswa njengesibambiso ukuze kuthathwe imali mboleko.
Addicts steal, sell possessions, and prostitute themselves to get enough money to support their habits.	Kugcina sekudaleka izigebengu, ezibamba inkunzi namaphara ahluphayo antshontsha izimpahla ekhaya ayozidayisa ukuze athole imali.
the communitarianism	Le Communitheme
A few years ago there w...	1 year ago Insidethe...
What more can I say about Emilia?	Ngiyiphi imininingwane engingayenza ku-ESTA?
How can I become my Mom's live-in caregiver and get paid for it?	Ngingakusebenzisa kanjani lokhu dolobha womama ukukhokhela sonke isikweletu sendlu futhi indlela yokukwenza?
The Gift of Lamentations	Siphiwo Samazima
Let him rot in the dark - maybe he'll have an idea appear.	Makabeke umlomo wakhe othulini; mhlawumbe kungaba khona ithemba.
We don't receive poker machines (Casino excepted in Western Australia.	Izikhala zamahhala (ama-spins wamahhala ngaphandle kwediphozithi) ekhasino!
We was young at the time.	Sasiseyizinsizwa ngaleso sikhathi.
the Hotel Galvez.	Igumbi e-ihhotela ibungazwe ngu-Galip
The County Clerk is also in charge of:	Njengoba Jackson County umahluleli, wayenomthwalo wokusingatha noma:
"Another possibility is that Alphaeus took a Greek name similar to his Jewish name , the way that Saul took the name Paul "" (Catholicism and Fundamentalism , ã‚¤ã‚°ãƒŠãƒ†ã‚£ã‚¦ã‚¹ãƒ—ãƒ¬ã‚¹, 1988, p."	"Okunye okungenzeka ukuthi Alfewu wathatha igama lesiGreki efana igama zakhe ezingamaJuda, indlela ukuthi uSawule wathatha igama elithi Pawulu"" (Katolika eziyisisekelo, Ignatius Press, 1988, p."
But there is a door separating the radio station and the ops room.	Kodwa kunomnyango ohlukanisa isiteshi somsakazo kanye ne-ops room.
They are human beings with real fears and problems, too.	Futhi ukuqhuma kwezibhamu - samuntu ukwesaba yangempela nezinto ezibakhathazayo.
I've been studying but I need more help	Ngiyawuqonda umsebenzi, kodwa ngifuna usizo oluthe xaxa
4:20 Esther had not yet declared her native land and her people, according to his command.	4:20 U-Esteri wayengazange kodwa wamemezela kwezwe azalelwa kulo futhi abantu bakhe, ngokuvumelana nomyalo wakhe.
The way of avoiding the something is to wear a blindfold or keep eyes closed.	Vele ukudweba impendulo imfumbe kumele amehlo noma uvale emehlo.
Ah, yes, the Chase.	James yes, Chase no.
"In the last few days, after reading dozens of emails and comments from my Newsbud community friends I decided to just get down to it and do it."""	"Ngemuva kokufunda lokhu okuthunyelwe, nokulalela ithebhu kaRobbins, ngibheke izinqumo zami zeminyaka emisha, ngazidwengula ngabhala isinqumo esisodwa nje esisha: ""Vele ukwenze."""
That is, so long as his manager doesn't lose faith in him.	Lokhu kwenzeka uma nje leyo ndawo ilahlekelwa ukholo yena.
The Federal Bureau Of Investigation 18 days ago	sizwe nzama 18 days ago
In search of the perfect health care system in india	Thola Izinhlobo Ezinhle Zokunakekelwa Kwezempilo zaseNdiya
Sleep well in the New Reich.	Lala kuhle qhawe lamaqhawe.
The city's club's academy, GNK Dinamo Zagreb took advantage of that opportunity and requested the services of Mateo Kovacic.	Isikole sika-city club, uGNK Dinamo Zagreb wasebenzisa leli thuba futhi wacela usizo lweMateo Kovacic.
"Want to hear my ""Working Class Hero""?"	"Ngabe ngizwa lapha ""iba Inofizielle Mitarbeiter""?"
The Federal Road Safety Corps (FRSC) on Tuesday disclosed that it has deployed 1,500	I-Road Traffic Management Corporation (RTMC) ngoMsombuluko iveze ukuthi isibalo sabashonile sesifinyelele kwabawu-1 200.
Most people develop calluses at least once in their lifetime, but it can be difficult to understand how this skin condition arises.	Cishe wonke umuntu ubhekene nobuhlungu begciwane okungenani kanye empilweni yakhe, ngakho-ke ungacabanga ukuthi ubuhlungu kangakanani umqondo wokuvinjelwa kokuhamba ezindaweni eziphansi.
We had a budget of about $30,000.	Lokucabanga ukuthi sibe nohlelo lokusebenzisa imali zamaRandi 1000.
Then you need to change the model, but how?	Udinga ukuvula ke ngesikhathi umdlalo, kodwa indlela yokukwenza?
I wouldn't regret joining this club.	Angizisoli neze ngokujoyina leli qembu.
A local museum shows ancient artifacts.	Museum ibonisa lasendulo art izinto.
"""The one who loves pleasure will become a poor man; whoever loves wine and oil will not get rich."" (21:17)"	"""Othanda ubumnandi uyoba mpofu; othanda iwayini namafutha ngeke acebe."""
work together on a rubric.	Yenza umsebenzi elihambisana esigabeni umsebenzi.
It is also reported that he is now making a cycle claim for damages from the insurers of the car driver.	Uthe basafuna ukucetshiswa ngezomthetho mayelana nokuthi kumele yini uMadonsela abanjelwe imali ngokulimala kwemoto.
EVERYONE can understand.	Noma ubani angakuqonda.
Boaz' kindness was actually an expression of Jehovah's loyal love toward a woman who had come to 'seek refuge under the wings of the God of Israel.'	Umusa kaBhowazi watshengisa indlela uJehova ayemthanda ngayo owesifazana lo owayeze 'ukuzophephela ngaphansi kwamaphiko' kaNkulunkulu ka-Israyeli.
In the afternoon visit to Konark Sun Temple, Chandrabhaga Beach.	Ngemuva kokudla kwasekuseni kuhambela ithempeli likaRamchandi, i-Chandrabhaga Beach, i-Konark Sun Temple.
20But Amaziah would not listen, for it was of God, in order that he might give them into the hand of their enemies, because they had sought the gods of Edom.	20 Kepha u-Amasiya akalalelanga, ngokuba kwavela kuNkulunkulu ukuba abanikele esandleni sezitha zabo, ngokuba babefunile onkulunkulu bakwa-Edomi.
Is it possible to live near him?	Kungenzeka yini ngempela ukuba sisondelane naye?
Across the world, people and organizations are targets of fraud every day.	Ezwekazini lonke, nsuku zonke, izinhlangano nabantu ngabanye bayalonakalisa.
From details in his Obituary, he served on the following ships:	Nge ubuhlungu in emphinjeni wakhe owenzÃ© izidakamizwa ezilandelayo:
I don't know who needs to hear this but, you should moisturize and moisturize often.	Angazi ukuthi ngubani odinga ukuzwa lokhu kepha, kufanele ugcwale umswakama futhi u-moisturize njalo.
Get others to help influence.	Thumelela Thumelela Siza Abanye Babhekane Nokucindezeleka
Camaraderie between teachers and students	Entre profesor y alumno Phakathi Kothisha Nomfundi
Let's make Pop Corn and add your favorite seasonings.	A usawoti kancane bese wengeza seasonings ozithandayo.
The injured have been shifted to different hospitals for medical aid.	Belaphe abalimele, bayiswa ezibhedlela ezahlukene ukuze bathole osizo olwanele.
JFK's Brother Robert F Kennedy said to Lyndon B Johnson, 'why did you get my brother killed' -	"RFK wabuza Kamuva Lyndon Johnson ""Kungani kuye wabulala mfowethu?"""
Teresa is wearing a short-sleeve shirt today.	Namhlanje ugqoke isikhindi esimfushane kakhulu.
During the 1960s and 70s, disco music was popularised in many	Kusukela ngeminyaka ye-1960 neye-1970, umtshingo wawudlalwa ngabaculi abaningi bakuleli
T-Shirts with the message	Ukhetho Lelaphu elinomyalezo
Sadism and Masochism Porn 1	Ntokozo Sibonelo Khuzwayo 1 and FortunÃ© Massamba 1
Here, other items can be added if desired prior to applying payment.	izithako angeziwe angafakwa uma wayefisa zokupheka ngenhla.
The Government of Uganda has announced the closure of Entebbe International...	IUganda imiselwe ukuvula i-Entebbe International Airport ...
skills has emerged.	Kuvela kwaba amakhono.
The table below shows how to use these options.	Ngezansi isithombe iqhinga isikuta ukusetshenziswa izicelo ezinjalo.
"I wanted to destroy him."" 0"	"Ngangifuna ukumbulala."" - UPaul."
The easiest option for many first-timers is to keep mealworms in an aquarium tank.	Inketho elula kakhulu kubantu abaningi bokuqala ukugcina izimbungulu zokudla ethangini le-aquarium.
In the Name of God live 15:49	Egameni lenkosi 6:15
They are usable, though.	usable nonetheless.
- I like my name.	Ngiyalithanda igama lami.
But the ticket is transferable to a colleague within the company.	Noma ingadluliselwa kwelinye ilungu elingaphakathi enkampanini.
On the other, you can get curry chicken.	Ngesikhathi esifanayo, ungenza ukucutshungulwa ushizi.
Later he returned to the Academy as a language instructor. read more...	Ekukhuleni kwakhe ube esefunda esikoleni sekhethelo sokufundisa ... Read more
Once the hair is eliminated, it will never grow back.	Njengoba Kabusha izinwele ke olungasayikuphinde lube khona.
"(Ephesians 4:29) Let us discuss why we need to keep on guard when it comes to speech, what speech we should avoid, and how we can utter speech that ""is good for building up."""	(Efesu 4:29) Ake sixoxe ngokuthi kungani kudingeka siqaphe lokho esikushoyo, inkulumo okufanele siyigweme, nokuthi singakhuluma kanjani ngendlela 'eyakhayo.'
At the end of the day, the tour operators dropped us off at the railway station for a night ride to Victoria Falls.	Ekufikeni kwabo eTsholotsho indawo bagcina beyithole eNgamu phetsheya kukaGwayi khonale esititshini sesitimela esiya eVictoria Falls.
"You are witnesses of these things"" (Luke 24:46-48)."	"Wanezela: ""Kumelwe nibe ngofakazi balezi zinto."" - Luka 24:44-48."
"**** ""shall not be subject to judicial review"" ****"	"3 ""Neni kubulelezi kale-kale litaba za kwamulaho.*"
by The Mamas & The Papas for violin solo	Nokuthula Ngwenyama, Miasma for Solo Violin
It's feedback like this that helps us learn and continue to be the best at what we do.	Kuhle kakhulu, okokufundisa okufana nalokhu yikho okusisiza siqonde futhi sazi ukuthi yini esinayo phambi kwethu.
Invaders were helped by Ukrainian Neo-Nazis.	Ukukhulula Ukraine kubahlaseli amaNazi awuzange sithathwe kalula.
Arrange a talk show on this issue.	Bhala inkulumo elungiselelwe ozoyethula kulo mcimbi.
There is also a 'Day of the Dead' workshop suitable for older children and teenagers.	"Izingane icala ""langa thokozile"" kufanelekile izingane enkulisa futhi izingane ezindala."
The web-site may also use cookies which are not necessary for its functioning.	I-COB tech ingasetshenziswa nasemasimini okufaka isicelo ukuthi amanye amaphakheji ayinayo indlela yokuyifinyelela.
The only motherfucker	Ojal wuod uyoma
It has an offline translation feature, that enables users to translate text without an internet connection.	Umsebenzi ongaxhunyiwe kwi-intanethi uvumela abasebenzisi ukuguqulela itekisi ngaphandle kokuxhunyezwa.
Contempts of the children's rights in the world	Ukwenza ekhoneni zezingane kuleli zwe
Ultimately, though, the result is the same.	Nokho, umphumela ekugcineni uyefana.
So, an arrangement had to be made for somebody to write the examination for him.	Yikho-ke kwahlelwa ukuthi kube lothile ozafunda laye.
It produces a lot of cellolite.	Ikhupha amathimila amanengi.
Touring Mobilis is known for its traffic updates on the radio.	UZondo uyaziwa ngezinkulumo zakhe ezigqugquzela emsakazweni.
It's funny how one person can come into your life and flip it upside down.	Kuyaxaka ukuthi umuntu ungena kanjani komunye athi shiqe ngaphakathi kuye.
Finishing a full Iron is not difficult, it all depends on the time you spend on the course.	Ukuwela akunzima kepha kuthatha isikhathi eside ngakho-ke konke kuncike esikhathini onaso.
Let's take the example of a new ...	Ukuze usho isibonelo sedolobha laseNew ...
obsequious in the dark says:	Kholo Sinqobile Mnyandu says:
Recognizing that there is no need to reinvent the wheel in	Ukuqonda ukuthi asikho isidingo sokugijima nxazonke zama-
The lightning in Lake Bonney.	Umahamba-nendlwana e-Bonney Lake
This system requires a special fluid.	Kusobala ukuthi lesi sikhala idinga flooring ekhethekile.
11:5 But Anna sat beside the way daily, on the top of a hill,	11:5 Kodwa u-Anna Wahlala eceleni ngendlela nsuku zonke, phezu phezulu egqumeni, kusuka lapho wayezoba akwazi ukubona ibanga elide.
My husband was in the hospital for 2 weeks.	"""Umyeni wami usehlale esibhedlela amasonto amabili."
"""I am the youngest member of the team."	"""Yimina omncane kunabo bonke abadlali eqenjini."
A Few of Her Accomplishments:	Izinto ezimbalwa azenzayo ezibonakala zimpumelelo kuye:
Choose any one product.	Khetha umkhiqizo udinga ngamunye.
I will be heading back home now.	Ngizolanda uSenzo aye ekhaya njengamanje.
If you need a guest permit for longer, you will have to submit additional applications.	Uma isimo sezulu sizodinga ukuchelelwa okuningi, kuzodingeka ukuthi uvakashele kaningi kunalokho.
One day she went to watch the house of a neighbor lady who lived close by, who had to go into town to do some errands.	Ube seya ezohlobeni zowesifazane, eduzane nawo lo muzi, eyofuna okhiye bokungena ngaphakathi.
"I want to find a good guy who loves me and treats me with respect,"" Allison said."	"Ngithanda kakhulu inhlonipho yena, ungumuntu onothando nokwaziyo ukungibekezelela,"" kusho uZakwe."
Roof can be opened up.	Uphahla, futhi angavulwa.
Pride is among them.	Isibindi sabo mkhulu phakathi kwabo;
"And Saul said unto him, Why have ye conspired against me, thou and the son of Jesse, in that thou hast given him bread, and a sword, and hast inquired of God for him, that he should rise up against me, to lie in wait, as at this day?"""	"USawule wathi kuye: ""Ningenzeleleni ugobe, wena nendodana kaJese, ngokuyinika isinkwa nenkemba, uyibuzele kuNkulunkulu ukuba ingivukele, ingiqamekele njenganamuhla, na?"""
Therefore, you can easily take advantage out of this in some manner or protect from some serious effects.	Ngakho-ke, ungaguqukela kuye noma usuke kwezinye izinhlobo ngaphandle kwezinkinga.
However, his biggest success has come at longer distances.	Kodwa indima yakhe ephambili kunawo wonke uye wabonisa kusekude ukufika lapho.
Microfinance: What it is.	Ukuhlukahluka kweMicroeconomic: ziyini?
It's still running on the browser	wo har pahla waqya zindegi ka
(b) all responsibilities, rights and other matters terminated by section 267 (1) in respect of the child are restored.	b zonke izibophezelo, amalungelo nolunye udaba oluqedwe yisigaba 240 1 ngengane ziyabuyiselwa.
The UK is the second major country after the US.	II-UK iyisizwe sesibili esihlosiwe ngemuva kwe-United States.
According to them, they suit me.	Bathi ngikulandela njalo
Sixty-four of these have already been	E46 I magi abadok
And day by day, we do so many things that only add to our debt.	Empeleni, ne izikhala eziningi kangaka ngosuku, senza okuningi kuka ezombusazwe nje.
The ones I have read also suffer from a lack of plot.	Nephepha abelifunda seliyamcasula ngoba sekuyisikhathi eside elindile.
Open up a box.	Vula isipheqi.
'The Law and the Prophets were proclaimed until John.	"""Umthetho nabaprofethi kwadingeka isikhathi sabo kwaze kwafika uJohane."
"Will ""What do you deliver to them?"""	"20""Kepha uNkulunkulu wathi kuye: 'Wena siwula, ngalobu busuku umphefumulo wakho uzakubizwa kuwe; pho-ke, izinto ozilungisileyo ziyakuba ngezikabani na?'"
Why not cycle on a bicycle.	Chika, kungani ungahlali phansi ngebhayisikili lami?
The Roaring 20s: Lady Gaga	Ukulele top 5 _ maria gadÃº
What's Going On Meaning - Shmoop	uKhala Kanjani - Zahiphop
We don't let ourselves write bad writing.	Kuyasijivaza singababhali ukusebenza kanzima sibhala
Rebuffed by Courts	Zangwa Nomazango
Gwen is overwhelmed by Lisa s generosity.	UGrace udikiwe yindlela uWandile amqoqosha ngayo.
The bathrooms behind the sanctuary will be the only ones open.	Ehlangothini elingaphansi kwemigwaqo, ukuphela kwemizimba ehlatshelwe imihlatshelo kuyohlala ngaphandle kokungcwaba.
The spectacle amazed me.	Lo mbukiso ungigcinele isimanga.
Keep in mind that it will take time, and longer than usual.	Lokhu ngiyakucacisa, kuzothatha isikhathi eside, kepha kukude kakhulu kunokujwayelekile.
Therefore, the impact on consumption might not be as bad.	Ngakho-ke, mhlawumbe imiphumela yokuguquka kwesimo sezulu ayisiyimbi kangako.
It's number 22.	We ukuthola inombolo 22.
Ann 1838, the Exeter Diocesan Board of Education resolved to found an institution for the education and training of schoolmasters , the first such initiative in England .	Ngo 1838, i-Exeter Diocesan weBhodi Yemfundo ukuxazululwa wathola isikhungo imfundo nokuqeqeshwa schoolmasters, isinyathelo sokuqala salolu hlobo England.
It followed a two-month investigation.	Ngesikhathi esifanayo uphenyo wenziwa phakathi kwezinyanga ezimbili.
Insects are commonplace in houses.	Unogwaja yizilwane ezivamile endlini.
The maid is going to clean up the house before the guests arrive.	Kufanele sihlanze indlu ngaphambi kokuthi kufike izivakashi
The decision begins once you start thinking about it.	Isinqumo iza lapho uqala ukufuna.
"Opposed to this ""acting wickedly against the covenant"" were other priests, Mattathias and his five sons, one of whom was Judas Maccabeus."	"Ukuphikisana nalokhu ""ukwenza kabi esivumelwaneni"" bekungabanye abapristi, uMatathias namadodana akhe amahlanu, omunye wabo kwakunguJudas Maccabeus."
stars, as well as their magnitude.	Njengobude bazo, ngokunjalo nobubanzi bawo.
"""If he had not arrived when he did he would have died."	"""Uma lingakasho ukuthi ubani akabulawe ubengabulawa."
The maps of the city: Navia	Thaila ayala nakedBabe: Beach: Nude
Even when I halfway wanted to put it down, I kept reading to see what would happen.	Yize bengivele ngikhiphe iningi elingikhathazile, ngizodlulisa umyalo ukuze ngibone ukuthi kwenzekani.
We want to use this program?	Ukusebenzisa lolu hlelo lokusebenza?
All nukes in India are in component form.	On wonke, izimonyo Indian yenziwe ngezithako zemvelo ziyingxenye asezingeni elifanele.
35 'They hit me, and I was not hurt; They beat me, and I don't feel it!	35Bangitshayile, kangizwanga buhlungu; bangidutshuzile, kangikunanzanga.
Although religion may still be.	Njengoba nje inkolo sisekhona.
Design changes can be made only to the Design Master.	Ivumela ushintsho lwedatha kuphela ku-Design Master.
Okay, now you're right for the second time.	"""Uchame futhi okwesihlanu."
When the proposed purchase/contract cost is between $5,000 and $25,000, at least three informal bids shall be solicited from viable sources.	Izimpahla kanye nezinsiza ezilinganisiwe kuzindleko ezingaphakathi kwama- R5,000 kanye nama-R100,000 angatholiswa ngokumema amakhotheshini entengo abhaliwe avela kubanikezeli abavunyiwe okungenani abathathu.
"Of course ""spiritual work"" and ""helping yourself"" were okay."	"Yiqiniso, ""shaba"" ngezinqubo zomsebenzi nokuphumula kwakuyiphepha."
You are not going into the sea to get those big fish.	Abadobi ukuza lezi zindawo catch enkulu.
The South Koreans are also guilty of wishful thinking.	AmaMongol nakubheka njengento kokuba ngenhloso embi.
It's where many couples spend a great deal of time sharing food, fun, and creating lasting memories.	Kuba khona imibhangqwana eminingi ukuchitha okukhulu isikhathi babelana ngokudla, fun, nokwakha izinkumbulo obuhlala.
"This is not going to end nicely. """	"Lokhu ngeke kuze kube sekugcineni kahle."""""
Come on -- there are lots of examples.	Around - eziningi izibonelo.
"""After using the product for a few days, my head started to become dry and itchy,"" he said."	"""Ngemuva kokusebenzisa lolu ketshezi izinsuku ezintathu, izinduna zivele zoma zase ziyaphela nya,"" esho."
40 to 60 milesThe average individual conducting a long-distance bicycle tour will cycle between 40 and 60 miles (64 - 96 kilometers) each day.	Umuntu ojwayelekile oqhuba ibanga elideibhayisikilitour kuthandaumjikelezophakathi kuka-40 no-60Izinkulungwane (Amakhilomitha angama-64 96) lilinyeusuku.
American literary agent.	Abanamakhono umbhali American.
(Conducted in accordance with applicable sections of California law.	(Iqeda ngolimi lwesiNgisi sengezwe ngokuvumelana nemithetho ezisohlwini section ekhethekile kwalesi sihloko).
I challenge you won't find a better view of Lavasa than from our apartment:).	Ngiphonsela inselelo ukuthi ngeke uthole umbono ongcono we-Lavasa kunasefulethini lethu:).
The term is out of control!	Iphuzu alilawulwa! >
report is based on interviews with 67 sub-Saharan migrants	Imibiko ehambelanayo Kutholakale 6 wezidumbu zabafuduki olwandle
The summary is available on the IRS website.	Isethulo sethu siyatholakala kuwebhusayithi ye-ISIRC.
Judges 8:13 And returning from the battle before the sun rising,	8:13 Base bebuya empini ngaphambi kwelanga,
Shown compassion for the poor and needy?	Umusa okhonjiswa umuntu ohluphekayo nosweleyo?
In fact, he tells us so in his author's note when he assures us that he has taken liberties with his family's story with pure abandon.	Kungenzeka wavumela phezulu ngombana ukulandisa kumhlathulula njengowathatha umndenakhe baphuma e-Uri.
They do not have time to ask whether the customer needs plastic bags.	Babengenaso isikhathi sokubuza amakhasimende ukuthi bayawadinga yini amapulasitiki.
It is my understanding that this event is held each summer.	Kuyaziwa ukuthi lo mshado uhlale unyaka nonyaka.
A crucial element to this happening is the improvement of AI.	Isici esibalulekile kule nqubo ukuthuthukiswa ukuhlaselwa AOE.
"And when it doesn't come, really, really, really bad things can happen."""	"""Lapho kungenzeki kungenzeka: ezamehlela empeleni non-abavamile."""
"The voice of Ishtar rings out: ""Mortal, thou hast done well!"""	"Yisiqubulo Taurus owesifazane: ""Ukusebenza kanzima usuthela!"""
It always has seemed to me that writers assume that the next generation is going to have a perfectly happy life.	Kuhlala kuphela ukugqoka, ukuthi isizukulwane esilandelayo sabantu abadlali abasha sizophumelela kakhulu.
However, a woman's body produces other types of hormones as well that influences other aspects of her health including her mood, weight, energy level, and more.	Kodwa umzimba wakho wenza futhi usebenzise ezinye izinhlobo eziningi ze-hormone ezithinta ezinye izici zempilo yakho-kusuka ezingeni lakho lamandla, isisindo, isimo sengqondo nokunye okuningi.
Each of us has to find our own path through life - there is no one way.	Kumele thina ngamunye sihambe indlela yethu singabi nalutho oluthinta omunye kithina - yini engalungile kulokho?
Action is needed at all levels and on all timescales.	Umsebenzi udingeka ngaphansi kwazo zonke izimo futhi ngezinye izikhathi kuzo zonke izimo zezulu.
Today, shake off the self-pity.	Ikhishi namuhla ikhiphe kudivayisi owenza lutho.
I hope this movie is a hit for him.	Bernard unethemba lokuthi lolu suku kuyoba inhlekelele kuye.
Who is grieving.	Mani Å¡Ä·Å«ningi.
others to help them.	abanye ukuba basize.
Upon decommissioning, these effects are likely to be reversible.	Nokho, lapho udoti ubuchwepheshe imiphumela enjalo engathandeki cishe ziphinde zenzeke.
Deep vein thrombosis- The formation of blood clots in your legs' deep veins is symptomized by pain and swelling of your legs.	I-thrombosis ejulile ye-vein - Ukwakhiwa kwamagundane egazi emilanjeni yakho emilanjeni ejulile kubonakaliswa ubuhlungu nokuvuvukala kwemilenze yakho.
Every time they get food out of date.	njalo uma ethenge ukudla uvele
"Label says: ""Rich and smooth."""	"Njengoba isisho sibonisa, ""ezishibhile futhi onamileyo."""
Financial information such as credit card or bank account numbers;	imininingwane yezezimali enjengezinombolo zekhadi lesikweletu / lasebhange;
the blood of the body	Igazi kusukela emzimbeni
Defeating the Bullwhip Effect in Forecasting	Ukuqonda i bullish ekukhoneni ngaphambili
Till you find your voice, nothing can really change.	Kuze uze ufinyelele noma yikuphi ubuso, akukho lutho olungashintshwa.
So many people do not take advantage of this simple opportunity.	Kodwa abantu abaningi abalibambi ngezandla zombili leli thuba eliyivelakancane.
Free a variety of vehicles, including cars, trucks, motorcycles and boats, to hunt down your enemies, drive into the play area or flee quickly.	ukuhamba nge-style controlande izimoto ezihlukahlukene kuhlanganise izimoto, amaloli, izithuthuthu kanye nezikebhe ukuzingela izitha zakho, ukugijima endaweni yendawo yokudlala noma ukuphunyuka ngokushesha.5.
When asked what is one business idea he is ready to give over to others, he replied that he has a child who has a severe food allergy to sesame and nuts.	Ebuzwa ukuthi kungabe wumuntu onjani ongaba senhlanhleni yokuthandana naye, uveze ukuthi ufuna uswahla lwensizwa esukile egadeni futhi enephakethe eliqinile impela.
He was really a friend in need.	Ngalesosikhathi wayemdinga sibili umngane weqiniso.
"It is the month in which school-aged children are made to listen to Dr. King's ""I Have a Dream"" speech and are possibly given sheets containing his image to color and hang on a classroom wall."	"Yinyanga lapho izingane ezifunda isikole zenziwa ukuba zilalele inkulumo kaDkt King ethi ""Nginalo Iphupho"" futhi kungenzeka zinikwe amashidi aqukethe isithombe sakhe azowafaka umbala bese elenga odongeni lwekilasi."
In any case, there were separate treaties covering chemical and biological weapons.	Kwezinye ngokuningiliziwe izinto ezithinta izikhali zamakhemikhali nezinto eziphilayo abe ukufana okuthile.
It can happen if the following conditions occur:	Lokhu kungenzeka uma lezi zifo ezilandelayo:
It is paramount to the successful development of our nation.	Lokhu kuyisici esibalulekile ekuthuthukiseni umnotho ngempumelelo lesi sizwe.
They also observed a pair of shoes that were wet and coated with grass cuttings.	2 wakwatapheya, osuswe isikhumba kanti waqotshwa izicucwana ezincane.
The Mystery of the Egyptian Vulture Country House	Ngo endlini waseGibhithe yizicukuthwane
That was the first time I started training for a full 5K.	Ngaleso sikhathi ngangiqala ukuqaphela konke ukugijima kwe-5K.
It needs careful planning prior to buying.	Kuyadingeka ukuba acabangele ngaphambi kokuthenga.
I don't know how I'm going to do it, but somehow I will.	Anginalo iqiniso lokuthi ngizokhona kanjani, kodwa ngizokwenza ngandlela thile
However, now that I'm pregnant I haven't been hangry.	Kodwa manje njengoba ungekho ngihlezi ngikhubekile
tions, but inhumation, even under barrows, is also attested	Chinaza Onwubiko, Chinweizu Ejikeme Udobi
Why I put it like this?	Kungani ngikubeka kanjalo?
"""They always look out for me and ask how I'm doing."""	Njalo bayangihlola futhi bangibuze ukuthi ngizizwa kanjani.
for 2016 - North America leads the way	Obama 2016 _ Banal Leakage
Cocksure and fancy-free.	Ukupaka kwamahhala ne-WIFI.
We think we can fix people.	Ngicabanga ukuthi singakwazi jabulisa abantu.
"I just can't think of a life without music."""	"Angiyicabangi impilo yami ngaphandle komculo. """
Visit my website and tell me what you think.	hlola iwebhusayithi yami futhi ungitshele ukuthi ucabangani.
All action with respect to the faith of others must be exercised by God while we wait for the last judgment.	Kungokokugcina lapho umuntu eyocwengwa ngaphambi kokuphethwa komsebenzi wokuphatha kukaNkulunkulu, futhi bonke labo abalandela uNkulunkulu kumele bamukele ukuvivinywa kokugcina, kumele bamukele ukucwengwa kokugcina.
After a long illness, a longThe use of drugs in cats can significantly worsen the state of health.	Ngemva yalesi sifo, ukusetshenziswa eside izidakamizwa e amakati kungaba ngokuphawulekayo sibe sibi impilo.
a more dangerous world.	Phila eziyingozi kakhudlwana kuleli zwe.
There are several types of retailers where job seekers can start employment.	Bangu izinhlobo eziningana zabathengisi lapho abafuna umsebenzi bangaqala khona ukuqashwa.
"Only God gets to do that."""	"NguNkulunkulu kuphela ongakwenza lokhu!"""
Getting Started with v2.0.8	sindisa nxusani 0Z8 start no
A key focus of our preparatory work has been engaging with fellow EU Member States, including France, who face similar challenges to Ireland.	Okunye osekugqanyiswa eyobudlelwano lo Mengameli abenabo namazwe angaphandle ikakhulukazi awase-Europe okubalwa iFrance.
Along with the committee's members, Lelono started to visit residents.	Ngemva kokuncedisa indoda le lemuli yayo baqalisa ukusiza abanye ababehlala kulesosakhiwo.
It's matt.	Yiningayi - Mt.
We find your friend, Bassam.	Yazana nombungazi wakho, u Bastien
It would have been impossible for me to figure out the truths the Lord has taught me.	Ngibone ukuthi ngeke akwazi ukulwa ngendlela inkosi eyasifundisa yona sisekwelakwa Mthethwa.
The child may lose trust and respect for their parents or idolize the celebrity.	Indodana ingenza abantu bahloniphe ababelethi bayo namkha ibenze babadelele.
"""What DO you want, Mother?"	Yini ongathanda, ma'am?
Patients will have the right to choose their family doctor.	Kulokhu, iziguli zinelungelo lokukhetha udokotela zabo.
When used, they wash down the drain.	Ngemva kwesikhathi edingekayo, begeza off the zehena.
She was most definitely NOT the person she acted in her films.	Manje kukhona cishe akayena umuntu oyedwa owayengeyena ujwayelene nomsebenzi wakhe e-movie.
The God Who is Unchanging	Ngino Nkulunkulu 'geka ashintshe
Fosters: We need fosters in all areas.	Note: Sinabathuthukisi edolobheni ngalinye.
On the other hand, surface temperatures in these parts of the Atlantic Ocean may have been higher in the past.	Mhlawumbe esikhathini interglacial kulezi zingxenye yayithambile kakhudlwana futhi isimo sezulu esifudumele.
It has good mechanical properties, it is easy to machine, it is weldable, and can be precipitation hardened, but not to the high strengths that 2000 and 7000 can reach.	Ziyakwazi kulula umshini, kukhona Weldable, futhi kungaba kwezulu lukhuni, kodwa hhayi amandla okusezingeni eliphezulu ukuthi 2000 futhi 7000 ongafinyelela.
The future of the form?	Indlela aphila nale fomu?
D/A: writes out voltages.	ls -a: bonisa amafayela afihliwe.
Under normal circumstances, we target a risk-reward ratio of 1:3 - so that if you were to place an order at a stake of $60, we would aim for a profit of $180.	Ngaphansi kwezimo ezijwayelekile, sibhekisa isilinganiso semiklomelo engcuphe engu-1: 3 - ukuze kuthi uma ufaka i-oda esigxotsheni esingu- $ 60, singahlose ukuthola inzuzo engu- $ 180.
Single press of the button and bam, it's on.	Omunye simple slip-up and BAM, ubhekene gone.
They help us to open our hearts.	Amahlelo la asisiza bona sivikele iinhliziyo zethu.
Of the three, he was more honorable than the two, for he was their captain; however he attained not to the first three.	Kulaba abathathu wayetusekile kunababili, waba yisikhulu sabo, kepha akafinyelelanga kwabathathu bokuqala.
I have a better Plan.	Ngakho, nginesu elingcono.
For women under 25, the probability of having a special child is 1 in 1400.	Uma umama okhulelwe akuyona 25 iminyaka, ingozi e isilinganiso 1 kuya 1400.
So the body receives the necessary elements, without causing harm to the stomach.	Ngakho-ke, umzimba uthola ukwaneliseka okungenamsoco ngaphandle kokulimala kumanyikwe.
It was at this point that my status changed.	Yingaleso sikhathi lapho i-passport yakhe ishintshile.
According to DigiTimes, as they shared MacRumors, sensor displacement stabilization will be present in all devices that will be launched at the end of 2021.	Ngokuya nge-DigiTimes, njengoba babelane ngayo Ama-MacRumors, ukuzinza ngokusebenzisa ukufuduka kwenzwa kuzobakhona kuwo wonke amadivayisi azokwethulwa ekupheleni kuka-2021.
We do to others as we would have others do to us (Matthew 7:12).	Kodwa senza lokho esifisa ukuthi abanye bakwenze kithi. - UMathewu 7:12.
I'm supposed to answer each thing with a single word.	Ngi buzile into zonke, Zi sho ngazwi linye zonke;
not tread it blindly, but in the light of knowledge.	Musa uphakamisa ngokwakho, kungenjalo ungakwazi abakholwanga, kodwa musa kancane amakhono azo.
The need for corrective measures to deal with the consequences of past injustices is overwhelming.	Ukushintsha ukunikezelwa kosizo ukuhlangabezana nezidingo ezingqangi ukubhekana nokungalingani kwaphambilini.
Fire district trustees brought the plans to county board members for the first time.	Abaholi bebandla babecele ukuba labo okungokokuqala befika enkonzweni beze ngaphambili.
Chinese media pointed out that the company's owner lost large amounts of money in currency trading and fled out of China.	Inkampani ye KPMG ithi abantu ababesenza imali enengi ngesikhathi kusasetshenziswa idollar le Zimbabwe balahlekelwe sokusetshenziswa imali yamanye amazwe.
"You guarantee that (i) you are not located in a country that is subject to U.S. Government embargo, or that has been designated by the U.S. Government as a ""terrorist supporting"" country, and (ii) you are not listed on any U.S. Government list of prohibited or restricted parties."	"Ubonisa futhi uqinisekisa ukuthi (a) akutholakalanga ezweni elingaphansi komngcele woHulumeni wase-US, noma oqokwe nguHulumeni wase-US njengezwe ""elisekela amaphekula,"" futhi (b) ubhalwe ohlwini noma yiluphi uhlu loHulumeni baseMelika bamaqembu enqatshelwe noma anqunyelwe."
"""I think we have to work more on our conversion because we created a lot of chances but failed to convert them into goals."	"""Engikubona njengo-kusidlisile eKapa ukuthi sakha inqwaba yamathuba kodwa sehluleka ukuwa-sebenzisa."
Further data reveals that over 170 routes have been cancelled for 2017.	Kuthiwa zingaphezu kuka-50 izimoto eseziduniwe umkhondo wazo ongakaze utholakale kusukela ngo-2017 kuze kube yimanje.
Sendmail has evolved into a work-horse	Lishe laba ngumlotha Worker Indawo
Trying to clear old stock.	Zakudala Zama ukoma imicu.
The result of the modifications will be available back in the calling program.	Futhi umphumela wokulungisa uzofakwa kuhlu ngezansi komyalezo.
They were reportedly dressed like Jesus.	Kukholakala ukuthi babegqoka Kristu.
However, many people might feel that it still applies today.	Futhi ungagcina omningi isikhala ukuthi namuhla kumelwe.
"It wasn't our day."""	"Bekungasilo usuku lwethu."""
This Is Your House Song	Ubuhle Bakho House Song
So, these are the stupid birds.....	Ngakho kungakhathaliseki ukuthi lezi zinyoni oyisiphukuphuku?
There are only three hills to be found in the city limits (in Jingshan Park to the north of Forbidden City) and mountains surround the capital on three sides.	Kunamagquma amathathu kuphela angatholakala emikhawulweni yedolobha (eJingshan Park enyakatho yeDolobha elivinjelwe) futhi izintaba zizungeze inhlokodolobha ezinhlangothini ezintathu.
The honorable member said some members of this Government had participated in that practice.	UMchunu uthe amanye amalungu ombutho wamaphoyisa afakwe ngaphansi kwalolu phiko.
Writing computer programs for various purposes.	UHlelo-Ukubhala ikhompyutha amaphakheji ngokuqondene nezinjongo eziningana.
14 Thou makest us a proverb among the nations, and a nodding of the head among the people.	14Usenze saba yisiga phakathi kwezizwe, ukunikinwa kwekhanda phakathi kwabantu.
He was a paramedic and communications specialist.	Ubengumfundisi wezokuxhumana nobuntatheli kwangqondonkulu.
Numerous other cultivars are grown on a local basis.	Eminye amaphrojekthi amaningi okuhlala aqhamuka endaweni.
The distinction (I think) is that the	Mindset Cabanga (Cabanga is the
Walking is an easy exercise to get your body ready for the day.	Ukugijima kusihlwa kunenzuzo yokuthi umzimba wakho ulungele ukuvivinya umzimba.
Name: Looking After The Herd.	Name: bhekisisa Zondo
Democrats certainly seem to be evil.	I-Democrat ibukeka ingalungile.
about their future and their hometowns' future.	ngenxa yekusasa labo kanye nekusasa lomhlaba wabo.
When we've done something wrong, we can be held accountable through the grace of Jesus.	Ngalokho-ke, nasenze into ephambene nokulunga, kufuze sibawe uJehova asilibalele ngehlawulo kaJesu.
Traceability, when it comes to animal products such as meat, is incredibly important.	Kungaba zithathwe kuyi yimuphi ubukhulu, umkhiqizo ezifana isidlo inyama neze konakalisa.
Grubby bandages that are changed twice a day.	I-bandage enamaqabunga ishintsha izikhathi ezi-2 ngosuku.
Coolio - 1, 2, 3, 4 (Sumpin' New) listen to all release completely in mp3 impossible, download release album mp3 impossible too	[mp3] Izintombi Zase Mhlangeni - Bhasobha Nsizwa / Usuka Emqadini listen to all release completely in mp3 impossible, download release album mp3 impossible too
And Abimelech said to Isaac, Go away from us, for you are mightier than we are.	"U-Abimeleki wathi ku-Isaka: ""Suka kithina, ngokuba unamandla kakhulu kunathi."""
The local authorities are investigating.	Iziphathimandla zendawo ziyaphenya.
If they must stay outside, ensure they have protection from the sun.	Lapho uwathola, kudingeka uwavikele angahwamulwa yilanga.
If you are eligible, and have taken the steps to become registered, then you have the right to have a say in the election.	Uma ungowalapha futhi iminyaka ivuma, unelungelo lokubamba iqhaza uma sekuvotwa.
That's what that certificate means.	Yilokho okushiwo yile bhulogi.
These plates are highly appreciated by ......	Kula mathebula kwamukelwa nguFunda kabanzi...
It does not have zero knowledge encryption, however.	Ayinaso isikrini ngolwazi.
the book of hope	Incwadi yesithenjwa
color white, black, red, blue..et. according to customer's requirement	Okumhlophe, Okubomvu, Okumnyama, Okuluhlaza okwesibhakabhaka, ngokwemfuneko yangempela yekhasimende
You are the only one putting stuff up in animation.	Wena kuphela okunye senze isimo sishube.
(Revelation 13: 3, 4; 16:2) They do this by giving worshipful honor to their country, its symbols, or its military might.	(IsAmbulo 13:3, 4; 16:2) Lokhu bakwenza ngokulihlonipha sakulikhulekela izwe labo, uphawu lwalo noma amandla alo ezempi.
Let George Do It (0)	Let George Do It ukulele
A man's labor never belonged to Caesar.	I-iyunithi yokuqasha ephelele ibungazwe ngu-CÃ©sar Mauricio
"I'm going to look at the fingers of the two other women who are coming to see me now that are a couple of months along."""	Ngicela ukuthi ngiqale ngiye ezintabeni lamankazana angabangane bami ukuze ngiyekuba labo okwezinyanga ezimbili.'
Or at least most of.	Noma okungenani iningi.
When you plan to celebrate with some bubbly, you want to do it in style.	Uma uhlela ukugubha ngezinye izinto, uyafuna ukukwenza ngesitayela.
The partially digested food, now referred to as chyme, exits the stomach and begins passage through the small intestines.	Ukudla ingxenye yomzimba kugaywe, manje obizwa ngokuthi i chyme, akube kusakhulunywa ngaye isisu bese iqala adabule amathumbu amancane.
"Q. How can we fulfill the ""law of Christ?"""	"Kuyini esingakwenza ukuze sitshengise ukuthi siyawulalela ""umthetho kaKhristu""?"
Also on September 21 (Nativity of the blessed virgin) signs were made about the future life of the spouses.	Futhi ngo-September 21 (Ukuzalwa KukaKristu laseTheotokos) izimpawu ngokuphathelene nekusasa ukuphila abashadayo.
The manner in which it is used	Indlela esetshenziswa ngayo
These factors may increase the risk of getting pancreatic cancer:	Kungakhuphula ubungozi bomdlavuza wekhanda we-pancreatic:
"""Are you laughing yet?"""	"""Usahleka namanje?"""
Who knows, maybe it will make people more determined to change everything.	Kwazi bani, mhlawumbe la idatha ukwenza abantu abaningi ukuba bathuthukise ukuphila kwabo siqu.
I'm a big fan of zooms, but many others prefer fixed.	Imvamisa ngiwumlandeli weFedora, kepha izinketho eziningi ziba ngcono
Always keep your dog on a leash and be courteous to those around you.	Gcina le nja ku-leash yabo ngaso sonke isikhathi futhi uqiniseke ukuthi bahlala eduze kwakho.
"""As an apple of gold in silver carvings is a word spoken at the right time for it."" - Proverbs 25:11"	"""Ilizwi elikhulunywe ngesikhathi esifaneleko lifana namahabhula wegolide akghabise esitjeni sesiliva."" - IZA."
In other areas, the color was applied by spraying the pigments by blowing the mixture through a tube.	Kwezinye izindawo, umbala wawusetshenziswa ngokufafaza imibala ngokushaya ingxube nge-tube.
My best friend Ruby	Thandekile Ruby
3For behold, the LORD is coming forth from His place.	1:3 Kuba yabona, INkosi iya kuphuma endaweni yayo.
// use it here.	Sebenzisa Lapha!
Well, in English we only have one word: Time.	Imane, kukhona umthetho owodwa kuphela - isikhathi.
Learning difficulties are often picked up at school.	Bavame ukubhekana nezinkinga esikoleni, bebhalwa nge-ADD
More than 1500 forecasts are made every month.	ukukhiqizwa nyangazonke abangaphezulu kuka-1500 amasethi.
(Acts 13:22) Many a battle has been lost through failure to follow orders.	(Gen. 3:6) Abantu abaningi abaye behluleka ukuzithiba baye babhekana nemiphumela ebuhlungu.
Topic: I'm pleased to say its official	Tag: thokozani langa ukuzala ukuzelula
Therefore, there is a high chance that...	Lapho-ke amathuba makhulu okuthi...
That is either English or/and Spanish.	Nasi isichazamazwi sami saseSpain / sesiNgisi.
The rule of thumb is that growth	Ukulele Tabs Take That ukulele tabs
"""We have a lot to improve."	"""Sinezinto eziningi okufanele sizilungise."
Go to a surgeon and you get surgery.	Qalisa kudokotela futhi qiniseka ubambe imvukuzane ehlinzwa.
3, transaction security needs to be strengthened.	10.33 Uma ngabe kukhona izixhushuxhushu zabasebenzi ukuphepha kufanele kuqiniswe.
The protesting Aam Aadmi Party leaders said that they will not call off their strike until their demands are met.	Ongusihlalo we SGB uThandi Shezi uthi ngeke nje baze bayeke ukubhikisha kuze kube ukuthi isikhalo sabo sikathishanhloko siyezwakala.
He provides the guidance we need in order to make good decisions, ones that honor god.	Unikeza isiqondiso esisidingayo ukuze senze izinqumo ezinhle ezidumisa uNkulunkulu.
"""The course will be closed until further notice,"" according to a news release from the college."	"Isikhungo sizovalwa kuze kube kukhishwa isaziso esehlukile,"" ngokusho kwesitatimende."
It goes hand in hand with our status	Uluhlaziya kanjani uhlobo lwethu ngesandla
Return to the Flooded City	Ukugibela edolobheni futhi ezindaweni ezimagebhugebhu
Put yourself in the place of Mrs. Matthews.	Sigcine kushampeni wasoGwini uNkk.
The three fields...	Imikhakha emithathu ...
until after the first World War.	Kwaze kwaba kweMpi Yezwe Yokuqala.
For example, if you add a credit card or other payment method to your Google Account, you can use it to buy things across our services, such as apps in the Play Store.	Isibonelo, uma ungeza ikhadi lesikweletu noma enye indlela yokukhokha ku- akhawunti yakho ye- Google, ungayisebenzisela ukuthenga izinto kuwo wonke amasevisi ethu, njengezinhlelo zokusebenza ku- Google Play Isitolo.
6 For it is itself also from Israel: a workman made it, and it is not God.	8:6 Ngoba ngokwaso futhi kwa-Israyeli: isisebenzi kwenza kwaba, futhi akuyena uNkulunkulu.
Selective serotonin reuptake inhibitors (SSRIs) are a group of medications used to treat depression and anxiety disorders.	ISerotonin Selective Reuptake Inhibitors (i-SSRIs) yindlela yezokwelapha ejwayelekile ekhethiwe yokubhekana nokuphazamiseka kwemizwelo nokudangala.
"""Beasts Of The Southern Wild"" Is Incredible"	"""Kulala Desert Lodge is amazing"""
The explanation could also be very simple: Depression.	Into kuphela ukuthi kwakungase ukwesabisa - ukucindezeleka.
It's ALL about Rooney.. ffs	About rofanini - Thingiverse
D'Andrew teaches	Dunedin Ukulele Lessons
Also, you want to make sure, from Stage 1, that your blog post will be able to stand against the passing of time and stay helpful even years from now.	Futhi, ufuna ukuqinisekisa, kusukela ku-Stage 1, ukuthi okuthunyelwe kwebhulogi yakho kuzokwazi ukuma ngokumelene nokudlula kwesikhathi futhi uhlale uwusizo ngisho neminyaka kusukela manje.
The first section features the games and gambling options.	Ngakho, iqembu lokuqala lemithetho lihlanganisa izenzo nama-akhawunti wokudlala.
They were well-versed	vs Sindile Manengela
However, despite benefits such as transplants, cloning does carry some difficult ethical issues.	Naphezu ukuthuthukiswa omuhle ukuhweba iimfesi, zikhona izinkinga ezifana nokushoda isikhala okudayisa.
It also works not in Firefox in these cases.	"Nokho, lesi sidakamizwa ""Flucostat"" Ezimweni ezinjalo, ngendlela efanayo akusebenzi."
Koma says he doesn't know the man, but he could have dealt with him or someone he knows in court at some stage.	UKoma uthe akayazi le ndoda kodwa kungenzeka ukuthi yake yahlangana nayo enkantolo ecaleni elithuize noma nomuntu owaziwa yiyo le ndoda.
I don't know whether the bodies	Angazi noma umzimba wakho
This is What Old Computers Are Good For...	Lokhu kuhle kumakhompyutha amadala nakan...
"Yes, ""I'm ready to be judged."""	"^ Noma, ""ngilindele isahlulelo."""
"But, make sure to not run any one test for an ""extended period of time."""	"Kodwa ningatatazeli uma uxilongwe ""ukuguga ngaphambi kwesikhathi umzanyana."""
created all things, and set them in order, and endowed them with	Wadala zonke izinto futhi unokuhlakanipha namandla angenamkhawulo.
Top 10 things I learned.	- Izinto Ezintsha Eziyishumi Eziphezulu Engizifundile
The four inner planets are also known as rocky planets or the terrestrial planets.	Lawa maplanethi amakhulu amane egesi abizwa nangokuthi amaplanethi weJovian noma amaplanethi angaphandle.
the musical in london	Umculo kamuva waya eLondon
The Card of 10-20 years ago is not the Card of today.	inqubo Exchange yephasiphothi eneminyaka engu-20 no-45 iminyaka akuhlukile version odlule.
Sometimes change the world.	Sake Ushintsha umhlaba.
Go to Dodds.	""" Tag dodane"
The right to pick a mate?	Futhi ukufaka umlingani?
That said, the shape that can be seen is consistent with a canid pad.	Ngenxa yalokho, ukuma okumele kubonwe kufane kufane nokudonsa okuphikisiwe.
Any one of those disciplines can provide the necessary knowledge base.	Ngayinye yalezi imithombo kungaba azimisele njengoba yithuluzi ulwazi.
As noted earlier, the defense has sustained a good level.	Njengoba kutjhiwo ngaphambili, isifundesi sihlale somile eskhathini esinengi.
"""Michelle Obama is now..."	Sasha Obama se ...
They would also have their heads back!	Balimaze azinikela amakhanda abo!
It was explained in the video...	Uchazile kule video kodwa. . . .
You need to help the little dragon pass through...	Siza ingelosi yakho encane idlule isigaba esibuhlungu...
A: In so many ways, its amazing.	A: amazing, bazinga
Now it's one of my favorite weblogs!	Lokhu kuphenduke enye yama-blog wami engiwathanda kakhulu!
So you can take a look at all of the data.	Ungabese nokuhlola izingxenye iyonke.
2% is locked in ice caps and glaciers.	I-20% ivaliwe eSitewide Mayelana Amakhava nakho konke.
According to them, the hotel is not new, but the rooms in it are cozy, clean, with fresh renovation.	Ngokusho kwabo, ihhotela akuyona entsha, kodwa izinombolo kuwo ethokomele, ahlanzekile, nge yokulungiswa fresh.
Deca Durabolin was developed in 1962 by a pharmaceutical company in Netherlands.	Deca Durabolin kwase kuqala kuhlelwe 1962 ngumuntu Netherlands inkampani eyenza imithi.
Naked women in bikinis	Women naked bikini
To understand yourself is the beginning of all wisdom.	Ukuzazi ngokwakho kuyisiqalo sakho konke ukuhlakanipha.
"We're going to hide you with us."""	Sizozifihla Kuwe (We will hide in You)
More of: teaching the consequences of crime.	Indlela engcono: Zitshele ngemiphumela eziyobhekana nayo uma ziziphatha ngokungafanele.
That punishment is death and it will last forever.	Ukuba ujeziswe Phakade, ubuyoba nokuPhakade.
â† Have You Been Fighting A Losing Battle?	Ingabe ufile ngokulwa nokuguga?
CTB won't be able to keep up.	CVT akakwazi ukubhekana umthwalo.
1989) is a national Catholic university with more than 11,000 students across its Campuses in Fremantle and Broome , Western Australia , and Sydney in New South Wales .	1989) kuyinto enyuvesi kazwelonke Catholic njengoba kungabantu abangaphezulu kuka 11,000 abafundi emhlabeni esewonke yayo e Fremantle futhi iBroome, Western Australia, futhi Sydney eNew South Wales.
the sessions at abbey road	Izindawo zokuhlala e- Abu Road
Twenty-eight per cent of the county forms part of two areas of outstanding natural beauty: the North Downs and The High Weald.	Amaphesenti angamashumi amabili nesishiyagalombili esifundeni akha inxenye Yezindawo ezimbili Zobuhle Bemvelo Obungafani: I-North Downs ne-The Weald ephezulu.
26:39 But if some few of these still remain, they shall waste away in their iniquities, in the land of their enemies, and they will be afflicted, because of the sins of their fathers and their own sins,	26:39 Kepha uma ezinye ezimbalwa zazo zisasele, bayakudangala ngeziphambeko zabo, ezweni lezitha zabo, futhi bayohlushwa, ngenxa yezono zawoyise nezabo izono,
Keanu Reeves, the lead actor in the film, appraised them highly.	Yebo, uKeanu Reeves owayedlala njengabalingisi abakhulu be-movie wenza ingcebo enkulu ngayo.
You add all the fuses together, then multiply by 10, that's the actual power rating.	Engeza sonke i zonke izingcezu imishini futhi wande lokhu Imininingwane ngu 0.6 ukubala izidingo zangempela.
Isn't this a happy day?	Ingabe kwakungelona lolo usuku olujabulisayo?
Even the vehicles that pass through the checkpoints are not checked.	Abashayeli nalapho ehamba endleleni ngeke zihlolwe.
It is a symbolic representation of	kuyinto ukwakhiwa okungokomfanekiso ukuthi
"""People were going, 'John, can I have a photograph?'"""	Abalandeli babememeza bethi 'Kev, ngingaba nesithombe?'
We did so in 1918 when Czechoslovakia was created.	Kwaze kwaba ngo-1918, lapho kumiswa eCzechoslovakia.
It is safe to say that the car is pleasant to drive.	Kuphephile ukusho ukuthi imoto muhle endleleni.
Chairman of the Civic Association	Endumeni Civic Association
The love is strong and unerring.	Uthando lwabo luqinile futhi alungeke luphele loba sekutheni.
This is merely saying	Imane Bethi
In the United States, on the other hand, a broad public was accustomed to investing long term at fixed interest rates.	Phakathi naleso sikhathi esifanayo, isizukulwane esisha sentsha esikhulile e-United States sasibonisa ukuthambekela kokusebenzisa imali eningi ezintweni zokunethezeka.
- 2 whetstones	Simunye 2 vintages
"I got some in the bag under my bed."""	"Ngisenazo ezinye zezinto zakhe epotimendeni elingaphansi kombhede wami."""
What if YOU were aborted?	Kuthiwani nxa wake wakhipha isisu?
Let's see - no, it was 1973.	Kholwa noma ungakukholwa, kwakungo-1923.
We believe that each person must repent and turn away from their sins, in order to know the forgiveness of God.	Yilowo nalowo esishukumisa kubo, ngokuqinisekile Allah, emva kokuba wacindezela yabo, iyona Forgiver (kuya amantombazane), i Nomusa .
It is not known if it is related with the contemporary Nikon BCB flash unit.	Abakwazi ukuthi lalotshwa ukuhluza kanye reggi r'n'b.
He was a true hero for me.	ibiyiqhawe kimi.
In his free time, he likes to read and spend time relaxing at home.	Mhlawumbe umyeni uthanda ukuzihlalela buthule ekhaya ngesikhathi sakhe esikhululekile afunde incwadi.
Mr. Jawfish Oct 3, 2008 10:42 AM (in response to Mr. Jawfish)	swathi samala Dec 8, 2008 10:44 AM (in response to swathi samala)
Stressing that accessibility to persons with disabilities is an integral part of smart and sustainable mobility;	ukuqashelwa elilinganiselwe yokuthi intando kuyinto qualitatively mkhuba esiyingqayizivele phakathi kwezinye izinqubo ngokwengqondo;
Every so often on a rare occasion he will say something that is inaccurate.	Ake uqale nge yokuthi ezimweni eziningi walizwakalisa into engaqondakali ngisho sona.
The things aboutcalcium carbonate production line.	Pe Carbon Kuvunguza Ukugxilisa Pipe Production Line
What will cause the end of the World?	Yini eyobangela ukuphela kwezwe?
Length: Standard length is 2.2m, it can be customized according to customer's requirement.	Ukuphakama kweMeshi: I-0.6-2.5m ingenziwa ngezifiso ngokuya ngezidingo zamakhasimende
Do not take my name in vain, And do not the day of rest profane.	Ungafihli ubuso bakho kimi ngosuku losizi lwami; beka indlebe yakho kimi, ngosuku engimemeza ngalo usheshe ungiphendule.
Use caution in patients with heart failure.	Sebenzisa ngokuqapha kubantu abanokwehluleka kwenhliziyo.
The result will be available one day later.	Lo mphumela azoboniswa ngemuva nolunye usuku.
You'll find regretably numerous businesses who don't do the correct do the job and even more worryingly don't know what to do.	Kunabantu abaningi ukuthi musa siyifake ulwazimagama yakho iyasebenza, futhi nakakhulu abangawazi ngisho ukwazi ukuthi yini kahle.
This option appeared to have little to no support from those attending the meeting.	Uma kuzobalwa inani labantu abebekhona kuyacaca ukuthi lowo mhlangano awunanzuzo kakhulu kulabo ababizwe kuwo.
These things are actually really simple to use.	Lolu hlobo izinto Kulula ngempela ukuyisebenzisa.
An example of this would be a lighting console.	Isibonelo esihle salokhu kungaba yiyunithi yokupholisa umoya.
"""It's quite a selfless thing."	"""Yeka, zinhle kuyinto unvarnished."
An online degree program isn't the exception to a pricey education.	Ngo inqubo yokuxhuma i-inthanethi kanye cable TV akukho mqondo wokuthi imfundo ayiphelele.
My name is Calton.	Mina Calini
marketed by telomerase	Ibungazwe ngu-Telari
It's every journalist's dream to travel and see the world.	Iphupho labo bonke abahambi ukubona umhlaba.
Day passes, which are available to non-members, are $15 per day.	Licasulwe ezinye izimenywa zingase kube ngaphandle ukuthi ikhokhwe-Wi-Fi, obiza $ 15 ngelanga.
to select the number when the unit is in standby mode.	Kwinombolo yomqondisi lapho iyunithi ithuke.
A bomb went off in the World Trade Center garage in 1993.	1993 liqhuma ibhomu e-World Trade Center omunye imibhoshongo amawele.
As far as the projects inside, don't get me started.	Nokho, esidlekeni ovulekile, ungaqali.
Until 5 weeks ago, I have been terrified of death.	Ukuze leli sonto elidlule Bengilokhu owesaba ukufa.
modern-day {adj}	Ugabuga - Mini
I miss all of them.'	"I kinda miss these."";"
We urge the Government to take the matter seriously.	Sinxusa uHulumeni wesifundazwe aluthathele phezulu lolu daba.
Parents need to develop a healthy relationship with kids from their early childhood itself.	Obaba kufanele uqale ukuxoxa izinto ezibaluleke nezingane zabo kusukela zisencane.
"""he did very well"""	"""Uyenza khakhulu"""
Therefore, here you can safely play the role of a foreigner.	Ngakho-ke, lapha ungadlala ngokuphepha indima yomfokazi.
that the information in this document is accurate.	Isitatimende sokuthi imininingwane esesazisweni inembile.
The most common conditions are hip and elbow dysplasia.	Inkinga enkulu yezinja ze-Feist yi-hip ne-elbow dysplasia.
On the other hand, stored value transactions using smart cards can be anonymous.	Kodwa ikhwalithi embi izinto zokusetshenziswa othengiwe ukusetshenziswa amahlamvu ngaphandle kokwazi ubuchwepheshe unakho ukulimaza.
Because it it could be done.	Futhi ngoba kungenziwa.
But even this information has been suppressed on the internet.	Ngaphezu kwalokho, le sevisi ngisho etholakala ku-intanethi.
"""Life is like a game where you seek to overcome the obstacles that stand in the way of achieving your goals. ..."	"""Impilo ifana nomdlalo ofuna ukunqoba kuwo izingqinamba ezikumisile ekufinyeleleni ezinhlosweni zakho."
Around 60% of the South Island and 20% of the North Island is mountainous.	Cishe ingxenye yesihlanu yesiqhingi saseNyakatho kanye no-66% weSouth Island yizintaba.
32 Now therefore, rise up by night, you and the people who are with you, and lie in wait in the field.	32 Ngalokho vukani ebusuku, wena nabantu abanawe, niqamekele endle;
overextending and running deep, which you can't get away with for	uzojula ozojula uzojula awuzujula ongezujula ungezujula
Place of Birth: Bodrum, Turkey	Place of Birth: Mabhuyeni, Empangeni
He is best known for his contribution to the Music Industry; not just in Nigeria but Africa as well.	Waziwa kakhulu ngegalelo lakhe kwi-Music Industry; hhayi eNigeria kuphela kepha nase-Afrika.
No, Hotel Plaza 24 doesn't have a pool.	Cha, i-Box24 Casino ayinazo izici zokubheja ezemidlalo
This isn't really 'bad' for anything except a throwout bearing.	"Akulona ngempela ""okunamathiselwe"" nganoma yini ngaphandle kwekhadiarine."
Sam's judging	Uithol Samuel
"The neighbors were yelling, ""Get out of here!"""	Amasosha amemeza: 'Asiphumeni lapha!
Japan has been a reliable customer for AgustaWestland's AW139.	Isengezo esimangalisa kakhulu sendiza enophephela emhlane ye-AgustaWestland AW139.
Any obsession with this woman is well-founded.	Lona wesifazane oshadile indaba enjalo kufanele yesabe.
"This short video (8'21"") by Scientific American - the Clitoris, is a fascinating history of the clitoris."	"Le vidiyo emfushane (8'21 "") eyenziwe yiScientific American - iClitoris, ingumlando othakazelisayo we-clitoris."
We need to find out what happened and who is to blame.	Udinga ukuthola ukuthi ubani nesandla kulokho okwenzekile nokuthi ubani uyowa ngenxa yomonakalo.
The driver survived with only a broken leg.	Inhloko isimo wasinda kuphela imoto armored.
Does it make sense to increase the rated voltage of the capacitor in order to prolong its useful life?	Ingabe kuyazuzisa ke ukuya ngaphansi ngommese likadokotela ohlinzayo ngenxa yokuthuthukisa ukubukeka kwabo?
Do Muslims believe in Jesus.	Kukhona akulona iqiniso yibona ukuthi AmaSulumane abakholelwa kuJesu.
There is no confidence in Chief Gatto.	Shingeki no Bahamut Cap.
shalt not be as the hypocrites	u nga bi njengabazenzisi;
bellevue house national historic site ?	Home Webshops Zalando Lounge
from the sky and asks	Zulu ukubuza
Or possibly some other issue.	Noma mhlawumbe omunye umbuzo?
My back.... the whole video	Ovulation While _ All video's _
Some experts say to cut it out completely.	Abanye ososayensi bacebisa ukuyiyeka ngokuphelele.
â€¢ Currently enrolled full-time or accepted by an accredited four-year college or university in the U.S. or Canada	Â·Ukwamukela noma okwamanje ukuya ekolishi evunyelwe uhlelo lwe-full-graduate noma lwe-graduate e-United States.
Worse than that, once a vendor finds a supplier they're happy with, they rarely look at whether they could decrease the price they pay for the goods.	Okuningi nakakhulu kunjalo, uma umnikazi ngemva kokuthenga isilwane uyaqaphela ukuthi izinga ayikwazi bayamnakekela amnike imali eyanele ukunakekela.
Then we will stand around the throne of God with the angels and saints, as we prostrate ourselves before the throne and worship God (Rev 7:11).	(Sung in Zulu & Tswana) (in Zulu) Siyakhothama (We bow down) Njengengelosi ezulwini (Like an angel in heaven) Siyazithoba (We humble ourselves) Phambi kwaBaba (Before our Father) Thina sithi (We say) ...
have you ever been on a mountain?	Uke wayigibela intaba?
Plan starts from $2.95/mo.	Ukubanjana okwabiwe kuqala ku-$ 2.95 / mo.
When it started: 1991	Haze amaze maze released: 1991
Miles is a boy Lalaloopsy doll that can sing!	Futhi izingane eziningi zokudala kukhona unodoli ukucula Elsa!
Because people aren't machines.	Ngoba amadolobha akuyona into oyisebenzisayo.
"He says: ""We have to be honest, and acknowledge that a big part of the money in our banks come precisely from the exploitation of the African continent."""	"Nansi umbhalo ofushane wenkambinkimbi: ""Kumelwe sibe qotho futhi siqaphele ukuthi imali eningi ebhange lethu ifika ngokuqondile ekusetshenzisweni kwezwekazi lase-Afrika."""
Victoria Beckham has always had a keen eye for fashion.	nenhle Njalo Viktoriya Bekhem, sekuyisikhathi eside okuyinto kube lokuma isitayela.
The word is therefore an anglicism.	Leli gama lihlanganisa inkulumo futhi Anglicism.
Is Prepaid A Good Choice For You?	Ngakho ibhukhimakhi isinqumo esihle kuwe?
Specification Temporary construction fencing is an alternative to its permanent counterpart when a fence is required on a short-term basis such as for storage, public safety, crowd control, or theft deterrence.	Ukucaciswa ukwakhiwa lesikhashana uthango elinye ithuba sabafowabo unomphela uma kocingo liyadingeka nsuku yesikhathi esifushane ezifana isitoreji, ukuphepha komphakathi, ukulawula izixuku, noma ukweba ekulondolozeni.
See also Bochner's	ulaba to nani-khakhar
Ultra-thin, light weight	Amandla aphezulu, isisindo esikhanyayo
What is a Civil Servant?	Yini leyo yokuba yisisebenzi sikahulumeni?
It was predictable in its love of getting its own way.	Wakwazi unqobe ngokwayo phakathi uthando lwakhe.
In some respects, refugees face a different situation.	Kwezinye izimo, le isibotjhwa umelana.
Everything I have is a gift.	Konke enginako isipho nje!
First of all, there is the process of pregnancy itself.	Iphuzu olandelayo - ukukhulelwa uqobo.
The slightly fewer banking options, and also the selection of mobile slots and other casino games could have been bigger, are the only issues we'd want to see improved.	Izinketho zebhange kanye neqiniso elihlala likhona lokuthi ukukhethwa kwezikhala zeselula neminye imidlalo yasekhasino bekungaba kukhudlwana yizo kuphela izici zekhasino ephathwayo esingathanda ukuyibona ithuthukiswa..
Learn how to use these in your farm business.	Funda ukusisebenzisa ezitshalweni zakho.
Teachers who are struggling with alcohol	Bazoba senkingeni othisha abafika esikoleni bedakiwe
What is the debranching enzyme?	Kuyini ukususwa kwezinwele ze-enzyme?
- Be certain to have plenty of positive emotions.	Qiniseka ukuvakashela le ndawo, uzothola eziningi imizwelo eyakhayo.
At this, the beginning trader should know that there are two kinds of the process.	Labo abathanda lo mdlalo, Ziyazi ukuthi kukhona ezimbili izinhlangothi Tranformers.
The electric chair by needle.	Ikamelo e-ifulethi ibungazwe ngu-Yalila
The months of December and January cover our summer school holidays.	U- Disemba no- Janwari yizinyanga zokuphumula eziqondana namaholide esikole okuphela
You find the opportunity to work for yourself!	Nakani ngokwakho, uthole esebenzayo!
In most other cultures to date, men are, on average, three to four years older than their mates.	Kakade kusukela onyakeni wesithathu ukukhula Sebeyeza ziyahlukahluka. amaduna asekhulile ngokuvamile ezincane kuno nezintombi zabo at 4-5 cm.
Antonym of path of least resistance	HomeSofa Minimalis ModwaySofa Minimalis Modway
average life of 12-15 years.	Isilinganiso sobude bokuphila zohlobo okuyisilinganiso seminyaka engu 12-15.
Wouldn't it be better to use coloured dots?	Kungcono kakhulu ukukhonza izipelepele ezigxotshiwe?
The Louisiana Opt...	Labo 8 Louiza
Several of my work colleagues did the same.	Iningi lontanga yami nalo lalenza okufanayo.
Or wondering how to work out at home with no equipment?	Indlela yenza ekhaya, ngaphandle kokusebenzisa imvubelo?
Remember, the sensor only knows that the film needs 'x' amount of light to be properly exposed.	"Qaphela ukuthi idivayisi ibonisa umphumela kuphela, njengoba ukuze uthole isisindo ngqo odinga ukukwazi ukubaluleka ""g"" lesifunda."
Both parents are not needed.	Futhi abazali ayisadingeki.
This part of town is firmly urbanized now.	Le ndawo elisondelene ukuhlala manje ukwakha ngokunethezeka.
In most cases, the frozen	Kaningi - Abkhaze
Everyone has the right to drink Water -	unelungelo lokuthola amanzi, wonke
It is especially beautiful in the summer.	lihle ikakhulukazi ehlobo.
2 they're laughing.	Bahleka ngani na? 2.
"""Have you seen my master?"	Futhi okwekati ubona enkosini yayo?
It is important not to wait for the customers to come to you with their problems and challenges, but to be prepared instead.	Kubalulekile ukuthi ochwepheshe bÃ©nza konke okusemandleni abo nempahla Akawukhululi wena bekuhlupha futhi bafika singakapheli isikhathi esibalulwe isikhathi.
The Cuban government said the discussions are scheduled to end Thursday.	Isolezwe lithole ukuthi ukusakazwa kwezinhlelo kugcine ngoLwesine.
And I will increase thee very exceedingly, and I will make nations of thee, and kings shall come out of thee.	Futhi ngiyokwandisa impela inzalo yakho, ngiyakwenza futhi izizwe ngawe, namakhosi ayovela kuwe.
We are 7 billion on this planet and I'm pretty sure someone out there will also like them.	Kuleli zwe 7 billion abantu, futhi ngokuqinisekile phakathi kwabo kukhona uzobe bani esihle, futhi ubani bayokwazisa uyasazisa.
to try to overturn it or reverse its course, in full or in part.	Kufanele uthole kwesigaba okuyiphutha noma node, ekubuyiseleni noma ngokuphelele ulibuyisele.
Eventually he asks to marry Laban's daughter, Rachel.	Wayefuna ukushada nendodakazi kaLabani encane uRachel.
Take a look at our amazing clothing store by clicking here.	Thola le t-shirt enhle yombhoxo esitolo sethu ngokuchofoza lapha
Envision yourself having the end result.	Dvweba sitfombe engqondweni yakho ukuthi ufuna uthole umphumela.
This protocol has not been arbitrarily chosen.	Kulokhu, ngokuzenzakalela isiqophi imodi alukhethiwe.
However, it simply isn't possible, and will never happen.	Kodwa lokho nje lutho ngeke benze kanjalo, futhi ngeke ukuvela.
This is the time, more than ever, to focus.	Ngikholwa ukuthi isikhathi sokunaka nokugxila kukhulu kunanini ngaphambili.
H.H. The Rulers	Mookho Ramabusa
Use compressed air to get rid of dust.	Sebenzisa indwangu ethambile ukukhipha noma yiluphi uthuli
E! proclaimed.	Kumemezeleni .
at the Johnson Space Center in Houston, Texas,	Enkabeni ye-Texas, ihhovisi lethu lendawo e-Houston,
In the event that you have a vocation out in the open administration, then you may choose to get the tattoo in a range that you can conceal.	Uma kwenzeka unomsebenzi obala ekuphathweni okuvulekile, ungase ukhethe ukuthola tattoo ebangeni ongawafihla.
respectful, but engaged.	Ekhangayo, kodwa ezinikeleyo.
This was what I could afford.	Yile leased engingayenza.
There is no doubt therefore, that the Testicles plays a role in Prostate development.	Ngakho-ke kuvela ukuthi amadoda amthandabuzana ayidlala indima yokugqugquzela.
Within the Tyne & Wear area also scrap	Izindwangu zombala zombili ze-Yarn zadaywa &
We don't dock the tail.	Sibamba intambo.
Nevertheless, the suppression rate differs from a steroid to another.	Noma kunjalo, isilinganiso sokucindezela siyahluka kusuka ku-steroid kwesinye.
A bidder will be able to remove the undescended testes.	Ingcweti angenza ukususwa izitsha abathintekayo.
It doesn't matter what stock or configuration a rifle is in, it shouldn't be banned for appearance sake.	Akunandaba ukuthi uhlela ukusebenzisa siphi isikhali, njengoba ukutholwa kungasuswa kungakhathalekile usayizi noma uhlobo lwenhlamvu.
Reviews about the time during which the effect of the procedure remains, are individual.	Izibuyekezo of the ngesikhathi owalondoloza imiphumela yenqubo kukhona ngabanye.
the World Drivers' Championship nine times.	Ingabe iqhawe Olympic iqhawe emhlabeni izikhathi eziyisishiyagalolunye.
Start with wood floors.	Sungula ezigxotsheni kwezinkuni.
Engagement shoot - a great opportunity to get to know each other better	joyous celebration 18 yeki inhlanhla yokwazana
In any case, you have the option to refuse to provide your personal data.	Kunoma yikuphi, unganqaba ukunikeza idatha yakho siqu.
32 And ye shall bear no sin by reason of it, when ye have offered from it the best of it; and ye shall not pollute the holy things of the sons of Israel, and ye shall not die.	"32 Aniyikuthwala sono ngenxa yakho, lapho seniphakamisile okuhle kwakho, ningahlambalazi izinto ezingcwele zabantwana bakwa-Israyeli ukuba ningafi.' """
Every area is suffering in these high temperatures.	Uhlobo ngalunye lwesilwane lubhekana nemiphumela yalo ngamazinga okushisa aphezulu.
They were especially grieved by his statement that they would never see his face again.	belusizi kakhulu ngezwi alishilo lokuthi abasayikubona ubuso bakhe.
At 39 (going by his date of birth - 1937) he became a military ruler at 39.	Wayeneminyaka engu-47, 37 ngawo (ngekhefu) kwaba isikhulu eMoscow.
There is no UNIVERSAL solution.	Ikhambi Universal ukhwehlela alikho.
"The Bible points to our Creator, Jehovah God, and says: ""With you is the source of life."""	"IBhayibheli nalikhuluma ngoMbumbi onguJehova uZimu, lithi: ""Kuwe kunomthombo wokuphila."""
dONALD tRUMP HATES this group of people.....half boiled educated.	Le noveli ithandiwe nguDonald Trump... # Wonke amalungelo agodliwe..
I think that Wally is going to eat the Professor in the end.	I think Walez eat kids anyway.
"So it's best not to lie."""	"""Ukugwema ukuqamba amanga kuyinto enhle kakhulu."""
They are divided into seven areas of operation.	Turkey ihlukaniswe yaba izifunda 7 zokuphatha.
"""I must admit that there were some colleagues who felt that this policy would infringe on human rights but the no one has the right take away somebody's life."	"""Kumele ngikubeke kucace ukuthi kukhona abanye ozakwethu abebekhala ngokuthi lo mgomo uzofinyeza amalungelo abantu kepha akekho onelungelo lokuthatha impilo yomunye."
"The same is true of Christ's anointed followers, whose ""citizenship exists in the heavens."""	Kungokufanako nangabalandeli bakaKrestu abazesiweko, 'ikhaya labo elisezulwini.'
Ipcc special report on renewable energy 2019	bizobike Carbon ebike 2019
Interestingly, the state's Constitution of 1845 failed to mention the subject of higher education.	Ngokuthakazelisayo, UMthethosisekelo isimo sika 1845 kuhlulekile ukubalula isihloko imfundo ephakeme.
From the new world	Kusukela Ezweni Elisha
This will help to re-energise you.	Lokhu kuzosiza ukuvuselela amandla akho.
You want to get crazy?	iszimile u mad?
The most effective ways to use cocaine	Eyona nto ingcono yokushintshana Novacoin
Globalization doesn't have to mean uniformity or homogeneity.	Ngakho ingxube ngeke kugcine ductility futhi homogeneity.
Have a look at some of the support resources on their website.	Bona futhi ezinye ze-CV eziyisampula kwiwebhusayithi yabo.
China's emissions standards are stronger than ours	UK benzene emissions higher than US
It must be difficult and exciting to be in a school in a different coutnry.	Eyi kunzima futhi ibuhlungu lendaba kunzima ukugqunywa umsila esikoleni esisha.
Due to the importance of early detection and treatment, everyone over 40 is recommended to have an annual screening test.	Ukuze kutholakale lesi sifo ngesikhathi futhi siqale ukwelashwa kwaso, bonke abantu abaneminyaka engama-40 ubudala banconywa odokotela ukuba bahlolwe njalo ngonyaka.
We made it out of all of them but one.	Sibashiye bonke, kodwa munye.
Education is a part of the life of the students.	Ezemidlalo kuyingxenye nolimi yokuphila yomfundi.
Green: Less than 70%	Okuluhlaza: â‰¥ 80% amandla
Don't cut the stitches though.	Kodwa musa khipha amabhodwe.
- I LOVE my family.	Ngiyawuthanda umkhaya wami.
Numbers 16:11 11 Therefore you and all your company are gathered together against the Lord.	16:11 futhi ukuze lonke iqembu lakho limelane neNkosi?
Jesus H. Christ, I missed it!	Isis, we miss ya!
13 Jehoash rested with his fathers, and Jeroboam sat on his throne.	UJowashi waselala laboyise, uJerobhowamu wasehlala esihlalweni sakhe sobukhosi.
It's something he can only guarantee by sending her back - so he had.	Okuwukuphela okushiwo azithathe yakhe - ngaphansi yokubuyisela njengoba ngalendoda.
Step 3 is the quick getaway.	Inyathelo 3 Ukubetha ngesivinini esiphezulu.
And I am sorry if I did (which I know I did)	Ngithi ngithi I'm sorry if ngakwenza kabi (you know I'm sorry)
4.6 million cubic metres of .	Ukwakhiwa Kwenkontileka YeMeter 4 izigidi ezingu-960 eziyi-TL
let's ride on the subway	Jenda Embangweni Edingeni (underway)
More people are willing to make the switch when the economy is booming.	Ngaphezu kwalokho, abantu bayoba isifiso nakakhulu ukucela izinsiza zakho uma umnotho iqala ukuya ekwehleni.
We learned what we can do ourselves to prevent disease outbreak.	Sesizohlala phansi sibone ukuthi esingakwenza ukwenqabela imikhuhlane ebantwaneni yikuyini.
"At the time, Leon Livermore, chief executive of the Chartered Trading Standards Institute, wi: ""Criminals and irresponsible manufacturers will often exploit high demand and attempt to flood the market with cheap and dangerous products."	"Ngaleso sikhathi, Leon Livermore, esiphezulu Chartered Trading Standards Institute, wathi: ""Izigebengu abakhiqizi kokunganaki ngokuvamile ukuxhaphaza baningi futhi azame ukunqwabelana emakethe nemikhiqizo ezishibhile futhi iyingozi."
As an added bonus, these wallpapers help in keeping your home fire-resistant.	Njengebhonasi, ngokugcina ugaxekile ngaphandle, lezi zihlungi zogaxekile zikusiza ukuthi ulondoloze isikhala emafolda akho eposi.
personal and corporate people all over the world.	Yomuntu kanye neyeqoqo kuwo wonke amabhizinisi ethu emhlabeni.
List of Companies in Ormond Beach:	Ezinye izindawo zokuhlala e- Ormond Beach:
It may happen even at night.	Kungase kube ngisho nezikhathi ebusuku.
6 From the womb of my mother I rely on you; You brought me out of the mother's womb; You are always the object of my praises.	6 Ngencike kuwe kwasesiswini; nguwe owangikhipha ezibilinini zikamame; ukudumisa kwami kuyakuba ngawe njalo.
What's In It For Homeowners?	Kuyini for osomabhizinisi zasekhaya?
In a global marketplace, it is highly competitive.	Kuwo wonke emakethe ihlukene, simelela izinga phezulu.
The Canon EOS-1D is a professional digital single-lens reflex camera launched in November.	Canon EOS 1D Mark II - enhle kakhulu professional ikhamera yedijithali, ukukhululwa esasimenyezelwe February 2004.
The Gowans are also pictured.	Gouache futhi emifanekiso.
It is not the best solution but I can at least get some work done.	Angisho ukuthi yisixazululo esifanelekile kepha okungenani yiso engisisebenzisa ngempumelelo ethile.
?And I am not sure that the bank would lend me the money to start up the business at the level I would want to.	"""Angazi nokuthi ngizoyikhokha ngani le mali engayiboleka ebhange ukuze kuqalwe leli bhizinisi."
Only now do I understand why.	Kuphela manje Ngiyaqonda ukuthi kungani.
ii . if it becomes necessary for the purposes of the Constitution or in the interest of good government; or	(ii) uma kuba nesidingo ngenxa yomthethosisekelo noma ngenxa kahulumeni omuhle; noma
Over the years, Cellcom has given away millions of dollars in prizes and giveaways to its subscribers.	Eminyakeni edlule, i-AVBOB yabelene ngezigidi zamarandi kumalungu ayo ngamabhonasi akhethekile nezinzuzo zokungcwaba zamahhala.
Sushant's family has been actively seeking justice for the actor's death on social media.	Umndeni kaselby uthi usufisa ukubona kwenzeka ubulungiswa ngecala lokufa kwelungu lawo.
It is better to choose color options that do not pass the sun's rays.	Kungcono ukukhetha okukhethwa umbala, okuyinto ungavumeli imisebe yelanga.
Each acupuncture treatment is specifically tailored to your needs and complaints.	Ukwelashwa kwe-asthma ezibhedlela kuklanyelwe ukuhlangabezana nezidingo nezidingo zakho ngazinye.
That's what he is today.	Yena lolokuyengako namuhla,
Entrepreneurship (in the form of profit)	Ukwakheka Kwebhizinisi (Okwenziwayo Nenzuzo)
The very next verse is even clearer.	Futhi ivesi elilandelayo liyesabisa nakakhulu.
We know that he didn't do this.	Ngangazi ukuthi akenzanga noma yikuphi kwalokhu.
What are the fundamental laws established judicial system of the Russian Federation?	Yiziphi izici of amajaji eNkantolo yoMthethosisekelo Russian?
Includes roasted hazelnuts.	Hlanganisa nama-hazelnuts aqoshiwe.
Near the border with Mongolia is a large Russian settlement - Irkutsk.	Phakathi kumiswa isimo labetibambile ekunqotshweni indawo enkulu Russia amaMongol-AmaTatar.
second half.No.	2 0 no. no. yes.
"These workouts cannot be changed ""on the fly."""	"Awunayo ukuxazulula izinkinga ""usohambeni."""
Trinity Street in the town has been closed and motorists are advised to drive with care.	Ukunquma okuyinto treadmill kuhamba phambili ekhaya, abasebenzisi belulekwa ukuba sinake ukujiya lendwangu.
A birth must be registered in the district where the baby was born.	Kufanele ubike ukuzalwa kumasipala lapho ingane yazalelwa khona.
It's a bit of an odd feeling contemplating dual booting again.	Bukhona ubuwula ekushayweni yinduku eyodwa kuphindelela
â€¢ Are the conclusions justified by the facts presented?	Ã¢ â‚¬ Â¢ Ingabe ziyoshukumiseleka nakanikelwe imiphumela yabo?
Even More Than I Usually Do.	Yebo, ngisho nangaphezulu kokujwayelekile kunalokho abavame ukwenza.
I hope it truly helps...	Ngiyethemba ukuthi iyakusiza impela ...
where we don't have to fight	who fucks sinazo yolwa
She says I'm good, but nothing beats a woman.	"""Ngibatshele ukuthi badukile, akekho umuntu wesifazane lapho ngiphuma khona."
She was ordered to stay in hospital for a week.	Wadluliselwa kulesi sibhedlela wahlala isonto.
I had a dream of all the	Benginamaphupho njengowo wonke umuntu
Pertaining to nitrogen.	Sikhuluma nge nitrogen.
If an explanation is not logical, it is not an explanation.	Uma kukhona okungahambi osobala incazelo - akukuhle ukufaka.
It may be very disappointing.	Kungaba pretty ezidumazayo.
D'Anna, now	Anna Sisani
"""Let us remember the golden heritage of our country and feel proud to be a part of India."	Asikhumbule ifa segolide wezwe lakithi futhi siziqhenye ngokuba yingxenye Australia
Hopelessly Devoted To You 03:00	3 Ngibhekise Kuwe Rethabile Khumalo 5:00
The two-car garage	Inqola Yokuthenga Enamasondo Amabili
I Don't Get Older I Level up	I do not Age I Level Up
Light comes to us as energy, as n...	Ngokubuka kwabo, ufana nogesi osinikeza amandla hhayi Umuntu. ...
"""Shut the door, please,"" said Ida, in a low tone."	"""Ngicela wenzenjalo, Sisi,"" kusho uMaVilakazi ngezwi eliphansi."
She, too, realizes that death is in their midst.	Futhi, bazi nokuthi ukufa kusemnyangweni wabo
No one had to give Ro Parra directions to Pimlico Race Course yesterday.	Ibingekho efuna ukugoba uphondo ePeter Mokaba izolo
Are You Looking For A Home Like Your Grandmother?	Uzama ukuthola indlu kagogo?
I'm not sure what caused the plaintext to be placed in my files on the original SD card.	Angiqiniseki ukuthi ngiyavumelana naleli gama Abathonya beMega ngaphakathi kwe-infographic, noma kunjalo.
That will be their secret.	Le yimfihlakalo yabo eyimfihlo.
Walk through the kitchen t...	Indlela machining phezu komhlaba th ...
***Only Happy When It Rains is available in five sizes.	>> Ngomusa uhlanza ngenkathi kufakwa umswakama omkhulu
"the animated television series ""South Park."""	"Lawa ochungechungeni TV ""South Park"" izinhlamvu."
It will be no different with the church in these last days.	Hhayi kwaze kwanzima ukusonta kulezi zinsuku zokugcina.
People have known for a long time that horses are a socially sophisticated species, but this is the first time they have seen that they can distinguish between positive and negative human facial expressions.	Isikhathi eside amahhashi ayizinhlobo eziyinkimbinkimbi emphakathini, Kepha kungokokuqala ukuthi kube khona ukukhombisa ikhono lalo lokweqa umgoqo ophakathi kwezinhlobo uze ukwazi ukufunda imizwa.
One might think that English is the most spoken language in the world.	Ngalesi sikhathi, singasho kalula ukuthi isiNgisi yilona limi olugqamile emhlabeni.
Don't use package to produce gross revenue.	Ungasebenzisi itjhila elisetjenziswa nguwe woke umuntu ukuhlwengisa amabele amanengi.
Gree won a lot of money.	Roulette Isu Win omningi Cash!
However we are also able to offer Companions who are willing to assist in the home on a full-time basis with care of the independent elderly (non-medical).	Noma kunjalo, labo abasele ekhaya bangasiza izikhonzi ezisenkonzweni yesikhathi esigcwele ngokulungela ukunakekela abazali bazo asebekhulile uma kudingeka.
"""Now my friend is trying to make a sign to piss people off."""	"""Umngane wami ungithumela manje umlayezo othi abantu bayasuswa ePower."""
Jeremiah 5:15 Lo, I will bring a nation upon you from far, O house of Israel, saith the Lord: it is a mighty nation, it is an ancient nation, a nation whose language thou knowest not, neither understandest what they say.	5:15 Bheka, O ndlu ka-Israyeli, Ngizohola phezu kwakho isizwe esikude, isho iNkosi, isizwe esinamandla, isizwe sasendulo, isizwe ongeke usazi ulimi lwaso, futhi ngeke ukuqonde abakushoyo.
How long will you make me wait to read that?	Ngiyabe ngizafunda kuze kube nini?
They would ignore all further e-mails, texts, and phone calls.	Babengawanaki wonke amanye ama-imeyili, imibhalo nezingcingo.
After all, if they did, they might live longer.	Manje yebo, uma sebekhona, bangahlala isikhathi eside.
Do you have the Piston?	Eyakho ipikitsha ikhona na?
Zimbabwean First Lady Grace Mugabe says that she will assist President Robert Mugabe in steering the country into economic recovery, according to a report.	Unkosikazi kaMengameli waseZimbabwe uGrace Mugabe uthi uzosiza uMengameli Robert Mugabe abuyisele izwe esimeni somnotho esifanele, ngokusho kwemibiko.
Protection and Care of Animals.	Ukunakekela ukunakekelwa kwezilwane nokusebenza kwezilwane.
Help for the Homeless and Hope for the Future	Abangenamakhaya futhi bafuna ikusasa elihle
Water is also a very crucial tool for healthy hair growth.	Lo mkhiqizo futhi manje iyithuluzi omkhulu, kubalulekile ukuze izinwele enempilo.
And everyone rejoiced when they were defeated.	Bonke babejabula ngokuthi base, ngaphandle onqobile.
I was lying down and taking a rest.	Mina yayiphumula futhi Endi Hug.
There are reasons why God doesn't answer some prayers.	Iziphi Izizathu Ezimbili Ezenza UNkulunkulu Angayiphenduli Eminye Imithandazo?
First of all please try to find the full context of the Video.	Ngemininingwane engaphezulu, zizwe ukhululekile ukubuka ividiyo ephelele ye- isethulo sokumaketha esingena ngaphakathi.
"Interestingly, the term ""political party"" does not find mention in either the American or Indian constitutions."	"Ukuze uzwisise ngokuphelele ukuthi igama elithi ""zemikhosi"" awabona ngempela ukuya eSpain noma Latin America ngemikhosi kazwelonke."
Also thank you for the gift's.	Ngiyabonga nangezipho uTshatha angiphe zona.
"""Your father and I have sought you sorrowing."" ---Luke 2:48"	"Mina loyihlo sesibhudule sabhudula sikudinga.""  - ULukha 2:48."
sometimes it doesn't work though. why not?	sawubona, hey kwesinye isikhathi ayisebenzi, kungani lokho kwenzeka?
It wasn't long afterward that the President of OWU resigned.	Akugcinanga lapho njengoba kungakapheli sikhathi esingakanani nomengameli we-EFA naye ememezele ukuthi uyasula esikhundleni sakhe.
What you need is someone who does not have a need to	uyodinga oyodinga eyodinga akayudinga ongeyudinga engeyudinga
"""Can you tell me your name? """	"""Ungangitshela igama lakhe?"""
c. assisting the financial institution in complying with performing such activities.	c. ukusiza isikhungo sezezimali ngokuhambisana nokwenza imisebenzi enjalo.
Seeing a pregnant woman	Uyothi Wabonani Mfazi Ongazalang
mortify their sins, they are lost.	Ngebanga lokuthi baba zizoni, bahlongakala.
He's always been wise.	Njalo ehlakaniphile.
The interviews were all given by Bob Rafelson	Amafulethi wonke ibungazwe ngu-Rafaela
I would describe the cannabis that I'm using now more as a hallucinogen.	Futhi ngikholwa kakhulu kunani lezokwelapha manje lama-amakhowe e-psilocybin ukwedlula engikwenzayo nge-cannabis.
But the awesomeness is not only that.	Kodwa ubuhle bayo abugcini kulokhu kuphela.
Trapped by the succubus online porn video	Watch Cewe ngisep enak banget porn tube video
Galvanized is not a metal or alloy; it is a process in which a protective zinc coating is applied to HDPE to prevent rusting.	Lashukumisa akuyona insimbi noma ingxubevange; kuyinqubo lapho kusetshenziswa khona i-zinc enamathela evikela insimbi ukuvimbela ukugqwala.
Before the beginning of classes, choose the appropriate course from a well-known coach and follow its rules.	Ngaphambi kokuqala kwamakilasi, khetha inkambo efanele evela kumqeqeshi owaziwayo futhi ulandele imithetho yayo.
The story of Alfa Romeo	Pawn a Alfa Romeo Kwenzekile
That's a beautiful icon!	Awesome icons nonetheless!
This is a big culture change, so you need support from all parties, especially those at the top.	Sisesikhathini sesizini lapho ubadinga khona bonke abadlali bakho ikakhulukazi laba abamqoka.
what do you do at sea?	nenzeni nje olwandle?
Some, but not all, of these include exemptions.	Ezinye, kodwa hhayi zonke, zalezi zimo zihileleka ukusetshenziswa okungeyona okungalindelekile.
Cover can be used as a purse.	Cover lungasetshenziswa njengoba isikhwama.
Why creativity isn't limited to the arts - and how you can blow the lid off your creativity.	Kungani amacembe awohloka kusukela rose, futhi ungabasiza kanjani ubuhle ezingezwakali?
"""A large number of persons"""	"""Lukulu lwa wantu ayingi"""
Their numbers have swelled to over 100.	Inombolo yabo ikhamuluke eside kudlulwe eziyikhulu.
Official Full Name platelet derived growth factor C	Igama lomkhiqizo oqediwe Inani lomkhiqizo ku-1XE, g
Soon, when you buy a new PC, it won't support Windows 7 or 8.	Ngokushesha, uma uthenga PC entsha, ngeke ukusekela Windows 7 noma 8.
Perhaps to launch an assault.	^ Mhlawumbe zokuhlasela.
Ask her what the world would look like if every single child were born to a single parent.	Siza ingane ukucabanga ukuthi eyokwenzeka iplanethi uma Leso naleso sakhamuzi iphula umuthi owodwa?
There's also a connection with sleep.	Futhi has nobudlelwano obuthile sleepwalking.
This book is primarily comprised of.	Le ncwadi ikakhulu siqukethe yakhe
itself, but it is.	kukhona, kodwa lokhu ngokwayo.
Show me your tongue, son.	Sikhombise ubuso bakho mntanami!
Was it only men that fought for women's rights?	Kodwa iqhaza amadoda kuphela ababemelene zokulinganiswa kwamalungelo abesifazane.
We are Moving Towards You	Sikhothama kuwe
What's left of Yvette Lation's house.	I-ikhaya eliyindawo yokuhlala ephelele ibungazwe ngu-Yvette
The study was conducted in two special education schools in Hong Kong.	Ucwaningo lwenziwe ezikoleni ezimbili ezisesiyingini saseMhlathuzana.
The Comptroller of the Currency is the oldest bank regu	Longdress Lowo Kencana Ungu Mandala Ungu
"Why did he sign it?"" said Mr Charalambos."	"Ubungavaliwe ngani?"" kubuza uMnuz Ramatlateng."
Winner of Best Managed Companies in Canada	Best kanambambili ongakhetha izinkampani abadayisi canada
â€¢ Hospitals.	â€¢ Ukubhedlela
17:02 Oh, you know the story of the golden calf.	25:24 Niyakulazi ulinameke ngegolide elicwengekileyo.
I remember better.	I remember nani
four of water.	4 amalitha amanzi.
Save us from all misdeeds	futhi usisindise kulo lonke usizi
"It is so much more than the superficial; it is so much deeper, its about sacrifice."""	"""Okungaphezulu kunjengaleyo ephansi; kuyini ku-Basis kufana nalokho okuphezulu. """
Someone had to haul him to the top of the roof, and lower him straight down through so that he could get to Jesus.	Baze bagibela phezu kwendlu bamehlisa ophahleni kanye nohlaka ukuze bakwazi ukumngenisa ngaphakathi phambi kukaJesu.
In other words, everyone would know of it.	Ngaphezu kwalokho, akukakaqali, ngaphandle kwalokho, sonke besizokwazi ngakho.
Let's see how we might use the Explorer.	Ake sibone ukuthi singabuyekeza kanjani i-Explorer.
Combining several concepts.	ngokuhlanganisa amasu amaningana kanyekanye.
Operating system - Mac OS X Mavericks or later	Ngohlelo lokusebenza lwe-Mac OS X Mavericks noma ngaphezulu
for Him alone.	Ngelakhe yedwa.
If they don't, well then at least you tried.	Uma bengakwenzi, kahle, okungenani ubungazama ukusiza.
The steam vents are zig-zag in design allowing even distribution.	Esegunjini, iqhwa zinhlayiya etshalwa okwenziwe ngayo ngisho kungenzeka ukunikeza ijamo design.
I'm sure it tastes as pleasing as it looks.	Ngiyayibheja inambitheka kahle njengoba ibukeka.
Open a command-line tool	Vula ngomshini Molding Line
If it is disturbed, the body becomes ill.	Uma abaphukile, umzimba ogulayo.
There are chairs and an umbrella to take to the beach as well as some beach toys for the kids.	Kukhona izihlalo zotshani ongazithatha uhambe nazo ukuya olwandle kanye namathoyizi olwandle wezingane.
How can i remove ads from my facebook page.	Ngikhipha kanjani ohlwini lwababhalisile ku-Facebook wami?
Or wear a neck brace.	Noma mhlawumbe ugqoke uhlelo lwe-bracket?
Finally, what's your niche?	Yini ubuncane be-oda lakho?
The new signs have sparked mixed feelings amongst the townsfolk.	Iphrojekthi engavamile yalesi sakhiwo ibangela imizwa exubile phakathi kwabantu abahlala edolobheni.
So, what's Dry Eye?	Yini iso elihle elishayolayo?
Country of origin: VN	Linha: Yu Yu Hakusho
"""The current summary judgement provides us with several options to recover the debt owed to us."	"""Sifike lo Mkhandlu ungenayo imali ngendlela yokuthi kuye kwaphoqeleka ukuba sithathe isinqumo sokuba kubuyekezwe amanye amathenda ebesinawo."
Will it take a long time to get them back off?	Ingabe bathatha isikhathi eside ukubuyisela lokho kulungiswa kuye?
Fascinated by the water	Simangele Manzini
We hope we can count on your support in this way.	Sithemba ukuthi ngokusebenzisa izindlela zethu ongayenza ngokwakho isisindo sakho ezinjalo.
And the name of it was called Oak of Weeping.	Futhi igama laleyo ndawo labizwa, 'I-Oak Yokukhala.'
But the immune system does not sleep.	Kodwa isimiso somzimba sokuzivikela akusho ukulala.
This evidence must be in the form of a letter, notice, or other official document.	Lolu lwazi kufanele lufakwe esigabeni samazwibela noma sokuphawula seposi.
Determine if the relation is a function. { (0, 1)... - OpenStudy	Bhekisisa ukuthi ubude besikhathi sokwenza umsebenzi othile buholela kusiphi isimo... [some part of sentence missing]**
There is also the difficulty of judging wins.	Ngaphezu kwalokho, kukhona nobunzima lapho ukhetha usayizi.
"""You shall have no other gods beside me."	Ningalaleli abanye oNkulunkulu ngaphandle kwami ningabakhonzi.
Female can lay eggs in its lifetime.	Insikazi kungaba amabhu amaqanda esiswini.
The windows were blank.	Amafasitela kufanele kube mhlophe.
Its earliest appearance is in the catacombs of Rome in the third century.	Lapho kukhulunywa ngaye okokuqala ke ezitholakala catacombs waseRoma ekuqaleni kwekhulu lesithathu.
Some may argue that when we are spirit beings we will no longer have Satan and his demons to temp us to do evil, and yet, we can see that Satan did not have any outside force tempting him when he became lifted up in pride and made the decision to rebel against God.	Ubufakazi bukaJobe buyisixwayiso ezizukulwaneni ezilandelayo, futhi lesi sixwayiso sizitshela ukuthi uma zingamnqobi, uSathane uyohlale ezimangalela njalo futhi ezinakile, azisobe zaphunyuka ekuhlukunyezweni nasekuhlaselweni uSathane.
that consisted only of two brief sessions in 2015.	Lokhu kwalandelwa ukuvakashelwa kabili okufushane ngo-2016.
king alfred the great novels	Ideal Alfred the Great Images
Instead of making the reservation alone, ask your friends to do the same way.	Njengoba inketho - nje ubheke abanye ukuba umngane wakhe isicelo efanayo.
Set objectives Before creating, the most important thing should set goals.	Ngemva kokubeka imigomo badinga ukuthi lilinganise, hlunga uqale ngokubaluleke kakhulu.
Also fits the Nikon D4.	Kufanele futhi ususe ifolda .kde4.
12:3) This article will discuss how Jehovah helps us in the following situations: (1) When we suffer illness, (2) when we experience economic hardship, and (3) when old age makes us feel as though we had nothing useful to offer in Jehovah's service.	12:3) Esihlokweni lesi sizaxoxa ngokuthi uJehova usincedisa njani nxa sigula, silohlupho lwemali lalapho sizizwa singaselancedo enkonzweni yakhe ngenxa yokuguga.
Keshav could not do so.	Ushakov ayikwazanga ukwenza okuhlukile.
What are the other products on the market?	Imiphi imikhiqizo emisha emakethe?
In Germany, all employees are legally entitled to paid vacation.	Ngokomthetho isiRashiya, bonke abasebenzi banelungelo ukuphumula.
Camptothecins are mainly used in lung, breast, and brain cancer.	Camptothecins ngokuyinhloko asetshenziswa ephashini, isifuba, umdlavuza ubuchopho.
an on-screen comparison, you can select to print a report detailing the changes as well.	Ukuvula zokubhala ibhizinisi, ungakwazi ukunikeza inkonzo umbhalo ukunyathelisa futhi ukukopisha izithombe kanye imibhalo.
What's with the use of apps and Chucky is now linked to all technology?	Erina lya Nyamuhanga yandi, kandi thukaminya thuthi ngoku thutholere ithwalikolesya?
Discussions are underway for the kickoff meeting.	Kubanjwa imihlangano ukuze kuhlelelwe ukusabalaliswa kwephrojekthi.
That'll make it easier for us to rule them.	Lokho kuyoba lula ngathi ukuwabeka.
And his parents were also proud of him - after they got through being angry and concerned for his safety.	Baphatheka kabi abazali bakhe ngoba uSipho elimoshile ikusasa lakhe emuva kokuba bemyalile ngokukhetha phakathi kwabangani ababi nabahle.
Be sure it is something you will both be happy with.	Into eyodwa ongaqiniseka ngayo ukuthi nobabili nizokujabulela lokhu.
Our position is that the intention of the judge was not clear.	"""Sithi ukubotshwa kwenduna akuqondanga."
With sheer will and determination, he created what is known as The Black Sphere.	Abaningi babo bafunana okwakuthandelene futhi wadala lo okuthiwa kwenethiwekhi.
because the priests.	ngani mapriso.
Psalm 11:5 The Lord examines both the righteous and the wicked.	10:6 INkosi ibuza amalungisa nabangendawo.
In this case, relief was granted.	Kwezinye izimo, impumuzo lasetshenziswa.
What the Court's Decision Means	ukwahlulela kusho
Other players have  replaced them.	Indawo yakhe yathathwa ngabanye abadlali.
This year's Budget has raised the annual investment limit in the PPF to Rs 1.5 lakh.	Isikimu sinophahla lokutshalwa kwemali lwaminyaka yonke lwama-Rs 1.5 lakh.
first in Haiti.	Okokuqala, ukusebenza eGoli.
Very few people get this opportunity.	Bambalwa abantu ababanikeze ithuba.
In SharePoint 365 it is no longer possible to open web pages directly in SharePoint 365.	32563 Awukwazi ukusebenzisa ifayela lesifanekiso ukudala i-database ngqo kusayithi le-SharePoint.
There are a variety of Thai girls.	Nazi Izizwe Ezihlukahlukene ZaseThailand.
How do you feel about the Book of Abraham?	Isibonelo saka-Abrahamu singakusiza njani?
Off the straight.	Suka ngakwesokudla.
The organization, which protects all information shared within confidential meeting settings, works to bring newly admitted gamblers to a place where they can carry on with their lives, make restitution to anyone who has been harmed sustainable their gambling and later serve as a mentor to others who are on the same path.	Inhlangano, evikela lonke ulwazi olwabiwe ngaphakathi kwezilungiselelo zemihlangano eziyimfihlo, isebenza ukuletha abagembuli abasanda kuvunywa endaweni lapho bangaqhubeka khona nezimpilo zabo, babuyisele noma ngubani olinyazwe ukugembula kwakhe futhi kamuva asebenze njengomeluleki kwabanye abasendleleni efanayo.
What Should I Do If I am a Victim of Domestic Violence?	Kumele ngenzeni uma ngiyisisulu sodlame olwenzeka ekhaya?
"A strong arm man."""	'Ingalo eqinile'.
Difficulties and challenges should not discourage us.	Ubunzima nezingozi eziningi ngeke kusidangalise, nesibhakabhaka esiwayo ngeke sisiqede amandla.
"Playlists containing ""I Got Habits"" (feat."	"Sinamathisele izithombe ezisuka kwi ncwadi yakwa BookDash ethi ""I can get dress myself"" (Ngingazi gqokisa mina)."
Note that it does not agree with the cardinal signs!	Qaphela ukuthi ayivumelani nezimpawu eziyinhloko!
A slave could not speak his mind to his master.	Eenkhathini zekadeni, ikosi beyingekhe ikhulume nesisebenzi sayo ngalokho ekucabangako nendlela ezizwa ngayo.
Why I don't make my hair	Kungani izinwele zami ziwa
It doesn't change the story from the earlier debates in which most people seemed to see Kerry as the winner.	Akwaziwa ukuthi kuzaphetha ngani ukutshengisela lokhu endaweni ezinengi kweleMelika lapho inengi labantu akade likhangelele ukuthi uClinton uzanqoba kukhetho lolu.
