"""Today is the day when Britain steps back from the brink, when we confront the bills from..."	እቺ ቀን እንግሊዞች የአበሻ እጅ ሊይዙ መቅደላ ጫፍ ላይ ወጥተዉ አፍረዉ የተመለሱባት ቀን ናት...
Your dream is still alive.	ሕልምህ ሕያው ነው።
'The creative energy that called the worlds into existence is in the word of God.	"""አለማትን ካለመኖር ወደ መኖር የጠራቸው በእግዚአብሔር ቃል ውስጥ ያለው የመፍጠር ሀይል ነው።"
Which leads me onto the next step...	ወደ ቀጣዩ ነጥቤ የሚያደርሰኝ...
While they seem to shy away from direct engagement, I admire their staying power.	የባህል አስተዋጽኦዎን ለማንቋሸሽ ሳልፈልግ ብቸኛውን ምልከታ አጥብቄ እቆያለሁ ።
them to read and write	ያንብቡ እና ይጻፉ
We have a constitution which clearly stipulates a parliamentary term of 6 years.	ስለዚህም ሕገመንግሥቱ በአምስት ዓመት ይደረጋል በሚል ያስቀመጠው ግልጽ ድንጋጌ ነው።
If you do not currently hold a license in ID, CompHealth's licensing team can help you with the processing and application.	በአሁኑ ወቅት የአካል ብቃት እንቅስቃሴ ካላደረጉ በቴላ የሚገኙ ባለሙያዎች የአካል ብቃትዎን ይገመግማሉ እና ብጁ እንዲያደርጉ ያግዙዎታል.
"""We are in the process of concluding our third viticulture certification series and can soon begin accepting applications for the next one."""	‹‹ሆኖም አሁን ሁለት አይነት ክትባቶችን እየሰጠን ነው፤ ሦስተኛውንም የክትባት አይነት በቅርቡ መስጠት እንጀምራለን›› ብለዋል።
Ulysses as an old man, in his bed,	ኡጁሉ ፈራ, ሚስተር ጌታቸው, አልጋነሽ አልቴ,
Vienna, engaged in a conversation	← ቅድሚያ የሚሰጡዋቸውን ይገናኛሉ _ የሚሰጡዋቸውን ውይይት
Handmade of 100% New Zealand Wool pile.	ቁሳቁስ100% ኒው ቀናኒላንድ Wool ፣ ወይም ብጁ
using the latest technology, there will be no smell to annoy the inhabitants of	በቅርብ ጊዜ ያልተነበበ መልእክት አሳይ የሰው ልጅ ሙቀት መታጠብ ካለበት ምንም ለውጥ የለውም
He'd been arrested several times in the past and released.	ቀደም ሲል ብዙ ጊዜ ታስሮ ተፈታ።
This is the Kingdom which will surpass all kingdoms, and which will remain forever.	ይህ መንግሥት ሁሉንም መንግሥታት ያጠፋና ለዘላለም ጸንቶ ይኖራል።
What's your message to Lola Luscious	ለሉላ ሎፔዝ መልስ ይስጡ
It's essential that you use what you were taught.	የተማራችሁትንም መከለስ ተገቢ ነው።
Barata, former owner of the jewelry store	ከ፡ ቀድሞው የሳጥንህ ባለቤት
Although I didn't purchase everything on her list, I did end up ordering many of her suggestions.	ይድረሰው አይድረሰው ባላውቅም በርካታ ደብዳቤዎችን ፅፌለት ሁሉ ነበር።
The Bengal Sultanate was one of the major Islamic states established after the Muslim conquest of the Indian subcontinent.	ሳኡዲ አረቢያ የቀንደኛ የዋሀቢ እስላማዊ አክራሪ እምነት ተከታዮች ዋነኛ ሀገር ናት።
And then it hits you - it's the 'snap-snap' of someone's flip-flops chipping away at your sanity.	እሷ፡- እንሳደብ ካልክስ- ስድብ ባንተ ይብሳል
most of all, your people.	ከምንም በላይ ሕዝቧ እንጂ.
fellows have never even heard his name.	ተከታዮቹም ስሙን እንኳ ሲጠሩ አይሰሙም ።
Kenya and Ethiopia are not really known for their large water reserves.	ኬኒያና ኢትየጵያ ግዙፍ የትስስር ፕሮጀክቶቻቸውን እውን ማድረግ አልቻሉም
acts as translator, not only of language but also of culture.	የተፃፈበት ቋንቋ ቋንቋ ብቻ ሳይሆን ባህልም ሆኗል።
"""That is not the way it was."""	"""ፈልጌ አይደለም እንደዚህ የሆንኩት ."""
Click here for more details. - Dues: $70/year.	እዚህ ላይ, ተጨማሪ መረጃ / በወር $ 2.
Now that we are at the end of our first two 'short' weeks of school, the students and staff are beginning to get used to our new building, and it feels as though the academic year has started in earnest!	ወደ አዲሱ የትምህርት ዓመት ወደ ሁለት ሳምንት የምንገባ ሲሆን ተማሪዎቻችን እና ሰራተኞቻችን ወደ ትምህርት አሰጣጥ ልምዶች እየሰፈሩ ናቸው ።
"""Why 'withering' of local news landscape is dangerous for democracy."""	"""የእኔ እዚሀ አገር 'እስካሁን' መኖር ሰበር ዜና የሆነበት ምክንያት ለምንድነው?"
According to The Shelton Group, 90 percent of millennials say they're willing to purchase from a brand when they trust that company's social and environmental habits.	እንደ ሸማቾቹ ገለፃ ፣ 90% የሚሆኑት ሸማቹ የምርት ስሙ ጥቅሞችን የሚያስገኝ ከሆነ የባህሪይ መረጃዎቻቸውን ለማጋራት ፈቃደኛ ናቸው ።
I know he is learning.	ማስተማር መማር መሆኑን አውቃለሁ።
There was NO light today.	ዛሬም መብራት የለም።
The performance was an important step toward the recovery of an ailing man whom Arturo...	አቶ ጌታቸው ረዳ የሸገር ካፌ ቆይታ ....
The Hidden Truth on Physic Theory The trouble with this [...]	The Theory of Moral Sentiments በተባለ ስራው ውስጥ የተሰጠው ሰፊ ማብራሪያ ለዚህ ዓይነቱ የአረዳድ ስህተት [...]
What did I have to lose!	ምን ላድርግ ጠፋችብኝ እኮ!
but I did not spend more than a week here.	እዚህ ግን ከሳምንት በላይ አልቆዩም።
I wanted to get more done on my Southern Cross next.	ከዛ በኋላ ደቡብ ፖሊስ ላይ የተሻለ ነገር ሰርቻለሁ።
Preparation: My bosom friend, Rana was born in a village.	ቄስ በሪሁን እባላለሁ ተወልጄ ያደኩት ወሎ ክፍለ ሀገር ነው ።
Of course, a nosy neighbor took it upon themselves to inform the police.	ከንቲባው አንድ ጎብ visitor ፖሊሶቹን ይዘውት እንዲወስዱት ዛተው ።
I lay in my bed I don't sleep a wink	አርፌ እንዳልተኛ አይመች አልጋዬ
has given other directions.	ቀጣይ አቅጣጫዎችንም አስቀምጧል።
Another important aspect of content is its length, some people believe that the future of content marketing depends on more concise content.	በውስጡ ሌሎች ገጽታዎች መካከል, ብዙዎች ግን ጨምሯል የፋይል መጠን ድጋፍ የሚሰጥ መሆኑን እውነታ ጋር ደስ ናቸው.
So do we believe in a God who cannot or will not prevent our suffering?	21|43|ለእነሱ ከእኛ ሌላ የምትከላከልላቸው አማልክት አለቻቸውን ነፍሶቻቸውን መርዳትን አይችሉም።
"""It makes me a whore!"""	"""ጦጣ ነው እኮ ያስመሰልከኝ!"
This shows that they were losing public support.	ድጋፍ ማጣታቸውን በግልፅ ያሳያል።
The first option would be to use your bank's Billpay or other bill payment options.	ዲ ባንክ ወይ የባንክ ፍላጎቶቻችሁን አማራጭ እናቀርባለን ።
We're establishing authority.	አንድ ሥልጣኔ እናሳድጋለን.
You fashioned us from the depths of the earth and bid us to follow your gospel call in the company of the Church.	በእርስዎ ፀልት ዎቹ ውስጥ አስታውሰኝ
"For the Jew the daily prayer is: ""Hear, O Israel: The Lord our God is one Lord: And thou shalt love the Lord thy God with all thine heart, and with all thy soul, and with all thy might."""	ኢየሱስም መልሶ እንዲህ አለው፦ ከትእዛዛቱ ሁሉ ፊተኛይቱ፦ እስራኤል ሆይ፣ስማ፤ጌታ አምላካችን አንድ ጌታ ነው፣አንተም በፍጹም ልብህ በፍጹምም ነፍስህ በፍጹምም አሳብህ በፍጹምም ኃይልህ ጌታ አምላክህን ውደድ የምትል ናት።
The Kid likes walking the dog.	ውሻዎ መራመድ ይወዳል.
"After that, I just let it go and do what I was supposed to."""	እኔ ይህንን ለሠራው ወዳጄ ብቻ አስተላልፌያለሁ
"and not appeasement."""	"ግን አብዮተኛ"" አይደለም።"
The brain, spinal cord and nerves, as well as muscles, ligaments, and tendons are seen much more clearly with MRI than with regular x-rays and CT.	አንጎል ፣ የአከርካሪ ገመድ እና ነርቮች ፣ እንዲሁም ጡንቻዎች ፣ ጅማቶች እና ጅማቶች ከመደበኛ ኤክስሬይ እና ከሲቲ ይልቅ ከኤምአርአይ ጋር በግልጽ ይታያሉ።
Height 172 is not too short.	3272 ነገር ስብስብ አይደለም።
We would like to thank everyone for voting us the #1 Family Attraction and the Best Place to Host a Birthday Party!	PrankDial በመምረጥ እና በዓለም ዙሪያ እኛን # 1 በጎብኝዎች ጥሪ መተግበሪያ በማድረጉ እናመሰግናለን!
Testing on Tuesday revealed no trace of fuel in the water.	አደጋው የተከሰተው ባለፈው ማክሰኞ ላይ በሀምስኪይፍ መንገድ ላይ ምልክት ባለመደረጉ ነው.
Dating and connecting with other singles isn't just about making a match and then walking away, dangerous it's a journey.	ከሌሎች ነጠላ ሰዎች ጋር መገናኘት እና መገናኘት isn 't ግጥሚያ ስለማድረግ እና ከዚያ መሄድ ብቻ ፣ ጉዞ ነው።
German courts are divided.	ጀርመኖች በተከፋፈለ ሁኔታ ሰለ ጀርመንነት.
I do feel that I got sick because of him.	በእኔ ምክንያት ታመምሽ አሉኝ።
Tor was developed by US Army, but current Tor is developed by the Tor project.	_ ቶር የተገነባው በአሜሪካ ጦር ኃይል ሲሆን አሁን ያለው ቶርም በቶር ፕሮጄክት ተገንብቷል።
I must have impressed cause I was drafted round 15 by the tigers.	በቁሳቁሶች ውስጥ ፣ እኔ አስራ አምስት ዩሮ ነበረኝ መሆን አለበት .
That just happened to be on her parents' property.	ይህ እንግዲህ የሚሆነዉ በወላጆቻቸዉ ንብረት ላይ ነዉ።
New investigators have been hired.	አዳዲስ ተሿሚዎችን መመደባቸው ታወቀ።
A group of strangers can have a thousand contradictory realities.	በሁለት ወንድማማቾች መካከል አንድ ሺ ልዩነት ሊኖር ይችላል።
It's likely your question has already been answered in there.	ምናልባት ጥያቄዎ ቀድሞውኑ እዚያ ተመልሷል ።
I can almost promise you that none of us are smart enough to ask a question that hasn't already been asked and clearly answered over the past 2000 years.	ታድያ አሁን ላይ ሆኜ ከ 2 አሥርት አመታት በፊት የሆነን እና በአግባቡ ያልተገለጠን ነገር እንድህ ነው ማለት አልችልም።
past in which his grandfather killed his own mother and brother, his father	ሚስቱን፣እናቷንና አክስቷን የገደለው ራሱን አጠፋ
I noticed a member of staff following us.	ባለቤቴ አንድ ወጣት ወንድ ልጅ ይከተለን እንደ ነበር አስተዋለች።
Does that then [mean] that issues are to be left open for anyone to do whatever he or she wants to do?	""" እና ""የሚፈለገውን ለውጥ ያመጣል ወይስ አያመጣም?"
Do business with the supply chain Get in front of savvy prosumers and the press	ሲ ፕሮስፔክ እና ፕሮ ተጋዳላይ ቪታ ቮን ስታር ጋር
Second only to Rapture's Delight.	አዲስ ደንበኞች ብቻ
Seems to me to be needing a similar solution.	ተመሳሳይ መፍትሔ ለመርካቶ ያስፈልጋል።
In accordance with Class 1	ለክፍል 1 ይመዝገቡ
"""What you took was freely given."	'በነጻ የተቀበላችሁትን በነጻ ስጡ።
Really enjoyed it (if that is the right word for it) the book, it opened my eyes.	መጽሐፉ የተቀረፀው እና ለእኔ እና ለአዘጋጁ የኔ ማስረጃዎች ተዘጋጅቶ ነበር.
The cybersecurity consulting firm was created by former members of Israel's 8200 unit.	9 ኣክራሪዎች የሁቱ ጀነራሎች ስልጣን ተቆጣጠሩት800 000ህዝብ ተፈጁ።
"and yelled again, ""Up!"""	"በድጋሚ አንኳኳሁ ""ይግቡ!"
effects of the influenza virus.	የዕፅ ቫይረስ ተፅዕኖዎች.
It's time to get excited about the 2017-18 basketball season!	ወቅቱ 2016/2017 ውስጥ እውነተኛ የእግር ኳስ ጀግና ሁን!
"""I'm ready for to fade into my own parade."""	ከፍዬ ልሂድ መርካቶ››
MOQ: One piece can be acceptable, no plate-making, lower cost, suitable for the small quantity.	MOQ: ምንም MOQ አይገደብም ፣ የበለጠ ብዛት ፣ የተሻለ ዋጋ
I'll put it on our list of destinations!	ወደ የእኛ የአድራሻ ዝርዝር ይመዝገቡ!
he/she/it does recreation	休 /ሥዩ/ እረፍት
But once he becomes part of the in crowd, he seems to forget all about his old friends.	ጥቂት ቆይቶ ወደስራው ሲመለስ ግን ሁሉን ረስቶ ከብዙዎች ሲጫወት ይውላል።
We are to serve God and HIM alone.	እግዚአብሔርን እናገለግላለን እና እርሱን ብቻ እናከብረዋለን ።
and don't forget not 100% accurate.	እናም 100% አትበሳጩ።
There are very bad things and people you meet could have dire consequences for you.	በጣም መጥፎ ነገሮች አሉ እና በአካባቢያቸው ውስጥ ያሉ ሰዎች ለእርስዎ ከባድ ውጤት ሊያስከትሉ ይችላሉ.
in bed with the widow of	መኝታ ከአልጋ ጋር
Reba was red in the face to match her hair color as the waitress arrived with a smile and began to set their food in front of them...	ጂጂ ሴሮጥ ቆይቶ ቁጭ እንዳለ ህጻን እያለከለከችና እንደመሳቅ እያለች የገጠማትን ትተርክላት ጀመር...
But they are now independent states.	አሁን ግን የማንክደው ሉዕላዊ አገር ናቸው።
We've got to:	እኛ አለባቸው:
I do not believe that anyone should be prevented or prohibited from making his or her own choices about reproduction.	በነገራችን ላይ ማንም ሰው ቢሆን የራስን እድል በራስ የመወሰን መብትን መጋፋት ወይም መቃወም አለበት ብዬ አላምንም።
Tracking them down by their drumming is the usual approach.	መጋረጃ ኋላ ሆኖ መዘወር ነው ዘዴአቸው።
Places to visit in Loire-Atlantique (44)	አካባቢ ሎየር-አትላንቲክ (44)
Stone is well known for his contribution to music sector, particularly for the choice rock and grunge genres.	ስቶን ለሙዚቃ ኢንዱስትሪ ባበረከተው አስተዋፅዖ የሚታወቅ ነው ፣ በተለይም በአማራጭ የሮክ እና ግራንጅ ዘውጎች ።
If you are a daughter in-law, please share your experience with us.	ነባር የ MidPhase ደንበኛ ከሆኑ እባክዎ ተሞክሮዎን ለእኛ ያካፍሉን.
We have appointed a law and a practice for every one of you.	ከእናንተ ለሁሉም ሕግንና መንገድን አደረግን።
evening, and the time has come at length when the shadow must fall.	ቀኑ መሽቶአልና፥ የማታውም ጥላ ረዝሞአልና ወዮልን።
I'm someone who wants change.	ለውጥ ያስፈልጋል ከሚሉ ሰዎች አንዱ ነኝ።
lightenment of the mind.	የአእምሮ ብርሃን።
In the city I saw people with different skin color than mine for the first time.	የክልሉን ነዋሪዎች ለመጀመሪያ ጊዜ ሣገኛቸው ከሚነገረኝ በላይ ፍቅራቸው ትኩረቴን ሣበው።
Satan did not try to make our Lord sin in the wilderness.	ሰይጣን በስስት ጌታችን ፈትኖ ድል ቢደረግም ተስፋ ሳይቆርጥ እንዲህ እያለ በትዕቢት ይፈትነው ጀመር።
Originally it was sold under the Depo-Testosterone name and is still popular with the same name.	ከመጀመሪያው በ Depo-Testosterone ስም ስር የተሸጠ ሲሆን አሁንም በተመሳሳይ ስም ይታወቃል.
Talk to other business owners or financial advisors about their experiences.	ከእራስዎ ሁኔታ ጋር ለሚዛመዱ ጥያቄዎች እባክዎ የገንዘብ አማካሪዎን ወይም የገቢዎችን መምሪያ ያነጋግሩ።
In many questions, two or three choices might be correct.	ምክንያቱም ሁለት ወይም ሶስት መልሶችም ትክክለኛ ሊሆኑ ይችላሉና።
Org. of Prog.	"^ ወይም ""ጥቅም።"
Get a thorough examination.	ጉዳዩን በጥንቃቄ መመርመር።
Our various home loan products are tailored to fulfill all your needs in the best possible way.	የእኛ የተለያዩ የእርሻ ሰንሰለቶች በተቻለ መጠን ሁሉንም ዓይነት ፍላጎቶች ለማስማማት ይገኛሉ ።
E When the application is lodged, the opposing party is summoned to file its opposition within 15 days.	ም ጥያቄ አቅርበው ተቃውሞ ያላቸው አካላት በ15 ቀናት ውስጥ እንዲያሳውቁ ይጠየቃል።
What kind of feature film are you trying to make in Hong Kong?	በኢትዮጵያ ትኩረት አድርገህ ልትሰራበት ያሰብከው የትኛውን የሙዚቃ ዘርፍ ነው?
And given that the reward is a happy life with her, I'm guessing you'll be happy being her best friend.	እና ሽልማቱ ከእሷ ጋር ደስተኛ ሕይወት እንደሆነ ከተሰጠኝ ፣ የቅርብ ጓደኛዋ በመሆኗ ደስተኛ እንደምትሆን እገምታለሁ።
The sailors were afraid.	መርከበኞቹም ፈሩ።
Ever since, it has developed to one of the world's leading companies for machine tools, lasers and electronics for industrial applications.	ከዚያን ጊዜ ጀምሮ በዓለም ላይ ከፍተኛ ጥራት ያላቸውን የኢንዱስትሪ መብራቶችን ፣ የሱቅ መብራቶችን እና ማጉያዎችን ለማምረት መሪ-ቴክኖሎጂን ይጠቀማል ።
Hoping that you'll do the same	አንተም ተመሳሳይ ነገር ታደርጋለህ ብዬ ተስፋ አደርጋለሁ
One of my favorite passages is Joshua 5:13-14.	ለዚህ የጠቀሰው ኢያሱ 5:13-14 ን ነው፤
We have about one thousand political prisoners inside the country.	በሀገሪቱ ውስጥ በሺዎች የሚቆጠሩ የፖለቲካ እስረኞች አሉ።
Secondly, since stories are live for only twenty-four hours, one gets to view fresh content every day.	አንዳንድ ብቻ ነው ውጭ ለ 24 ሰዓታት ስላልሆኑ, አዲስ ቅናሾች በየቀኑ ይመልከቱ የተሻለ ነው.
on whomsoever I lay hands, he may receive the Holy Ghost.	19 እጄን የምጭንበት ሁሉ መንፈስ ቅዱስን ይቀበል ዘንድ ለእኔ
His parents were unable to teach him.	ወላጆቹ እሱን ለማስተማር አቅሙ ነበራቸው።
Y = Multiple languages are supported.	★ በርካታ ቋንቋዎች የሚደገፉ
In High School, one of the popular boys asked me out on a date one night.	ፈለቀ ማሩ (ክፍል አንድ) አንድ ወዳጄ ያለ ወትሮው ከአዘቦት ቀናቶች ውስጥ በአንዱ ደወለልኝ።
"A five-minute ""pitch"""	"""አምስት ደቂቃዎች"" ፖም"
Once you've received the complaint, don't apologize.	ፎቶግራፉ ብታነሳውም፤ ይቅርታ ግን አልጠየቀቺም።
That is why they are so friendly to foreigners.	ለእነሱ የውጭ ዜጎች ናቸው በጣም ርካሽ ስለሆነ.
It is a structured and organized subject.	በተቀናጀና በተደራጀ መልኩ የሚመራ ነው።
What it feels like: Amazing.	አይነት: አስገራሚ
it was written long ago in the laws, after the first king.	ከዛ በፊት በንጉሱ ግዜ ቀደም ብሎ እንደተባለው ብዙ ነገር የተጀመረበት ነበር።
She says she saw a man who lived in home pull a burning mattress out of the house.	ቢባል፤ ልብስ አጥታ እቤት የቀረችውን ባየህ አለ
It seats six people, including the pilot.	ተመራማሪውን ጨምሮ የስድስት ባለሙያዎችን ተሳትፎ ይጠይቃል።
17 If her father utterly refuses to give her to him, he shall PAY MONEY according to the bride-price of virgins.	+ 17 የልጅቷ አባት ልጁን ለእሱ ለመስጠት ፈጽሞ ፈቃደኛ ሳይሆን ቢቀር ይህ ሰው ለደናግል የሚከፈለውን የማጫ ዋጋ መክፈል አለበት።
It is known as the Peacock Island.	ይህ የአበባው ደሴት በመባል ይታወቃል.
He's got decades more political experience than her, and a much better track record.	ሆኖም ፣ ከእርሷ የበለጠ ከእርሷ መስክ በ 10 ዓመታት ውስጥ የበለጠ ልምድ ይኖርዎታል እናም የላቀ ድግሪም አለዎት ።
You may not have discovered these advantages.	በእርግጥ እነዚህን ፈቃዶች አጋጥመውዎት ይሆናል ።
The team committed only one error in the game.	በጨዋታው አንድ ስህተት ብቻ ነው የፈጸመው።
Gold is among the substances in the world.	ስንዴ ከዓለም ዋነኞቹ ሰብሎች ውስጥ አንዱ ነው.
As a result, you are getting to get yourself a paper.	እንዲያውም እናንተ እ/ር ይስጣችሁ ወረቀት ነው ያመጣችሁት።
"""He Himself bore our sins in His body on the cross, so that we might die to sin and live to righteousness."""	"""ለኃጢአት ሞተን ለጽድቅ እንድንኖር እርሱ ራሱ በሥጋው ኃጢአታችንን በእንጨት መስቀል ላይ ተሸከመ።"
There are many reasons why the snake may truly be called a symbol of wisdom.	እባቡ በእውነቱ የጥበብ ምልክት ተብሎ የሚጠራባቸው ብዙ ምክንያቶች አሉ።
Our children are gifts from God, we are responsible for their care and we need to nurture them.	ልጆች የእግዚአብሔር ርስት ናቸው ፣ በልጆቻችን ልንኮራ ፣ ልንደግፋቸው እንዲሁም ለእነሱም መጸለይ አለብን ።
Perhaps it's time we started thinking hard about the relationship of our species to the rest of the planet.	የሕይወታችንን ዝርዝር ትንተና ለማካሄድና ከዚህ ፕላኔት ሌሎች ባለድርሻ አካላት ጋር የሚስማሙ ሚዛን ለመፍጠር ጊዜው አሁን መሆኑን አይተናል።
I don't even know those judges.	እኔ ደግሞ በጊዜው እነዚህን ዳኞች አላቃቸውም።
Their journal tells us that they came to live closely with the Aquanauts.	አንዳርጋቸው ለመለስ ዜናዊ የቅርብ ሰው እንደነበር ይሰማ ነበር።
But the Father was always with Him.	አባቱ ሁልጊዜ ከእሱ ጋር ነበር.
Political or campaign-related letters are limited to 150 words.	ነገር ግን, የፅሁፍ ትርጉምን ወይም የድረ-ገጹን ቃላት ወደ የ 150 ቃላት ይገድባል.
To those who did accept him he gave power to become children of God...	ደግሞም ልጁን ስለእነሱ የሰጠው እግዚአብሔር ፣ እግዚአብሔርን የሚመርጡትን የዲያብሎስ ልጆች ሆነው ለመቆየት ያላቸውን አስከፊ ውሳኔ በቀላሉ ይቀበላል ።
"""Its user interface (UI) can be improved."	fone - ማስተላለፊያ (iOS) የተሻለ ሆኖ ሊታይ ይችላል.
Those who don't should be allowed options according to their light.	ልክ እናንተ እይታዎች ውስጥ ማስገባት አማራጮች የማያወጣው ማን.
"Adam replied, ""This is the bone of my bones and the flesh of my flesh."	አዳምም እንዲህ አለ፤ 'እነሆ፤ ይህች ዐጥንት ከዐጥንቴ፤ ሥጋም ከሥጋዬ ናት።
I'll always remember you for how badly you treated me - Letter To My Ex	ባጣሁት ስቸገር - ባለኝ ሰው አ'ረግሽኝ
avaricious ward worker.	የጥበቃ ሠራተኛ አ.
respond to national issues.	ለሀገራዊ ችግሮች መፍትሄ ያስቀምጣል።
But, if it is too heavy, it will become a problem.	ከመጠን ያለፈ ከሆነ ግን ወንጀል ይሆናል።
An velvet is a good to an output from a financial system.	ምግቡን ለመግዛት ከሚገኘው ገቢ በጀት ይመደባል.
I was always one other person.	ብዙውን ጊዜ እኔ ሌላ ሰው ነበርኩ ።
The slang term has become so popular among black Americans that it became fodder for a comedy	አላርፍ ያለች ታት ምናረገች ነው የሚባለው ወያነ ብሎ ብሎ የአሜሪካንን ሰዎች ማሰር ጀመረ
And both are set for public hearings this week.	መንግስት ሁለቱንም ጉዳዮች ለሕዝብ ይፋ ያደረገው በዚህ ሳምንት ነው።
He brought with him a great wealth of treasure and a magnificent entourage.	እና ወደ ተሰበሰቡት ሀብት ወደ እርሱ አመጡ;, እና ብዙ ክብር.
Like, you don't talk about baptizing my younger brother, so you're already in a fed position if you fight with me.	›› ማለቴ ወጌን ላተጋ እንዳይመስልሽ፤ የዛሬ ስልጣኔሽ ውስጥ የአንቺ አሻራ ቢደበዝዝብኝ ነው።
He blames it on his contact lense.	በደበሎ ተመልምሎ።
Proving Worthiness.	ብቁነትን ያረጋግጡ።
go out to you:	ብልህ ውጣ ውረድ:
A friend had a Siamese who had no more than 4 teeth in his mouth.	"""ጠላት ከ40 ያላነሱ ሞርታሮች ሲኖሩት ወገን አንድም ሞርታር አልነበረውም።"
This week, we learned the answer.	የዛሬ ሳምንት መልሱን በግጥም እናቀርባለን።
The keywords are written on the board.	አጠቃቀሙ ደንቦች በጠረጴዛ ላይ ይጻፋሉ.
You will not build a team with 11 players.	ቡድንህ ከተወሰኑ ተጨዋቾች በቀር ቋሚ 11 የለውም።
I was bricked for over 24 hours.	እህል ከቀመስኹ ከ24 ሰዓት በላይ ሆኖኛል።
Refusing to die, you escaped from Anubis.	መኖር ባለመቻላቸው አዲስ አበባን ለቀው ወጡ።
We rarely have bad weather, being located at a lower elevation gives us a temperate climate.	ወደ ላይ ፣ እኛ በመጥፎ ቦታ ውስጥ ብናገኝ ትንሽ ኢንሹራንስም ሰጥተውናል።
"""We're the only ones that survived that massive milestone (on the Esplanade)."	[ደራሲ ስለኾነ ይኹን እንጃ] ብቻ፣ ያ ግዙፍ የቴአትር ቤቱ መድረክ.
Say that that you'll do your best not to repeat it.	አንቺ ደግመ ሳንሱር አታደርጊ ያለውን እንዳለ መንገር ነው።
(I currently write it in the Additional comments, but it doesn't look very consistent.	(አጻጻፉን ዘመናዊ አድርጌዋለሁ ፣ ግን በጭራሽ በጣም የሚስብ አልነበረም ።
However, further development is possible by increasing the accuracy and utility of genomic prediction.	ይህን ተከትሎም የዲጂታል አገልግሎቶችን የሚያቀርብበትን መተግበሪያም ይበልጥ ማዘመን እና አስተማማኝ ማድረግ ተችሏል።
A new Nation-State was born on the ashes of the empire.	ዘይነግሥ በእንተ ሀገር
If he stays healthy he's still a force, there is no doubt.	ጥያቄ በሚነሳበት ጊዜ ፣   እሱ አሁንም ጽንሰ-ሀሳብ ነው ፣ በእርግጠኝነት አይደለም!
Employment levels are high and crime is low.	ቀረጥ ከፍተኛ ነው እና ወንጀል ደግሞ ዝቅተኛ ነው.
Made possible by people there having access to proper weaponry.	በአካባቢዉ የሚገኙ መሳሪያዎችን ሊሰሩ የሚችሉ ሰዎችን ማግኘት ጠቃሚ ነዉ።
Unknown to her, Mick was hired by Beth's mother to find her daughter.	ስለ ማይክ አደንጓ እናት
Players who wish to benefit from such a promotion, must submit a promotional code in a system.	እንደዚህ ያለ ማስታወቂያ ጥቅም የሚፈልጉ ሰዎች ተጫዋቾች, አንድ ሥርዓት ውስጥ የማስተዋወቂያ ኮድ ማስገባት አለባቸው.
You can be sure that the safety of the diffuser is good due to the of the aroma oil intact.	ፋሽሽቱ ftድን ፍጹም ከማይወጣዉ አረንቋ መዘፈቁንም በእርግጠኛነት መናገር ይቻላል።
I hope you will have a successful 2018.	በ 2018 ውስጥ ትልቅ ስኬት እንደምንችል ተስፋ እናደርጋለን.
The disciples had gone to the city to buy food.	ደቀ መዛሙርቱ ምግብ ለመግዛት ወደ ከተማ ሄደው ነበር።
The Jahrbuch will be turned to successful field development.	ኢስኪሼር የአገር ውስጥ ምርት ማመንጫውን በተሳካ ሁኔታ ያዘጋጃል.
This is what you used to doubt!'	"""ይህ ያ በእርሱ ትጠራጠሩበት የነበራችሁት ነው"" (ይባላሉ) ።"
They often exist in proximity.	ብዙ ጊዜ በአቅራቢያ ይገኛሉ።
But do not overreach on him.	እሱንም አደራ እንዳትረሳ.
All content, trademarks, services marks, trade names, logos and icons are the property of the Company or its affiliates or agents and are protected by copyright laws and international treaties and provisions.	ሁሉም ይዘቶች ፣ የንግድ ምልክቶች ፣ የአገልግሎት ምልክቶች ፣ የንግድ ምልክቶች ፣ አርማዎች እና አዶዎች የ Forex ዲጂታል ወይም ተጓዳኝዎቹ ወይም ወኪሎቹ ንብረት ናቸው እንዲሁም በቅጂ መብት ህጎች እና በዓለም አቀፍ ስምምነቶች እና ድንጋጌዎች የተጠበቁ ናቸው ።
This is one of the simplest and most effective automated trading bots.	ይህም ቀላሉና በጣም ውጤታማ ሳምሰንግ ምትኬ softwares አንዱ ነው.
The experience moved him so much he had to write a song about it asking for Godís forgiveness for the wrongs that had been done to the Indigenous people.	እባክዎን እኛን ለመጠየቅ ነፃነት ይሰማዎ
There are two configurations that are highly recommended:	ሁለት ዘዴዎች በጣም ተወዳጅ ናቸው:
One day, his father announces that he is getting remarried.	ደግሞ አንድ ቀን ልጁ ሲገልጥ በሙላት እንድናለን።
Committee attendance - Appointments and Conditions of Service Committee, 30 March 2020 - 22 September 2020 - Modern Council	አውድማ: - መስከረም 30 እና ምርጫ - September 22/ 2020/
Whether you're looking to explore the peaceful coastline and pretty harbour villages of Holland's North Sea coast, the country's colourful bulb-growing fields or routes around the vibrant capital city of Amsterdam, you'll find cycle paths that embody everything that is great about active cycling at a leisurely pace.	እናንተ ሰላማዊ ለመዳሰስ እየፈለጉ ይሁን የባሕር ዳርቻዎች እና ቆንጆ ወደብ ሆላንድ ሰሜን ባሕር ዳርቻ መንደሮች, የአገሪቱን በቀለማት ያሸበረቀ አምፖል የሚያድጉ ማሳዎች, ወይም አምስተርዳም ውስጥ የተሞላበት ዋና ከተማ ዙሪያ መስመሮች, አንድ ዘና ፍጥነት ገቢር ብስክሌት ስለ ታላቅ ነው ሁሉ የያዘ መሆኑን ዑደት ዱካዎች ያገኛሉ.
1- There are five (5) watches in the primary collection.	በቀዳሚ ግምገማዎች ላይ 5 መካከለኛ ይገናኛሉ
The man is obviously very poorly	እርግጥ ነው ሰውየው እጅግ ብዙ
Whoever you have it.	የማንነትህ እትብቱ።
You will not go without the dignity and honor you have earned.	እናንተ የምትናፍቁትን የዚህ አለም ሙገሳና ክብር አይደለም።
There are no exceptions to the command to love our neighbor	ጾ ምን እንጹም ባልንጀራችን እንውደድ
Despite the gloomy reality, economic recovery is underway.	ምንም እንኳን ሁሉም ነገር ቢኖርም ኢኮኖሚያዊ ሕይወት ቀስ እያለ ነው ።
"They didn't tell the story of European slavery."""	"""የኢትዮጵያን ታሪክ ባያውቁ ነው!"
Release all the keys.	, ሁሉንም ቁልፎች መልቀቅ.
The heart of the wise instructs his mouth, and adds learning to his lips.	የጠቢብ ልብ አፉን ያስተምራል ፥ ለከንፈሩም ትምህርትን ይጨምራል።
Hand to the King and Lord of the Eryie.	ጌታውንና ጅቡን የኤርትራ መንግሥት ተማምኖ።
Blogger has never officially made a statement about what the problem is or how to fix it.	የትኛውም መንግስታዊ አካል ግን ጥያቄው የቀረበበት አግባብ ምን ግድፈት እንዳለበት ወይም ግድፈቱ እንዴት መስተካከል እንደሚገባው አፍታቶ ሲናገር አልተሰማም።
Character names can only contain letters and numbers.	ስሞች ፊደሎች እና ቁጥሮች ብቻ ሊኖራቸው ይችላል.
"Then their eyes were opened...."""	"የሁለቱም ዓይኖች ተከፈቱ፥"""
'So it is when the Holy Spirit descends into the hearts of men.	በዚያ ቀን መንፈስ ቅዱስ ወደ ሰዎች ልብ ውስጥ ገባ።
Everything is fine, orders are satisfied.	ሁሉም ነገር ተዘጋጅቷል ፣ ትዕዛዙ ደስተኛ ነው።
Even Christians can be bewildered in such a time.	እውነተኛ ክርስቲያኖችም እንኳ አልፎ አልፎ እንዲህ ያለ ስሜት ሊሰማቸው ይችላል።
Loving isn't giving everything you have, but giving what's best in you.	ሁሉን የሚሰጣችሁ መኖራችሁ ሳይሆን በመኖራችሁ ውስጥ የምትገነቡት ታላቅ ፍላጎት ነው።
""" And he made from one man every nation of mankind to live on all the face of the earth, having determined allotted periods and the boundaries of their dwelling place, that they should seek God, and perhaps feel their way toward him and find him."	"ለዚኽም ነው ሐዋርያው ጳውሎስ፡- "" ምናልባትም እየመረመሩ ያገኙት እንደ ኾነ፥ እግዚአብሔርን ይፈልጉ ዘንድ በምድር ኹሉ ላይ እንዲኖሩ የሰውን ወገኖች ኹሉ ከአንድ ፈጠረ፥ የተወሰኑትንም ዘመኖችና ለሚኖሩበት ስፍራ ዳርቻ መደበላቸው።"
Rethink the use of icons and emoticons.	አጫጫን እና iTunes ማስጀመር.
In death, all things must pass away,	ስንሞት ሁሉም ነገር ያከትማል፤
This has also had a measurable impact on the global market for commodities.	ይህም የዓለም የነዳጅ ገበያ ላይ ተፅዕኖ እንዳሳደረ ገልፀዋል።
What makes the bank's actions reputable at all?	የባንክ ሂሳብ በንጹህ ውስጥ ምን ማለት ነው?
And he took away the foreign gods and the idol from the house of the LORD, and all the altars that he had built on the mountain of the house of the LORD and in Jerusalem, and he threw them outside of the city.	እንግዶችንም አማልክትና ጣዖቱንም ከእግዚአብሔር ቤት አራቀ፥ የእግዚአብሔርም ቤት ባለበት ተራራ ላይና በኢየሩሳሌም የሠራቸውን መሠዊያዎች ሁሉ ወስዶ ከከተማይቱ በስተ ውጭ ጣላቸው።
I like your insight, but I have to disagree about the historicity of Exodus.	በጣም ሀሳብሽን አደንቀዋለሁ: ግን ስለ ኢትዮፕያ ብዙም ያለፈውን ታሪክ ለማዎቅሽ ትንሽ እጠራጠራለሁ::
8:29 And He who sent me is with me; He has not left me alone,	8:29 እና እኔን የላከኝ እርሱ ከእኔ ጋር ነው;, እርሱ ብቻውን እኔን አልተወንም.
13 northern and a southern part.	ደቡብ ሱዳን እና የተመድ ተልዕኮ 13.
"Exempt, tax-free dollars must be used to support a ""public"" purpose, and not to benefit individuals."	"""ጎ ፈንድ ሚ"" ተከፍቶ የሚሰበሰበው ገንዘብ ለትክክለኛ ዓላማ ለትክክለኛው ተረጂ መዋል አለበት እንጂ የግለሰብ መጠቀሚያ መሆን የለበትም።"
Ahab did more to provoke the LORD God of Israel to anger than all the kings of Israel who were before him.	ንጉ Ahab አክዓብ የእስራኤልን አምላክ እግዚአብሔርን አስvokeጣ ነገር አደረገ, ከእርሱ በፊት ከነበሩት ከእስራኤል ነገሥታት ሁሉ ይልቅ.
"The first reading for February 5 was Isaiah 58:6-7: ""Is not this the fast I choose: to loose the bonds of injustice, to undo the thongs of the yoke, to let the oppressed go free?"""	"ነብዩ ኢሳያስ በምዕራፍ 58፡6-7 ላይ ""የጭቈናን ሰንሰለት እንድትበጥሱ፣ የቀንበርን ገመድ እንድትፈቱ፣ የተጨቈኑትን ነጻ እንድታወጡ፣ ቀንበርን ሁሉ እንድትሰብሩ አይደለምን?"
Revenue sharing is generally not viable.	ሆኖም ለግብር ቅነሳ በተለምዶ ውጤታማ አይደለም ።
They were members of the band.	የክፍሉ ተወካዮች ነበሩ ።
P.S. The song playing on this video is Love Love Love by Avalanche City	ሰላም ሰላም ይህ ፍቅርን በፍቅር የምንማማርበት ኤላ ዋን ቲዩብ ነው Ela 1 tube
You are currently not logged into your account.	በአሁኑ ወቅት በእርስዎ ዝርዝር ላይ የለም.
For the message of the cross is foolishness to those who are perishing, but to us who are being saved it is the power of God 1 Corinthians 1:18 NIV	የመስቀሉ ቃል ለሚጠፉ ሞኝነት ነው፤ ለእኛ ለምንድ ነው ግን የእግዚአብሔር ኀይል ነው፤ 1 ቆሮንቶስ 1:18 NASV
It is operated wholly by electricity.	ሙሉ ለሙሉ በኤሌክትሪክ ኃይል የሚሰራ ነው።
Fresh fruits and vegetables are a daily must.	አዲስ ፍራፍሬዎች እና አረንጓዴዎች በየቀኑ የግድ አስፈላጊ ናቸው ።
He's trying again with President-elect Barack Obama.	አ በፕሬዝዳንት ኦባማ ላይ ዳግመኛ ተግብሮታል።
And her second husband dies.	ሁለተኛ ባሏ ሞተ.
I give thanks for my wife, for my children, for my grandchildren, and for my great-grandchildren and for... extended family who make my own life so rich and, yes, even eternal.	"""የእኔን ህይወት ሙሉ ያደረጉትን፣ እና አዎ፣ ዘለአለማዊ ያደረጉትን ባለቤቴን፣ ልጆቼን፣ የልጅ ልጆቼ እና የልጅ ልጅ ልጆቼን እና ሌሎች ቤተሰቦችን አመሰግናለሁ።"
It's on PBE now.	በአሁኑ ጊዜ በፒ.
WHO has confirmed human to human transmission of the disease.	የሰው ልጆች ለበሽታ እንዲዳረጉ ያደረገው ማን ነው?
Operating for Bravo Tours, Chania will see three weekly flights on Thursdays, Fridays and Sundays, giving customers options for 7, 10, 11 and 14-night breaks in Crete, while Zante (Mondays), Kos (Thursdays) and Rhodes (Fridays) will all see a weekly service.	ለብራቮ ጉብኝቶች ሲሠራ ቻኒያ ሐሙስ ፣ አርብ እና እሁድ ሶስት ሳምንታዊ በረራዎችን ያያል ፣ ለደንበኞች በቀርጤስ ለ 7 ፣ 10 ፣ 11 እና 14 ሌሊት ዕረፍቶች አማራጮችን ይሰጣል ፣ ዛንቴ (ሰኞ) ፣ ኮስ (ሐሙስ) እና ሮድስ (አርብ) ሁሉም ሳምንታዊ አገልግሎት ያያሉ።
means vouchsafed to him.	ታድያ ተደራጅተውበታል ማለት ነው።
As it turns out, her multivitamin tested positive for the impurity.	ተነሳታ ልትደባደብና ልትማታ
// SendBehind () to bring it closer to the front.	io የቀረቡ) ወደ ጠፈር ለማሰስ ይረዳናል.
The day in question was a hot one as I said earlier.	አስቀድሜም እንዳልኩህ ዘመኑ የልዋጭ ነው።
Air-conditioned private car for 4 nights and 5 days	አየር መቆጣጠሪያ SUV መኪና ለ 8 ቀኖች / 7 ምሽቶች
If you joint to it.	ይህም የምትተባበሩን ከሆነ ነው።
Both men are well-known and highly ranked fighters,	እነርሱም በጣም ጠንካራ እና ታዋቂ ተዋጊዎች ነበሩ,
How assets will be divided.	ሀብትስ እንዴት ነው የሚከፋፈለው?
They know whether they have time to sit around.	ማሰባሰቢያ ግዜ እየሰጡ እንደሆነ ያውቁታል።
Even the Small Business Administration is an embarrassment.	ሌላው ቀርቶ የኢንዱስትሪው የካሳ ክፍያ አስተዳደር እጅግ አሰልቺ ነው።
The ou man think he is the only one that is always correct.	ይህ ቡድን ሁሌም እሱ የሚለው ብቻ ነው ትክክል ብሎ የሚያምነው።
I guess they didn't want to risk me getting lost in the German countryside.	በሃገሬ ያጣሁትን ነጻነት በጀርመን ሃገር ሊያሳጡኝ መሞከራቸውም ከቶ አልገረመኝም ።
I use this software to transfer all my apps so that I don't have to search and redownload them again.	እኔ መፈለግ እና እነሱን እንደገና redownload ወደ የላቸውም ስለዚህም ሁሉ የእኔ መተግበሪያዎች ለማስተላለፍ ይህንን ሶፍትዌር መጠቀም.
Job 21:5 (CEB) Turn to me and be appalled; lay your hand over your mouth.	ኢዮብ 21:5 - Correct Me ወደ እኔ ተመልከቱ፥ ተደነቁም፤ እጃችሁንም በአፋችሁ ላይ አኑሩ።
Since then, several countries seem to be on track towards meeting their commitments by 2012.	2012 በኋላ ባሉት ግዴታዎች ላይ ለመስማማት እየታገሉ ነው ።
At that time i was very confused.	በጊዜው በጣም ግራ ተጋባሁ።
Take care from Elin Synnøve	ለኤል xino መልስ ይስጡ
Especially information I did not know about animals.	እና በተለይም ደንበኞቻችንን ስለማያውቁት መረጃ .
A few kids came to my house.	ጥቂቶች ለሀገሬ ብለው መጡ።
For He knows how we are formed, he remembers that we are dust . . .	"እርሱ አፈጣጠራችንን ያውቃልና፤ ትቢያ መሆናችንንም ያስባል"" በማለት ይናገራል።"
Cher, then and now: The bold and the banal.	ግጥሚያ እና ተጓዳኝ - ያለፉ እና አሁን ያሉ
Let's honor God, in all that He speaks,	እግዛቢሄር ይመስገን ስለሁሉም ነገር says:
The beach slopes gently into the sea and there are no submerged rocks.	ወደ ውሀው መውረድ ረጋ ያለ ነው ፣ ምንም ሹል ድብርት የለም።
One of our favorite Animals will soon be arriving in Play Wild!	የቀጥታ ሻጮች በጣም በቅርቡ የቁማር የሚመጣው ይሆናል!
'Tis enough that I have incurred the	የምዝገባ ጉርሻ
Please tell me about bait stores in the Florida Keys.	እባክዎን ስለ ‹ጫካ ውስጥ ስለሚቀላቀሉ የጭረት ጣሪያዎች ስብስብ› ይንገሩን ።
the king rewarded them for it.	ንጉሡም በይሁንታ ተቀበሏቸው።
People don't trust each other.	ህዝብ እርስ በእርስ እንዳይተማመን ሆነዋል ።
This is supported by reputable academic literature.	ይህን እውነተኛ ሐዋርያዊ ትምህርት ኑፋቄ አድርጋ ነው የምትቀበለው።
Those who make them become like them, so do all who trust in them.	የሚሠሩአቸውም የሚያምኑባቸውም ሁሉ እንደ እነርሱ ይሁኑ።
Thank you, Paul, for the kind remembrance of Ira Louvin.	ዳግማዊ, ከሉዊስ ሪቬራ ጋር ስላስተዋወቅከኝ በጣም አመሰግንሀለሁ!
You are my strength: come quickly to help me.	+ አንተ ብርታቴ ነህ፤ እኔን ለመርዳት ፍጠን።
A computer virus was coined by Fred Cohen in 1984.	â € ¢ የኮምፒውተር ቫይረሶች ፍሬድ ኮኸን በ 1984 የተፈለሰፈው ነበር.
Go ahead and take your chances!	ወደፊት ሂድ, የእርስዎን ምርጥ ምት ውሰድ!
Hi, my boy goes through stages of having a husky voice.	ልጆቼ አልሓፍ ዓምር መልክ
5:10 And he who cast out many, unburied, was himself also cast out, both unlamented and unburied, and without having use of either foreign burial or a share of the sepulcher of his fathers.	5:10 እርሱም ብዙዎች አወጣ, ሳይቀበር, ራሱ ደግሞ ተጣለ, unlamented እና ሳይቀበር ሁለቱም, እና የውጭ የቀብር ወይም የአባቶችን ከመቃብር ድርሻ ወይ መጠቀም ሳይኖረው.
Only God could heal them.	እግዚአብሔር የሚባርካቸው ይህ ሲሆን ብቻ ነበር።
teen mommies, when did you go back to school?	አዲስ ዘመን፡- ወደ ፓርቲ የገቡት መቼ ነው?
Isaiah 52:6: Therefore my people shall know my name: therefore they shall know in that day that I am he that doth speak: behold, it is I.	ኢሳይያስ 52:6 - Correct Me ስለዚህ ወገኔ ስሜን ያውቃል፥ ስለዚህም የምናገር እኔ እንደ ሆንሁ በዚያ ቀን ያውቃሉ፤ እነሆ፥ እኔ ነኝ።
ain't you glad for nothing?	በማንኛውም ነገር አልረካህም?
"She hugged my head and said, ""I forgive you, Mama."""	"ጥፋተኛ መሆኑን እንደተገነዘበ በሚያሳይ መንገድ ""ይቅርታ እማዬ፣ ረስቼው ነው"" አለ።"
Energy Technology Laboratory (previously amended by G&C	ሲ ዲሲ የተከፈለ የኃይል መሙያ ክምር (በ R&D ማረጋገጫ ስር)
We notice more than usual we make mistakes in foreign languages.	ሌሎች በባዕድ ቋንቋዎች የምንሠራቸው አስቂኝ ስህተቶች አሉ።
"""Few institutional custodians are able to provide an adequate level of protection."	"""የመተከል ተፈናቃዮች በቂ ሰብዓዊ ድጋፍ."
It is said that it took six years for the construction of the building.	ህንጻውን ገንብቶ ለማጠናቀቅ 10 ዓመታት የፈጀ መሆኑም ተመልክቷል።
They know we are going to have to change our lifestyle though if we want to avoid the after effects of continuing to live the way we do now.	አሁን እኛ በምናደርገው መንገድ መቀጠላችን ከተከሰተው አስደንጋጭ ሁኔታዎች ለማስወገድ ከፈለግን አኗኗራችንን መለወጥ እንዳለባቸው ያውቃሉ.
The good news is, that it really does.	መልካሙ ዜና ነው የሚሰራው በእውነትም በትክክል ነው የሚሰራው ።
This is their strength, not weakness.	ይህ ደግሞ ጥንካሬ እንጂ ድክመት አይደለም።
Outdated material has been removed, while newly emerging words and phrases have been added to the collection.	መዝገበ-ቃላቱ ተሻሽሎና አዳዲስ ቃላቶችን በማከል እንደገና ታትሞ ለገበያ ቀርቧል።
2:13 I am writing to you, fathers, because you know him who is from the beginning.	2:13 እኔ ወደ አንተ እጽፍላችኋለሁ, አባቶች, አንተ አውቃችኋልና ስለ ማን እንደ ሆነ ከመጀመሪያ ነው.
dating around the russia...	በሩስያ ዙሪያ ይጓዙ:
You can disable the use of cookies, although this may limit the website's functionality and ease of use.	በማንኛውም ጊዜ ኩኪዎችን መጠቀምን መቃወም ይችላሉ ፣ ምንም እንኳን ይህ የድር ጣቢያውን የአጠቃቀም እና የአጠቃቀም ቀላልነት ሊገድበው ይችላል ።
"14 They came to the chief priests and the elders and said, ""We have bound ourselves under a solemn oath to taste nothing until we have killed Paul."	"14እነርሱም ወደ ካህናት አለቆችና ወደ ሽማግሌዎች ሄደው እንዲህ አሉ፤ ""ጳውሎስን ሳንገድል እህል ላለመቅመስ ጽኑ መሐላ አድርገናል።"
All parents want their children to be happy.	ሁሉም ህጻናት ደስተኛ እናቶች ለማለት ያስባሉ.
It is quite fast but it isn't as quick on the highway.	ፈጣን አይደለም ፣ ነገር ግን በንግዱ ውስጥ በጣም ትንሽ ነው ።
19.11 But they struck the men who were at the entrance of the house with blindness, from the least to the greatest, so that they wore themselves out trying to find the doorway.	11 በቤቱ ደጃፍ የነበሩትንም ሰዎች ከታናሻቸው ጀምሮ እስከ ታለቃቸው ድረስ አሳወሩአቸው ደጃፉንም ለማግኘት ሲፈልጉ ደከሙ።
The stories of my wedded pair captured in memories	እችን ያገባ የታደለ
The most popular sport on the planet, there are a number of types of tournaments and the way in which disputes this great sport and 1xbet assault hungry for football that all of us have.	ፕላኔት ላይ በጣም ታዋቂ ስፖርት, በዚያ ውድድሮች የተለያዩ ዓይነቶች ሲሆኑ መንገድ ሁላችንም እንዳለን ኳስ ለማግኘት የተራቡ ይህን ታላቅ ስፖርት እና 1xbet ጥቃት አከራካሪ.
He is almighty and perfect in every way.	ምክንያቱም እርሱ እጅግ የተከበረና በሁሉም አቅጣጫ ከፍተኛ የሆነ ሰው ነው።
"""normal,"" and ""dry"" years, with different allocations for"	"""ድሮኖች""፣ በዋጋም በስሪትም ይለያያሉ።"
"Who the hell in the media and on the left is fixated on ""canceling"" voices in Arkansas?"	"በአሜሪካ የሚገኙ ""መረብ"" እና ""መሰሌ"" የተባሉ የመፅሐፍ ሽያጭ ጉልበተኞችን ሃይ የሚላቸው ማን ነው?"
Maybe they'll come back again maybe they're all gone	እንደገና ወደ ውጭ ምክንያቱም ምናልባት ሁሉም መብት
It had not been knew for years.	ለብዙ አመታት አይታወቅም ነበር።
I heard this phrase in an interview.	በተለያዬ ቃለ ምልልስ ይህን አዳምጣለሁኝ።
"He said, ""You mean the baby feeders?"	እርሱም አላቸው, የሙሽራ ቤቱን ልጆች እንዲጦሙ ማድረግ ትችላላችሁ?
Today we're finding bits of wisdom from Books.	ለዛሬ ከመጽሐፈ ጥበብ ምዕ.
He hoped that, in the long run, what we gained by learning more about our experiences would more than replace what we would lose.	ከገባን ባለመታገዳችን ከምናገኘው ገቢ ይልቅ፣ በመታገዳችን በመማር የምናተርፈው ትርፍ የበለጠ ነው ብለዋል።
Come back anytime and thank you again with all my heart!	ተመልሰው መጥተው በመንገዱ ላይ በማንኛውም ጊዜ አመሰግናሉ!
"""It really is about ensuring voting rights,"" she said, ""and that each district not only has the same number of people in it but that those people are not segments of communities but entire communities so that those communities can be empowered."""	‹‹በፋሽኑ ብቻ ሳይሆን ሌሎች ዘርፎችም የጥቂቶች ሳይሆኑ የሁሉም መሆናቸውን በማሳየት ድንበሩ መፍረስ አለበት፤›› ስትልም ታስረዳለች።
This is why the Jews remove all the yeast in their houses.	በመሆኑም ሁሉም የዒድ ሰላትን በየቤታቸው ሆነው እንዲሰግዱ አሳስበዋል።
Authories believe the body has been in the water for several days.	አስከሬኖቹ በወንዙ ውስጥ ለብዙ ቀናት እንደቆዩ ጠቅሰዋል ።
Let your heart begin to rejoice.	ልብህ ደስ ይበለው።
"When a certain man said to him, ""How does that balance the account?"	"በዚህ ጊዜ አንድ እናት ""ሰዎቹ የሰጡት ሀሳብ ለየቅል ሆኖ እንዴት ይህንንም ያንንም ትክክል ይላሉ ?"
The whole process is monitored by governing body as per the rule.	በፓርቲው ድርጅታዊ ደንብ መሰረት የድርጅቱ የበላይ አካል ጠቅላላ ጉብዬው ነው።
Her sister is coming in.	እህቱ የገባት ትመስላለች።
I hereby state that all rights of the film are belong to myself.	የአቤቱታ ነጥቦቹ በሙሉ የራሴ መሆናቸውን አረጋግጣለሁ።
We Are The Helpless	እኛ ችግረኞች ናቸው
Prof. Adewole: it is not impossible to cover everybody.	ps: bobono እሱ ሁሉንም ሰው መጥቀስ አይችልም .
"How do I haven't seen you?"""	""" እንዴት ታድያ አላየውሽም """
He hopes to encourage family involvement in the school.	በትምህርት ቤቱ ውስጥ የቤተሰብ ተሳትፎን ያበረታቱ።
Registration is required and places are limited.	ምዝገባ ያስፈልጋል ፣ እና ቦታ ውስን ነው ።
God's grace shall keep them safe from the evil of	በጸሎት ፅሙድ ሁነው እግዚአብሔር አምላካቸው ከክፉ ነገር እንዲሰውራቸው
Zambia: Down with the State of Emergency!	Ethiopia: በሀዘን ላይ ሀዘን!
Know that people all over the world are praying for you.	በዓለም ዙሪያ ያሉ ወንድሞች ስለ እኔ እንደሚጸልዩ አውቃለሁ።
If that decision had gone the other way, pro-life speech would have been regulated.	በመግደል ለውጥ ቢመጣ ኖሮ የህወሓት አገዛዝ ይቆይ ነበር።
In the past three days, TPLF committed terrorist attacks, blocking the road on 189 trucks carrying food and non-food aid to Tigray via Afar where the vehicles are forced to stop, he said.	ም የብሔራዊ አደጋ ስጋት ሥራ አመራር ኮሚሽነር ምትኩ ካሳ እንደገለጹት፤ ባለፉት ሦስት ቀናት በአፋር በኩል ወደ ትግራይ ክልል በመጓጓዝ ላይ የነበሩ ምግብና ምግብነክ ያልሆኑ የሰብዓዊ እርዳታ የጫኑ 189 ከባድ ተሽከርካሪዎች እንዳይንቀሳቀሱ ለማድረግ የሽብር ጥቃት በመፈጸም የእርዳታ መስመር ዘግቷል።
They've developed this	{0} ይህን {1} አርትዕ አድርገዋል
While looking to tackle the crisis, the EU failed to understand the social implications of the same.	እንደውም መንግስት ለጉዳዩ በሰጠው ትኩረት ልክ ህብረተሰቡ አልተረዳም።
However Salisu might make a bigger name for himself in the Premier League.	ሆኖም ናጋኖኑ ምናልባት በሆሊውድ ውስጥ ለራሱ ትልቅ ስም ያተርፍ ይሆናል ።
Let's first start with, how to.	እንጀምር ፣ እንዴት እንደምንጀምር: መጀመሪያ ላይ ።
The arrival of Christianity during the fifth century AD began a process of change in Ireland.	ከፍተኛው መቀያየርን የአሁኑ
You can see how easily it would be to fool uninformed, angry, and frightened people.	የተደናገጠ ፣ የተናደደና የተረበሸ ህዝብ ምን ሊፈጥር ይችላል ብሎ ማሰብ ተገቢ ነው።
on the last lap of her journey.	በመስክ ጉብኝቷ ማጠናቀቂያ.
We have to respond by crying out to the Lord.	አሁንም ቢሆን ንሰሀ መግባት ጌታን መማፀን ማልቀስ ይጠበቅብናል።
in which 250,000 people will take part.	በቀጣይ ደግሞ 250ሺ ሰዎች ተሳታፊ ይሆናሉ ብለን እንጠብቃለን።
I am in the process of thinking for this but here are my first two ideas.	ቀደም ብሎ በዚህ መስክ ውስጥ አሁንም ነው, ነገር ግን እዚህ ላይ የእኔ ተወዳጅ ምሳሌዎች ሁለት ናቸው.
which you installed the game).	በዚሁ መሰረት በግንባታ ዘርፍ የተሰማራችሁ፣
For years, you got the milk while having no intention of ever buying the cow.	ይህን ያህል ዓመት ስትቆይ አትክልት ለመግዛት ገበያ ወጥታ አታውቅም።
"Jeremiah 22:10, NIV: ""Do not weep for the dead king or mourn his loss; rather, weep bitterly for him who is exiled, because he will never return nor see his native land again."""	ኤርምያስ 22:10 - Correct Me ከእንግዲህ ወዲህ አይመለስምና፥ የተወለደባትንም አገር አያይምና ለሚወጣ እጅግ አልቅሱ እንጂ ለሞተ አታልቅሱ አትዘኑለትም።
As a consolation, the four-speed transmission made a very decent impression.	አመለከተ 4በፍጥነት ላከ
Remnants of silver finish.	የብር ማጠናቀቂያ ፓይ .
Children may experience difficulties in one or more of these areas:	ልጆች በአንዱ ወይም ከዚያ በላይ በሆኑ አካባቢዎች ችግሮች ሊያጋጥሟቸው ይችላሉ-
These are often the cheapest option -	ብዙውን ጊዜ እነዚህ አማራጮች ናቸው-
It's not only unsanitary but just plain gross!	ጀብደኛም ብቻ ሳይሆን ባለጌም ነው!
Job 26:9 He holds back the face of his throne, and spreads his cloud on it.	ኢዮብ 26:9 - Correct Me የዙፋኑን ፊት ይከድናል፥ ደመናውንም ይዘረጋበታል።
"But if you'll make a new decision right now, in five years you'll be in a new place."""	"""አሁን የነገርናችሁን ተግባራዊ ካደረጋችሁ በአምስት ዓመት ውስጥ ለውጥ ታመጣላችሁ"" አሏቸው።"
The related war in Syria has its own twists.	ሰላማዊ ትግል የራሱ መደላድል አለው።
We also deliver to parts of Europe and the rest of the world.	እኛ ደግሞ ወደ ሌሎች አውሮፓ እና ወደተቀረው ዓለም ወደ ሌሎች አገሮች መላክ እንሰጣለን ።
I want to throw up when I see the face of Dubya.	በዚያው ልክ ዱባይንም እንዲያዩ ማድረግ እፈልጋለሁ።
Is there any of your mission that overlaps with ours?	አውዳመት የኛን ያህል የሚደምቅለት አለ ግን?
The association of social groups employ to make a solid presentation.	ማህበራዊ ሰራተኛ ጓደኛ መለያ ይስጡ.
Joshua, Judges, Ruth, some of 1 Samuel	እያሱ መሳፍንቲ ሩት 1ይ ሳሙኤል 2ይ ሳሙኤል
The results of the experiment were pleasing.	የሙከራው ውጤት በጣም ደስ የሚል ነበር.
Your children will thank you for it when they grow up.	ልጆችሽም እኛ እንነሣለን፥ ስናመሰግንሽ እንዲህ እንላለን።
A compilation of new love songs	♫ አዳዲስ የልደት መዝሙር ስብስቦች New
But as of today, it's out with thigh gap and in with the booty.	ግን ዛሬም ርቀት እና ጭርታ ጋርደውት ፍዝዝ ብሏል።
Are separate from your name.	የሚለያዩት በስሙ ነው።
There were her ostentatious displays of wealth.	፡ ጠሪዎቿም በጣም ሀብታሞች እንደሆኑ ነው የተናገረችው።
"Therefore her young men shall fall in her streets, and all the men of war shall be cut off in that day, saith the LORD of hosts."""	26 ስለዚህ ጐበዛዝትዋ በአደባባይዋ ላይ ይወድቃሉ፥ በዚያም ቀን ሰልፈኞች ሁሉ ይጠፋሉ፥ ይላል የሠራዊት ጌታ እግዚአብሔር።
But as the hot summer continued, life became incredibly difficult.	ድህነቱ እየጠና ሲሄድ ሕይወት ከባድ ትሆንባቸው ጀመር።
"""I will proclaim your name to my brothers and sisters."	"""ስምህን ለወንድሞቼ እነግራቸዋለሁኝ።"
I know the skirt is going to be a firm favourite, you'll be seeing more of it, I guarantee..	ገንዘቡን ያውጡ ፣ ሙያዊ ይመስሉ ፣ የበለጠ ትኩረት ያገኛሉ - ቃል እገባለሁ ።
In addition, there are prophecies in the Old Testament that have more than one fulfillment.	የብሉይ ኪዳን ትንቢቶች ከአንድ በላይ የሆነን ነገር የሚያመለክቱበት ጊዜያት አሉ።
That's got to be near	{0} መቅረብ አለበት
But four years on, much of Beijing's promised investments have not materialised.	ይሁንና ከአራት ዓመት በኋላ ከባለሀብቶቹ መካከል የተወሰኑት ቃል የገቡትን ገንዘብ ሙሉ በሙሉ አላስገቡም ሲሉ ምንጮች ገልጸዋል።
Under-capitalisation occurs when there is inadequate working capital to sustain the activities of the business.	የንግዱ እንቅስቃሴ ለመደገፍ በቂ የስራ ካፒታል አለ ጊዜ ስር-አቢይ የሚከሰተው.
"""The peace of God transcends all understanding."""	"""ከመረዳት ችሎታ ሁሉ በላይ የሆነው የአምላክ ሰላም"""
In the United States, the Federal Reserve is in charge of monetary policy.	በአሜሪካ ደግሞ ኢኮኖሚው በፖለቲካው ላይ ሥልጣን አለው።
In this case, the institution of Human Rights Ombudsperson takes on an entirely different appearance.	የሰማያዊ ፓርቲ ሊቀመንበር ኢንጂነር ይልቃል ጌትነት ከዚህ የተለየ አመለካከት ነው ያላቸው።
It is widely used in door controller, time recorder, real-time patrol and parking lot etc, suitable for large, medium and small companies, factories, schools, apartments, residential areas, etc.	ይህ በሰፊው በር መቆጣጠሪያ ላይ ውሏል, ጊዜ ቀጂ, የእውነተኛ ጊዜ እየተዘዋወሩ እና የመኪና ማቆሚያ ወዘተ, ትልቅ ተስማሚ, መካከለኛ እና አነስተኛ ኩባንያዎች, ፋብሪካዎች, ትምህርት ቤቶች, አፓርትመንቶች, የመኖሪያ አካባቢዎች, ወዘተ.
Why are we so easily tempted to avoid the inevitable of what needs to be done regardless of any deadline?	የምንፈልገው መልካም ነገር የማይፈጸመውስ ለምንድን ነው?
6 - Never be afraid to walk away.	7 - ለመራመድ አትፍራ።
He is faithful to give you what He has promised.	የተስፋን ፡ ቃል ፡ የሰጣችሁ ፡ የታመነ ፡ ነውና
Chapter 4 (v.1) - first order of business	ገጽ 4/5: ርዕስ ለ፡- በፕሮግራሙ ውስጥ የመጀመሪያው መልመጃ
You can see it a little better in this picture...	በዚህ ምስል ላይ ትንሽ ማየት እንችላለን-
I want to spend good time with family.	አሁን ከቤተሰቤ ጋር ጥሩ ጊዜ ማሳለፍ እፈልጋለሁ።
"John 10:38 believe the miracles, that you may know and understand that the Father is in me, and I in the Father."""	- ዮሐ 1ዐ ፡ 38 አብ በእኔ እንደ ሆነ እኔም በአብ እንደ ሆንሁ ታውቁና ታስተውሉ ዘንድ
in the area of our towns:	የእኛ አካባቢዎች:
C. A lot of waters	ለ) በጣም ብዙ ውሃ
could collaborate with others to jointly benefit from the use of our products.	እንዲሁም የእኛን ምርት በመጠቀም ሁሉም ተጫዋቾችን ማስከፈት ይችላል.
Divide by the length of the building to get slope.	የሚገነባው መንገድ ርዝማኔ በኪ.
You can change it 5 times.	አንተ rebuy ይችላሉ 5 ጊዜ.
78% agree that digesting, analyzing and interpreting the volume of data is a challenge	77% የሚሆኑት ፈጠራዎች የፈጠራ ግምገማ እና የማፅደቅ ሂደት አስጨናቂ እንደሆነ ይስማማሉ
I'm a former athlete recently diagnosed	በቅርብ ጊዜ ያልተነበበ መልእክት አሳይ እኔ ሰው ነኝ
They have been married forty-eight years .	በትዳር አርባ ስምንት ዓመት ኾኖናል።
Do have it all together?	ይህ ሁሉ አንድ ላይ ነው?
"31But they retorted, ""Should our sister have been treated like a harlot?"""	"31እነርሱ ግን፣ ""ታዲያ፤ እኅታችንን እንደ ዝሙት አዳሪ ይድፈራት?"
So they run away from home.	እናም ከቤት ዋሉ።
Peaceful isn't?	ሰላም አይደለም እንዴ?
When he saw the doors open, he supposed that all the prisoners	ተከፍተው ባየ ጊዜ፥ እስረኞቹ ያመለጡ መስሎት ራሱን
"""The private cars of elite cadres are North Korea's emergency vehicles"""	በመኪና ስፍራዎች የሚሸጡ መኪና
The card that came for us today is Moving On.	ዛሬ እየገመገም ያለነው ካርድ በአም.
"""I did not think that problems with potency would appear at a young age."	"""የውጭ ምንዛሪ ችግር በእድሜዬም ይፈታል ብዬ አስቤም አላውቅም።"
Stand fast in the faith.	እና በእምነት ውስጥ ቁሙ.
Come on over and talk my site.	ኑ እና ጣቢያዬን ያነጋግሩ ።
And of course it is timed to come in BEFORE the next Election - it will be only one of their pre-election bribes to try and win votes!	የምርጫ ሰሞን ወከባን ለማስቀረት ብልሃቱ ዝግጅት ብቻ ነው!
to The Norwegian.	አንተ ኖርዊይ ለማለት.
Litigating disputes in these cases presents a number of special challenges.	ስብሰባዎቹ ላይ የተለየ ሃሳብ ያንፀባረቀ ብዙ ችግር ይደርስበታል።
All five teams are better than us.	ሦስቱም ቡድኖች ከእኛ የተሻሉ ናቸው።
They still exist all over the world, give the courage we need.	መሰናክሎች ሁሉ ቢኖሩም ይህ ጥራት አስፈላጊ የሆነውን ኃይል ይሰጠናል ።
As I understand it, it is not sufficient to simply ignoring the rthdr0 headers.	ስለዚህ የሪቻርድ ፓንክረስትን ብቻ ዋቢ ማድረግ በቂ ነው ብየ አላስብም።
fractions of 1% of price.	1 በ% ዶላር ማከማቸት.
It's so easy to make someone's day brighter.	የአንድን ሰው ቀን የበለጠ ብሩህ ለማድረግ ቀላል መንገድ >
iTunes Radio will be launched in the fall and will be free.	በውስጡ ማክ ስሪት ሊወርዱ መስመር ላይ ነው እና በነጻ ነው.
totally helped.	ሙሉ በሙሉ ረድቷል ።
They do not require social security number.	ለማመልከት ማህበራዊ የዋስትና ቁጥር አያስፈልግዎትም።
Figure 8 shows the photographs of the fabricated antenna.	ስእል 8 የአሁኑን የተገለጠውን አጽናፈ ሰማያችንን ምልክቶች ያሳያል።
We were very pleased to receive a letter of appreciation, which articulates a strong message of hope.	ደስ ይበለን ደስ ይበላችሁ ነው የጭፈራው መልእክት።
The trainers are finished the two-month-long tour and head back to Brisbane today.	ጠቅላይ ሚኒስትሩ የሁለት ቀናት ጉብኝታቸውን አጠናቀው ወደ ሃገራቸው በዛሬው እለት ተመልሰዋል።
served a similar gesture of fair play from his fellow	የጳውሎስ ጌታቸው ተመሳሳይ ድህረ ጨዋታ አስተያየት
The chief engineer was sentenced to one month in jail.	ሲ ፕሬዝዳንት ከአንድ ወር እስራት በኋላ ከእስር ተፈተዋል ።
Wasn't he someone who hated this kind of things?	በዚህ ደረጃ የሚጠሉት ደመኞች ነበሩት እንዴ?
Isn't he half-Jewish himself?	እሱ ራሱ ክሪስ ሃምስዎርዝ አይደለም ማለት ይፈልጋሉ?
His complaint isn't baseless.	የምታቀርቡት ቅሬታ ምንም መሰረት የሌለው ነው።
Thus, the religious overtones of the Syrian Civil War has perpetuated the conflict	የተቋረጠው የሶሪያ የሰላም ንግግር
in the heart of each of us.	በእያንዳንዳችን ልብ.
We might have a bigger problem.	ከዚህም የከፋ ችግር ደርሶብን ሊሆን ይችላል።
"Some of these ""agents"" remind me of ambulance chasers."	ከእነዚህ ‹የብሎግ አሰልጣኞች› መካከል የተወሰኑት የድሮውን የእባብ ዘይት ሻጮች ያስታውሱኛል ።
In the last four or five years, I've met a lot of influencers.	""" ባለፉት አራት እና አምስት አመታት ከተለያዩ ክለቦች ጋር አልፌያለው።"
If you're having drainage problems, don't immediately reach for chemicals.	የእርስዎ የኩላሊት ጤናማ አይደለም ከሆነ ወዲያውኑ እነዚህን ኪሚካሎች ሆነው ይቆዩ.
my favourite game...	የእኔ ተወዳጅ ስፖርት...
You will have to believe on a person who is completely unknown to you.	ለዚህም ማሳያው ብዙ የማያውቅሽ ሰው ሲያምንሽ ታያለሽ።
they are the chosen people of the only one true God and that He	ያዉ የተመረጠዉ ሰው እግዚኣብሔር የላከዉ ሰው ብቻ ነው እና ኣሁን
If that is the case, the country appears to me to be in serious trouble.	ይህ ካልሆነ በስተቀር አገሪቱ ከፍተኛ አደጋ ውስጥ እየገባች መሆኗ ነው የሚታየኝ።
Mozart's Magic Flute in a charming children's version.	የዚግዛግ ሰርvo አስተላላፊ ማሽን በሚገርም አመጋገብ ውስጥ አስገራሚ ምርታማነትን ይሰጣል ።
elected president, he would hold a press conference every month to communicate with the	አቶ ኮሚሽን ስብሰባ ያያዘ በእያንዳንዱ ወር ግን ሊቀመንበር መብት አለው ስብሰባዎች እዳም
The problem of choice is always painful.	ሁሌ መለመን ግን ህመም ነው።
Future will be yours.	መጪው ዘመን እኮ የእናንተ ነው።
truth of the next life becomes a true comfort.	ቀጥሎ ያለው ሕይወት የጉስቁልና ሆነ።
The 11th hour has come.	11ኛው ሰዓት ደርሷል!
Primer lets the lipstick stay on for a long time.	ከንፈራችንን ሊፕስቲክ ተቀብተን ለረጅም ጊዜ እንዲቆይ.
More than 75% of B2C marketers are using content marketing, while 69% are creating more content now than they did a year ago.	77% የሚሆኑት ነጋዴዎች አሁን የይዘት ግብይትን ይጠቀማሉ እና 69% የሚሆኑት ምርቶች ከአንድ ዓመት በፊት ከነበረው የበለጠ ይዘት ይፈጥራሉ ።
If what he alleges is a mere cavil, make him see that it is a cavil.	ወርኀ ዘር㗹 ነው ቢለው።
Do not be afraid of temptation.	ፈተናውን ለመጋፈጥ አትፍሩ!
Now I open my eyes, and now I see.	አሁን አየ አይኔ፣ አሁን አየ አይኔ.
But the Aunt isn't pregnant.	አክስቱ አስቀያሚ አይደለም ።
Each book seems to be its own creature, with its own demands and needs.	ማንኛውም ማናቸውም ተክል የእራሱ ባህሪያት እና ፍላጎቶች ያለው ህይወት ያለው ፍጥረት ነው.
All the houses here are log chalets.	እዚህ ሁሉም አንጓዎች የድንበር አንጓዎች ናቸው ።
She says that after initially attempting to strangle her, he pursued her when she tried to flee.	እነሱ ቀቅለው እንደሚበሏት ሲነገራት የኖረው ትውስ ቢላት ልትሸሻት ሞከረች።
Your faults ARE your faults.	በደላችሁ በደላችን ነው።
Signs on land.	የመሬት ላይ ምልክቶች.
And in fact, already have been.	ከዚህም በላይ እነሱ ቀድሞውኑ ናቸው።
Due to that at some point in age men get reduced in blood flows to the different organs of the body.	ከጊዜ በኋላ በሰዎች የፀጉር መርገም ላይ በሰውነት ውስጥ ወደ ሌሎች የሰውነት ክፍሎች ተሰራጭተዋል.
Determine the type of visa required to travel to the United States.	ወደ አሜሪካ ለመጓዝ የሚያስፈልገዎን የቪዛ አይነት ይወስኑ።
This time you don't get so easily,	አሁን ይህን ጊዜ ፣ በጣም ሳትደክሙ፣
by the time it reaches Mexico	መቼ ነው ወደ ሜክሲኮ የሚደርሱት
When it comes to surrendering to Him, I believe there are 3 things we need to surrender to God:	"ካብ ጋ አትጠጋ እላይህ ላይ ይፈርሳል አምላክን የምለምነው ሦስት ነገሮችን እንዲሰጠኝ ነው:- """
However, with the Swedes at the front was accompanied by his success.	ጠቅላይ ሚኒስትሩ በአገር ውስጥ ከህዝቡ ጋር ተቀራርበው ሃሳብ መቀበላቸው ስኬታማ እያደረጋቸው ነው።
We ought to be supported to the medieval models in certain constraints.	በሞዴል መልክ የቀረጽነው መተዳደሪያ ደንብ ዝቅተኛ ማሟላት ያለባቸውንን ነው።
prevent them from adopting unethical business practices.	ይህ ሥነ ምግባር የጎደለው የንግድ ግብይቶች እንዳይከሰቱ ያቆማል።
I'm not surprised as there are nature spirits around wherever we go.	በሄድንባቸው ቦታዎች ሁሉ ያጋጠመን ማራኪ ነገር ብል ማጋነን አይሆንብኝም።
are known to be the cause of mutations	- ለውጥ ምክንያቶች ተለይተው ይታወቃሉ
"He sat down with Sports Illustrated and discussed his historic career: ""I never thought it would be like this."""	በብርሃኑ ጨረር ዓይኖቹን እያጥበረበረ ‹‹እኔ እንደዚህ ዓይነት ነገር መፃፍ ቀርቶ አስቤም አላውቅም››በማለት የክሕደት ቃሉን ገፋበት።
That's why the employer is willing to pay for the labor services.	አሠሪው ደግሞ ለሚከፈለው ክፍያ አገልግሎት ያገኛል።
Child of the people.	የህዝብ ልጆች ።
"He claimed that those who voted to leave did so unaware, ""the people voted without knowledge of the true terms of Brexit."	"የምርጫ አስፈጻሚዎቹ ""የድምጽ አሰጣጥ ሥነ ሥርዓቱን ጠንቅቀው የማያውቁ ናቸው"" በማለትም ተችቷል።"
This is a White House full of unreliable narrators with people leaking information to sort of stab in the back someone else who is in a different faction.	ይህ ገጽታ ያለዉ ግለሰብ እንደአስፈላጊነቱ ወደ አደላዉ ክፍል የሚገለባበጥ በሁለት ተቃራኒ ጎራ ተመቻችቶ ለመቀመጥ የሚያስችላቸዉ መላ እየዘየደ የሚኖር ግለሰብ ነዉ።
The national champion jersey is regulated in articles 1.	የግሪን ሃውስ ስርዓት በ 1 ዋና ርዕስ ስር ቁጥጥር ይደረግበታል።
Before fake news, she captured the truth.	ዜናውን ሲቋጭ ደግሞ ሃቁን አስቀምጧል።
This will affect your credit and debt to income ratio.	ከኩባንያው ዕዳ እና የብድር መጠን ጋር ይዛመዳል ።
You need to understand that the greatest blocker is your own willpower.	ዝገቱ የጉድጓድዎ ትልቁ ጠላት መሆኑን ማወቅ አለብዎት።
And so I pledge myself to it,	እኔ ራሴ ቃል እገባለሁ
The findings with regards to the positive selection of our sample of asylum seekers is consistent with Chiswick's (1999, p.	ለኛዎቹ ተቃዋሚዎች ይህ የጋምቢያ ፈተና የ1997 ዓ.
The state's excellent universities should be heavily involved in this process.	በዚህ ወሳኝ ተግባር ላይ የሃገሪቱ ምሁራን ተሳትፎ አጽንዖት ሊሰጠው ይገባል።
"elizabeth says: ""Could not put it down"""	ወሲብ ትዕይንት- ስለጀመሩ
Pacific Awards Night is on Wednesday 13 June.	የአካዳሚክ ማመልከቻዎች ረቡዕ ጃንዋሪ 13 ናቸው ።
This lack of transparency has to stop!	ይህ ብልሹነት መቆም አለበት!
In his commitment to protecting the innocent, he has transcended to near godhood.	ዘይሄይስ እምኔሃ ወቦቱ ንቀርቦ ለእግዚአብሔር
At the same time, we have adjusted to life under new owners.	በዚህም አዲስ ተደራጅተው በመጡ ሰዎች ስር እንድንሰራ ሆኗል።
The important dates of Chhath Puja 2013 have been mentioned below.	Teemu Pukki እስከዛሬ ድረስ ያቆየው በጣም አስፈላጊው የልጅነት ትውስታ ከዚህ በታች ካለው ፎቶ ተብራርቷል።
I want to be the wise woman who fears the Lord and honors Him daily in her life.	ይኽቺ ሴት በዘመኑ እግዚአብሔርን እጅግ የምትፈራና የምታመልክ ሕጉንም የምታከብር ናት።
My dream is coming into reality.	ሕልሜ እውን እየሆነ ነው.
With great humility,	ከታላቅ አክብሮት ጋር፣
Luke 21:25-27 And there shall be signs in the sun, and in the moon, and in the stars; and upon the earth distress of nations, with perplexity; the sea and the waves roaring; [26] Men's hearts failing them for fear, and for looking after those things which are coming on the earth: for the powers of heaven shall be shaken.	25 _Lucas 21:25_ በፀሐይና በጨረቃም በከዋክብትም ምልክት ይሆናል፤ በምድር ላይም አሕዛብ ከባሕሩና ከሞገዱም ድምፅ የተነሣ እያመነቱ ይጨነቃሉ፤
So why does it work for some, and not for others?	ግን ለምን ለአንዳንዶች እንጂ ለሌሎቹ አይሰራም?
Since the Fall, the earth and its people have been on a downward trajectory of decay.	አገርና ህዝብ እግር ከወርች ታሰሩ።
Was he trying to send a message to a witness?	ሰው ሳይነግረው ቀርቶ ነው?
"Or shall all the fish of the sea be gathered for them to provide enough for them?"""	ወይስ የባሕርን ዓሣ ሁሉ ያጠግባቸው ዘንድ ይሰበሰብላቸዋልን?
Monday, December 24,	ሰኞ፣ ታኅሣሥ 24
- This occurs for two days...	ለሁለት ቀናት የሚደረገው ይህ...
of his worshipers.	በአምላኪዎቹ ይሳማል።
Welcome to your on-line login...	ደህና ፣ በመረቡ ላይ እንኳን:
We could walk in the sun!	እንዲሁም በፀሐይ ላይ በእግር መጓዝ ይችላሉ!
Servicing Australia, New Zealand and the South Pacific Regions.	አይኤችጂጂ አውስትራሊያ ፣ ኒውዚላንድ እና ደቡብ ፓስፊክ ኃላፊ .
This is the stupidest thing I ever read.	ይህ ያነበብኩት ትልቁ ሞኝነት ነው ።
What are the basis of such serious accusations?	ይህን ያህል በእብሪት የተወጠረበትስ ምክናያት ምንድን ነው?
(Mighty & Majestic) has granted him the praiseworthy station in the Hereafter.	ወደ ፡ ቀድሞው ፡ ሕይወት ፡ ለክብር ፡ መለሰው
Do you know all the abilities of yourself?	የራሳችሁን ችሎታስ በደንብ አውቃችኋል ?
17 When they saw him, they worshiped,[d] but some doubted.	17 ባዩትም ጊዜ ሰገዱለት፤ የተጠራጠሩ ግን ነበሩ።
I was at first a para-legal with the IRS.	እኔ በመጀመሪያ ከ IRS ጋር ፓራ-ህጋዊ ነበርኩ ።
How are the two strophes enacted?	ሁለቱ ስቴቶች እንዴት ይተሳሰራሉ?
The last, but certainly one of the most crucial marketing services, is Web Traffic Optimization (WTO).	እና ሳልቶ ከሁሉም በላይ የበይነመረብ አገልግሎት ስለሆነ .
My number one rule: keep smiling.	ቀላል ደረጃ #1: ሁሌ ፈገግ በል
We're getting closer though..	ይሁን እንጂ በቀረበልን...
Be with our families as many of us are away from home during the week.	የበዓል ወቅት በእኛ ላይ በመጣ ቁጥር ብዙ ሰዎች ለረጅም ጊዜ ከቤት ይርቃሉ ።
the big question is, why didn't she tell anyone about it? apparently no one corroborated her story.	ውስጧ ለምንም ያልነገረችው ማንም ያላዳማጣት ብዙ እውነት አለ።
These soldiers are part of security.	እነዚህ ሠራተኞች የዳኝነቱ አካል ናቸው።
God bless him and his workers.	በእግዚአብሔርና በሥራው ብቻ ተደነቅ።
They made for themselves a calf and did obeisance to it and offered sacrifices to it, and they said, 9 'These are your gods, Israel, who brought you up from the land of Egypt.'	ለራሳቸውም የጥጃ ሐውልት* ሠርተዋል፤ ለእሱም እየሰገዱና መሥዋዕት እያቀረቡ 'እስራኤል ሆይ፣ ከግብፅ ምድር መርቶ ያወጣህ አምላክህ ይህ ነው' እያሉ ነው።
Console will show the progress of Test case.	ScoreNEET ጋር ፈተና ውጤት እንዲል.
Booking window is now through December 31, 2021.	የቦታ ማስያዣ መስኮት አሁን እስከ ታህሳስ 31 ቀን 2021 ድረስ ነው።
At least, from the start.	ቢያንስ ከመጀመሪያው ።
points on the Earth's surface, and this is accomplished in a number of ways.	በየውድድሩ መሻሻል እየታየ ሲሆን፤ ይህም በተለያዩ መንገዶች ይረጋገጣል።
It's like the meeting ground of the world.	እንደ አገርም የስብሰባ ማዕከል ናት ማለት ይቻላል።
"I am thrilled beyond words to have this opportunity."""	"""ዕጣ ፈንታ እንዲህ ዓይነት አጋጣሚዎች ስለሰጠኝ ከመጠን በላይ ዕድለኛ ነኝ"" አለኝ."
A) Yes, this app is available for download from both popular mobile platforms.	A: አዎ ይህ አዲስ መተግበሪያ ለሞባይል ምቹ እና በብዙ አሳሾች ላይ ይገኛል ።
Would you go back to the mormon church?	ወደ ቅዱስ ጊዮርጊስ ትመለሳለህ?
- Or a normal version, but can have a considerable impact on FPS, depending on the power of your computer.	- ወይም መደበኛ ስሪት ፣ ግን በኮምፒተርዎ ኃይል ላይ በመመርኮዝ በ FPS ላይ ከፍተኛ ተጽዕኖ ሊያሳድር ይችላል።
I am selling due to personal issues.	ለግል የሥራ ጉዳይ እየሄድኩ ነው።
There is an economic reality to consider.	በእርግጥ ግምት ውስጥ የሚገባ ኢኮኖሚም አለ ።
This is so that we can automatically recognize and approve the following comments instead of keeping them in the moderation queue.	ይህ በሚከተሉት ደረጃዎች ውስጥ ከመተው ይልቅ የሚከተሉትን አስተያየቶች በራስ ሰር ይቀበላቸዋል እና ያጸናቸዋል.
Not all shelves must be filled.	ነገር ግን እያንዳንዱ ጉድጓድ መሞላት የለበትም.
Or maybe my priorities and criteria are misplaced, and we're not supposed to have an impact on the world at large?	ወይስ የማደርጋቸው ውሳኔዎችና ቅድሚያ የምሰጣቸው ነገሮች መጨረሻው በቅርቡ ይመጣል ብዬ እንደማልጠብቅ ይባስ ብሎም መጨረሻው መምጣቱን እንደምጠራጠር ያሳያሉ?
We took off into the woods.	ተታኩሰን ወደ ጫካ ወጣን።
the knob 18 will be turned to the desired temperature	vMix 18 በይፋ ተለቋል
Second, it is about freedom.	አንደኛ የነጻነት ጉዳይ ነው።
In 2014, most Americans would be required to carry health insurance.	በ2014 አብዛኛው የአሜሪካ ዜጋ አቅማቸውን ያመጣጠነ የጤና ዋስትና ይኖራቸዋል።
"""They're not your children!"""	የእነሱ ልጆች አይደላችሁም!
Thank you for this list, CF.	ለዚህ ዝርዝር እናመሰግናለን ፣ ዲ.
How can we be charged an over-limit fee when we hadn't been approved to charge any money?	በጣም ወጪ የሚያስወጣውን ካላሰብን አንድ ነገር ትርፋማ ነው ማለት እንዴት እንችላለን?
In theory at least, these aims are not incompatible.	በመሰረቱ ከእነሱ ጋር መነፃፀሩም ያንን ያህል ተገቢ አይደለም።
Plans for the upcoming year?	ለሚቀጥለው ዓመት የቀረበ ሀሳብ?
This article has been compiled to help you choose the right adverts and to help ensure they're delivered right.	ይህ ድጋፍ እናንተ ይምረጡ ማግኘት እና ቀኝ እንዳደረገ ስራዎች ለማግኘት ተገቢ መሣሪያዎችን መጠቀም ይረዳል.
"""So whether you eat or drink or whatever you do, do it all for the glory of God"" (NIV)."	እንግዲህ የምትበሉ ወይም የምትጠጡ ብትሆኑ ወይም ማናቸውን ነገር ብታደርጉ ሁሉን ለእግዚአብሔር ክብር አድርጉት።
"Tell them, ""Well, [pause] if that's your kind of thing."""	"እንደኾናችሁ (መልሱልኝ) "" በላቸው።"
He will be there until He comes back to establish His Kingdom.	እርሱ መንግሥቱን ሊያቆም እስኪመጣ ጦርነቶቹ ይካሄዳሉ።
The gelernt does not elected.	ተማሪ መረጠውም አልመረጠውም ማለት ነው።
The setting error of SD card is corrected.	በስህተት የ SD ካርድ የተመሰጠረ ነው.
Whether it's a rendition of a well-known song or a traditional melody, you cannot help but think of romantic vibes when hearing these soft sounds.	ዘማሪዋ በማወቅም ይሁን የገጣሚውን ማንነት ካለመረዳት የመጣ የዋህነት የተጠቀሱትን ስንኞች ዘምራለች።
In fact they will feel sorry at their inability to perform the same acts.	ለማድረግ ባለመቻሉ ያዝናል, ተመሳሳይ በማውረድ አይገኝም.
What is one of the main reasons you may choose to use an incubator?	በመጀመሪያ ደረጃ ላይ አንዲት እርጉዝ ማርባት እንድትችል ዋና ዋና ምክንያቶች ምንድን ናቸው?
And he engraved the doors of the inner temple, ಎಂದು, for the Holy of Holies.	እርሱም ወደ ውስጠኛው መቅደስ በሮች የተቀረጸው, ያውና, ቅድስተ ቅዱሳን ስለ.
It is One Love.	አንድ ነው ፍቅር።
The Finnish operator will retain a 10 percent minority stake in Vertu, which makes gold-plated devices.	ተጫራቾች የጨረታ ማስከበሪያ ቢድ ቦንድ 10% በባንክ በተረጋገጠ የክፍያ ትዕዛዝ ሲ.
I'm sure there are people with more creative ideas than me.	እዚህ ካነሳሁት የመነሻ ሀሳብ የበለጠ ሀሳብ ያላቸው ሰዎች እንዳሉም አውቃለሁ።
Man dies after being tied up in his home for several days	ልጅዎ ታሞ ከሆነ ለተወሰነ ቀናት እቤት እንዲቆይ ማድረግ
the good luck is here!	ጥሩ, እዚህ ላይ ነው ዕድል!
This is a perfect opportunity to expand.	ይህ ተጽዕኖ ለማስፋት ጥሩ አጋጣሚ ነው.
"""He's a tremendous skater with tremendous skill,"" says Ron Anderson."	"አንድሩ ""ሀብታም ችሎታ ያለው ባለሙያ ነው"" ብሏል።"
For doing so, they are to be commended.	እንዲህ በማድረጋቸውም አድናቆት ሊቸራቸው ይገባል።
poured out his vial upon the earth.	መስቀሉን እንደያዘ ወደ ምድር ተደፋ።
Learn to describe two pieces of legislation introduced in the US Congress to support health promotion.	READ ኢትዮጵያን ለመጉዳት በአሜሪካ ኮንግረስ አባላት የተጠነሰሱ ሁለት ረቂቅ የውሳኔ ሐሳቦች መከኑ ተባለ
For instance, the Rom cartridges may only render a certain quantity of textures which restricted the overall graphics capabilities of the system.	ለምሳሌ ፣ አንዳንድ ስካነሮችን ብቻ የሙሉ መጠን ከፊል-ሊስተካከል የሚችል አርቲፊተሮችን በቀላሉ መቃኘት ይችላሉ።
- ESG - if not now, when?	org - አሁን መቼ ይሁን?
Are We Living in the Last Days.	የምንኖረው በመጨረሻዎቹ ቀናት ውስጥ ነው?
Acts 3:5 - And he looked on them, expecting to receive something from them.	5 _Atos 3:5_ እርሱም አንድ ነገር ከእነርሱ እንዲቀበል ሲጠብቅ ወደ እነርሱ ተመለከተ።
28 When He entered the house, the blind men came up to Him, and Jesus *said to	28 ወደ ቤትም በገባ ጊዜ ዕውሮቹ ወደ እርሱ ቀረቡ፥ ኢየሱስም።
The Ministry of Finance proposed the abolition of mandatory indexation of salaries of civil servants	መ/ቤቱ የድጋፍ ሠራተኞች ደንብ ልብስ ግዥ በግልጽ ጨረታ አወዳድሮ መስጠት ይፈልጋል
The Way which leads the human to Self-conscious immortality cannot be traveled by everyone.	የሰውን ልጅ ወደ ራስ የሚያደርሰው መንገድንቁ ዘላለማዊነት በሁሉም ሰው መጓዝ አይችልም።
How's the fishing right now?....Is the lake open?	የሶኖማ ሐይቅ ክፍት ነው?
You may not think jewelry is important, but it is.	እርስዎ የጎራ ስም ጠቃሚ ነው ብለው ላይሆን ይችላል, ነገር ግን ይህ ነው.
Money is a power.	ገንዘብ ሃይል ነው።
Today's everyone has a mobile phone.	ዛሬ ሁሉም ሰው ሞባይል አለው ።
Work must be finished by the end of the week.	ሂደቱ በሳምንቱ መጨረሻ ላይ መከናወን አለበት.
I believe Church is where people gather to hear the word of God and communicate with one another.	ቤተክርስቲያን ናት ክርስቲያኖች ስለ አምላክ ቃል የበለጠ ለማወቅና እርስ በርስ ለመበረታታት የሚሰበሰቡበት ቦታ.
There is, in other words, capacity for doubling Acela service south of New York, where the highest demand is.	ስለዚህም ከደቡብ በኩል ያለዉን አዲስ ሃይል ኦህዴድን ጨምሮ empower ማድረግ ነዉ ዋናዉ የሱ ስራ።
In Korea, the Deluxe Edition came with a poster.	የህትመት Fest ን ይክፈቱ.
She met her partner through mutual friends and they soon started living together at his mother's house.	ከሁለት ጓደኞችዋ ጋር ቤት ተከራይታ በጋራ መኖር ጀመረች።
Don't talk about the weather.	Apple ስለ ቀኑ ጊዜ አትናገሩ ።
Children of the Damned Cover (All Guitars)	የውድድሩ ኮከቦች (ሁሉም ዋንጫ ተሸልመዋል)
We ran a program on racial profiling, and we involved the police to discuss that with the young people at the centre.	እኛ ይሄን በቃለ ጉባኤ ይዘን ኮሚቴ አቋቁመን የንብረት ቆጠራ አካሂደን፣ ጉዳዩን ለፖሊስ አመለከትን።
Our experience provides you with the comfort of having the right advice and investment strategy from the beginning.	በጥሩ ሁኔታ ግብይት እና በማስታወቂያ ስልቶች ላይ ከመጀመሪያው ጀምሮ ኢን investስት እንዲያደርጉ እንመክርዎታለን።
I wish that they'd bring the bundle to America.	ይህ ይሆንላቸው ዘንድም ድርድሩን ወደ አሜሪካ ወሰዱት።
This man has now been emboldened by the government.	ይህ ባነር በየ መንግስታዊ ተቋሙ ተሰቅሎ ይገኛል።
Corrosion caused by humidity and salt in the air can reduce the performance of plants in the long term.	የግሉ ዘርፍ ማሳተፍ እና በዚህ ገበያ ላይ መዋዕለ ንዋይ ማፍሰስ በረጅም ጊዜ ውስጥ አቅም የመጠበቅ አቅሙን ይቀንሳል.
Its handy for bus and train station.	በስልክዎ ላይ የሲቲኤ አውቶቡስ እና ባቡር ጊዜ.
This is where the real Wild West begins.	እንግዲህ የምዕራባውያን ድንጋጤ የሚጀምረው እዚሁ ጋር ነው።
But still not Nationality.	የሚል አገርና ዜግነት አልነበረም አሁንም የለም።
She asked if she could help him to which Groves demanded her driver's license.	አያ ጅቦም ሌሎቹ እንደጠየቋት ጠየቃት።
My team's project, of which I was the main developer, was selected by the client and was used as the foundation of democracity.ca.	በዲፕሎም የተመረቅሁት የአካውንቲንግ
He's a ... Get the pupils to point to the correct people.	እናላችሁ... ተማሪዎቹን ስለ ውሸት ሊያስተምራቸው ይፈልጋል።
They won't import cattle.	ወይንስ አይፈልጉም።
"They were terrified..."" Luke 2:9 (NLT)"	"እነሱም በጣም ፈሩ "" (Lk 2,9) ።"
24:15 Therefore glorify ye the Lord in instruction: the name of the Lord God of Israel in the islands of the sea.	24:15 በዚህ ምክንያት, ትምህርት ውስጥ ጌታን ያመስግን: በጌታ ስም, የእስራኤል አምላክ እግዚአብሔር, በባሕር ደሴቶች ላይ.
of life in the oceans, and of the hundreds of millions of people who lived from traditional fishing	ዜጎች፣በሚሉዮን የሚቆጠሩ በየባእዴ አገሩ ተሰዯው የሚኖሩና የግፍ ክንዴ
He is the culmination of the celebration.	የምስረታ በዓሉን ያከብራል።
We must not become like them.	ስለዚህ እንደነሱ መሆን የለብዎትም ።
They're often able to see things that are difficult for you to see.	ብዙ ጊዜ ለአንተ በቀላሉ የማይታዩ ነገሮችን ያያሉ።
The three men on the right are also judges.	ከፍርድ ቤቶች በስተቀር ሦስቱም የሕግ አስፈጻሚው አካል ናቸው።
"As the Apostle Paul wrote, ""The way of peace they have not known."	እነዚህን ሰዎች ቅዱስ ጳውሎስ በመልእክቱ ላይ ‹‹የሰላምን መንገድ አያውቋትም።
Yet it may be able to draw attention and energy.	ትኩረት እና ተጽዕኖዎችን ያክሉ ይችላሉ.
Apple, hopefully will not ignore these two points.	አቶ ገብሩ፡- መድረክ የሚለው እነዚህ ሁለት ነገሮች አይጣረሱም ነው።
the Serbian Orthodox Church opposes ecumenism; and through whom and in what	የኢትዮጵያ ኦርቶዶክስ ተዋሕዶ ቤተክርስቲያን መዝሙር - በምን.
It is imperative that trees and shrubs be watered on a regular basis if rainfall is not adequate.	የመሬት መሸርሸሩ ካልተስተካከለ የሸረቀ ብሩሾችን እና ማረሻዎችን መጠቀም አስፈላጊ ነው.
During an interview with the german TV station RTL:	👉 አማናል ከጀርመን ብሔራዊ ቲቪ ጋር ያደረገው ቃለ መጠይቅ ትርጉሞች፦
The Designer is now in the Microsoft Store.	መሣሪያው አሁን በ Microsoft Store ውስጥ ለሽያጭ ይገኛል።
There must also be an obligatory mention of Russia's harsh winter climate, which makes using a car much more appealing.	እንዲሁም የሩስያ ጭብጥ በጣም ያነሳሳውን የኢራንግል ካርታ የሚለግሰውን ያንን ቀላል ያልሆነ አየርን መረዳት ይችላሉ ።
Nicholson, Campbell and I decide to go on a journey, but hey! where are we all going?	እኔ አምሀርም ጋላም ንኝ እንደእኔም ብዙዎች አሉ ታዲያ የት ነው የምንሄደው?
After a close look at the roster, the place where they could use some additional help would be at right wing.	የ Instagram መገለጫዎን ማን እንደሚጎበኝ ለማየት
Let's weep for ourselves.	ራሳችን ለራሳችን እናለቅሳለን።
Being queen of the rock and roll scene isn't as easy as her highness makes it look bu.	የፀጋዬ መርዶና ቀብሩ የልፋቱን ያህል ደምቆና ከብዶ አለመታየቱ የ.
and prolonged drought periods.	ረዘም ያለ የክፍያ ወቅቶች ተባዙ;
How do you believe we experience a work of art?	የፈረንጅ ስራ ስለመሰለን ይሆን?
Daniel went with us.	ዳንኤል አብሮን ይጓዛል።
Every woman should know this man's secret	እያንዳንዱ ሴት ያስሱ እና ይኑርህ አለበት ይህ የውበት ሚስጥር
That's when we realized; we need to build something new.	ይሄን መገንዘብ ጥሩነው፤ አዲስ ነገርም መፍጠርም አለብን።
He was accustomed to ask his subconscious to give him a good.	""" በማለት ነው በምሬት የጠየቀው።"
""" Until it come to Thee, in vain I look around;"	መለስ ብየ ሳየው አመጣጤን ሁሉ;
This is not just a statement, it is a belief.	ይህ አባባል ብቻም አይደለም፤ እምነት ነው።
The night is a separate attraction.	የሌሊቱ ደግሞ ሌላ ጣጣ ነው።
You decide not to let any townspeople into the bar so that no one fights.	ትግሉ ተሸናፊዎች ወደሚገቡበት አዳራሽ ለመግባት ማንም በማንም ላይ በሩን እንዳይዘጋ ለማድረግ መሆን አለበት።
Miss Marchmont - The Way of a Man with A Maid 171 MB	21 ሆሚኒድስ - ወንድ በደብልዩ 71 Rubbit ጉበት
It used to be a trucker would have two choices, if any.	ኢንጂነር ይልቃል፡- ያ ቢሆን ኖሮ ሁለት ዓይነት ምርጫ ይኖረን ነበር።
The story could end here and it would be a fantastic story.	የtት ታሪክ እዚህ ላይ ሊያበቃ ይችላል ፣ እና እሱ ታላቅ ታሪክ ይሆናል።
Deuteronomy 21:22; And if a man have committed a sin worthy of death, and he be to be put to death, and thou hang him on a tree:	ዘዳግም 21:22 - Correct Me ማንም ሰው ለሞት የሚያበቃውን ኃጢአት ቢሠራ፥ እንዲሞትም ቢፈረድበት፥ በእንጨትም ላይ ብትሰቅለው፥
"When he asked why he was in prison, he said, the answer was, ""We keep you for security reasons."""	ለምን እንደሚታሰሩ ለጠየቅናቸው ጥያቄ ‹‹ሰላማዊ ሰልፍ ለማድረግ አቅዳችኋል›› በሚል ሰበብ እንደሆነ ተናግረዋል።
You need to enable Java Web-Start to run it (which is usually enabled).	ማድረግ አለብን መጀመሪያ የዩቲዩብ ድረ-ገጽን ይድረሱ (ከዚህ ማድረግ ይችላሉይሄአገናኝ) ።
"""This is what Christ's birth means to us."	ክርስቶስን መልበሳችን ማለት ለእኔ ይሄ ነው ።
gifts are taken to the Center in preparation for the Christmas party held for the	የገና በአልን ምክንያት በማድረግ በመዲናዋ ለበአሉ የሚያስፈልጉ ግብአቶች ግብይት እየተከናወነ ነው
They get tainted with the dust and odors; it's not appealing to those around us.	አጥሮ ለማስረዘም አሊያም ረዝም ለማሳጠር የምንሞክረው ትርጉም፤ በእኛ ልክ የተሰፋ አይደለም።
They are both honest and uncomplicated, which makes them easy to apply.	ሁለቱም ቀጥተኛ እና ያልተወሳሰበ ናቸው, ይህም ለአጠቃቀም ቀላል ያደርገዋል.
with the skins of animals for bed and bedding.	ከአመጋገብ እና እንቅልፍ መተግበሪያዎች ጋር ውህደት።
And then they made her go under water.	ታዲያ በውኃ መጥረግ ነዋ።
She wouldn't stop following them.	እነሱን መከተል አቁም።
May not offer shares to the public.	ለፓርቲው መዋጮ ላይከፍል ይችላል።
"Thank you for not letting me give up!"""	ላልሰጠከኝ ላመስግንህ!
Your benevolence towards me will not be forgotten.	እንዲሁ ፡ አልተውከኝም ፡ በፍቅርህ ፡ አዳንከኝ
Black dress is a fashion clothing.	ጥቁርም ነጭም ልብስ ልብስ ነው።
You need to first download the app and answer basic questions about yourself.	መተግበሪያውን ያውርዱ እና ስለ ራስህ መሠረታዊ ጥያቄዎች መልስ.
The fiftieth year.	50 ኛ ዓመት.
Now go, and I will be with your mouth and teach you what you are to speak.	እንግዲህ አሁን ሂድ፥ እኔም ከአፍህ ጋር እሆናለሁ፥ የምትናገረውንም አስተምርሃለሁ አለው።
1 Corinthians 6:2: Do you not know that the saints will judge the world?	1ቆሮ 6:2 ቅዱሳን በዓለም ላይ እንደሚፈርዱ አታውቁም?
They laid hands on Him, and seized Him.	እነርሱም እጃቸውን በእርሱ ላይ ጭነው ያዙት።
The results of these tests are recorded on the Certificates of Analysis.	የእነዚህ ክዋኔዎች ውጤት በመለኪያ የምስክር ወረቀት ውስጥ ተገል is ል።
The Health and Safety Executive has been added as an interested party.	በተመሳሳይ የመከላከያና የደህንነት ተቋማት ቀደም ብሎ የአንድ ፓርቲ መጠቀሚያ ነበሩ።
The suitable delegation of power and responsibility has been implemented.	የመፍታት እና የማስተዳደር ተግባር እና ኃላፊነት ተሰጥቶት ሲሰራ ቆይቷል።
A slice of a previously unseen side to life.	መድረሻ የሌለው ጥግ አልባ የህይወት ህልቆ መሳፍርት።
Paper is expensive, and even though there are a few things which you'll require a good deal of, you always have the option to go without.	ይህ ምርጫ በጣም ውድ ነው ፣ እና እርስዎ ባዶ እጃቸውን ላለመውጣት እርስዎ የሚመርጧቸው ብዙ ነገሮች ይኖራሉ።
I sure do, do you want to come to my house?	እኔም ዝግጁ ነኝ፣ወደ ቤትህ መሄድ ትፈልጋለህ?
As for the future of man and machine integration, I'm even optimistic about those opportunities.	የወደፊት የሰው እና የማሽን ውህደት በተመለከተ ፣ ስለእነዚህ ዕድሎች እንኳን ብሩህ ተስፋ አለኝ ።
They also perform functions like preventing the same ad from continuously reappearing, ensuring that ads are properly displayed for advertisers, and in some cases selecting advertisements that are based on your interests.	እንዲሁም ተመሳሳይ ማስታወቂያ በተከታታይ እንዳይታዩ እና ማስታወቂያዎች በትክክል እንዲታዩ የማድረግ እና በአንዳንድ ሁኔታዎች በእርስዎ ፍላጎቶች ላይ የተመሰረቱ ማስታወቂያዎችን የመምረጥ ተግባራትን ያከናውናል።
And I hope you continue to pay it forward and share all the good.	ወደፊት መክፈልዎን እና ሁሉንም መልካም ነገሮች ማጋራትዎን እንደሚቀጥሉ ተስፋ አደርጋለሁ ።
New, more concentrated formulations were proposed and checked to allow a minimum stability of 28 days.	የተለያዩ አዋጆች እየተሻሻሉና እየተጠኑ ሲሆን፣ ይህ መቶ ቀን ሳያልቅ በአጭር ጊዜ ውስጥም ይጠናቀቃሉ ተብሎ ይጠበቃል።
Do you want to stay up to date with the best Violetta events that are the best ticketing service in.	ምርጥ የወንጀል ጨዋታ ትፈልጋለህ?
The end of the road is in sight would you say?	- ቤተመቅደሱ ከምንሄድበት መንገድ ቅርብ ነው፣ማየት ትፈልጋለህ ?
A great collaborator, we have rewritten many of the business rules.	እንደ ሃላፊው ገለጻ ብዙዎቹን መመሪያዎች የማስተካከል ስራ ነው የሰራነው አንዳንዶቹን አጠናቀናል ።
that he did not know himself.	ራሱን አያውቀውም ማለት ነው።
wholly beneath the earth.	ሁሉም ከመሬት በታች .
And this one doesn't do flattening of the output.	ይህ ምርት ማበጀትን አይደግፍም ።
Nineteen are self-sufficient.	በርሷም ላይ አሥራ ዘጠኝ (ዘበኞች) አሉባት።
It occurs when the keyboard key is released.	ይህ ሁኔታ የሚፈጸመው የ አይጥ ቁልፍ መቆጣጠሪያ ሲለቅ ነው
So I will not help you.	ስለዚህ አልረዳህም።
Our client's satisfaction is the revenue for us which motivates us to do better and better.	ደንበኞቻችንም በዚህ ደስተኞች ስለሆኑ የሚሰጡን አስተያየት ጥሩና ለበለጠ ሥራ የሚያነሳሳ ነው።
Hello I would like to extend our thanks to entire staff of the St. George.	በዚህም መላውን የቅዱስ ጊዮርጊስ ደጋፊ አመሰግናለሁ።
Lhasa has now become a modern city.	ሴሉሲኒ ዘመናዊ ከተማ ሆነች።
He was the perfect model for this project.	ለዚህ ፕሮጀክት ፍጹም አጋር ነበር ።
"""We're really nervous because of this war."	በዚህ ጦርነት ምክንያት በከፍተኛ ስጋት ውስጥ ነን።
The Naboso insole isn't like other insoles on the market.	የቢሊ አሻንጉሊቶች በገበያው ውስጥ እንደሌሎች አሻንጉሊቶች አይደሉም ።
V.S. Lisovy , the philosophy teacher , who was working at the institute in 1962-1966, is remembered by the students of the 1960s owing to his lectures and original institute wallpapers which he edited .	Lisovy, ፍልስፍና መምህር, ተቋሙ ውስጥ ላይ እየሰራ ነበር 1962-1966, እሱ አርትዖት ይህም የእርሱ ንግግሮች እና የመጀመሪያ ኢንስቲትዩት የግድግዳ ላይ እዳ 1960 መካከል ተማሪዎች በ ትዝ ነው.
This is just one of the many steamers from Rowenta.	በሮኬትTheme ላይ ካሉት በርካታ ማራዘሚያዎች ውስጥ አንዱ ያ ብቻ ነው ።
You don't need a car here! 2 electric panels.	ወይም ከዚያ 2 የኤሌክትሪክ መኪናዎች ያስፈልጉ!
Don't forget about the amazing shows.	ስለ አስደናቂ ዝርዝሮች አትርሳ.
The processing of the data by Facebook takes place within the framework of Facebook's data usage policy.	በፌስቡክ በኩል ጥቅም ላይ የሚውል መረጃ በፌስቡክ የግል መብት ፖሊሲ ሁኔታ ይወሰናል።
Researchers say that because of hormonal changes that occur in adolescence, teens' bodies are not ready to go to sleep earlier at night.	ባለሙያዎቹም በመኝታ ሰዓት የሰውነት ሙቀታቸው ቀዝቃዛ የሆኑ ሰዎች ለእንቅልፍ መቆራረጥ እንደማይዳረጉ ይገልጻሉ።
"And the prophet Isaiah the son of Amoz came to him, and said..."""	ነቢዩም የአሞጽ ልጅ ኢሳይያስ ወደ እርሱ መጥቶ።
It's the one that clinched it for me to try with Jake.	ግን ያሰነበተኝ ለካንስ ስለዚህ ነበር።
Trust is not gained overnight.	ሆኖም መተማመን በአንድ ጀምበር የሚመጣ ነገር አይደለም።
Instead of making your audience feel confused, tell them what they need to do.	ምን ማድረግ እንዳለብዎት ይነግርዎታል, ምን ማድረግ እንዳለብዎ ከሚነግርዎት የስሜት ሕዋሳትዎ ይልቅ.
Your data can't be stolen if it isn't with you.	እናንተን ካላካተተ የኢትዮጵያ ሃብት መሆን አይችልም።
(Eliminate the Banned 2nd person.	(ለመንግስት ለተፈቀደለት ግብዣ እባክዎን አማራጭን 2.
Therefore, we only focus on the most important things.	እኛ ብቻ በጣም አስፈላጊ ተግባራት ላይ ያተኮረ ነው.
In response to a tap at the door of his	እብሪት በደጁ ሲሰለፍ
These desks aren't assigned to any individual worker, but might be shared.	እነዚህ ፣ ለገንቢዎች በማንኛውም መሣሪያ ላይ እንዲጫኑ የታሰቡ አይደሉም ፣ ሆኖም ግን የተወሰነ መረጃ ሊሰጡን ይችላሉ ።
The corollary on the part of ordinary people is the attitude that emergency preparedness should be left to the experts.	በየመን የሚደረጉ ሰብዓዊ ድጋፎች ሊቆሙ ነው
There isn't any jobs for them.	ለእነርሱ የሚሆን ሥራ የለም።
We don't because we often find that they don't have the other foundations of their online presence in place.	እኛ አናደርግም ምክንያቱም ብዙውን ጊዜ በቦታው ላይ የመስመር ላይ መገኘታቸው ሌሎች መሠረቶች እንደሌላቸው እናገኛለን ።
However, for example when she describes herself while volunteering at an AIDS clinic.	ለምሳሌ l ስንጫን ል ይጻፋል።
Members of the survey team will discuss their findings in this free webinar.	ነፃ ሪፖርቶች ምርምራቸውን በዚህ ድህረ-ገጽ ላይ እንዲመርጡ.
A Husband and a Dog	አንድ ሰው እና አንድ ውሻ
To me it seemed irrational and unsympathetic.	ለእኔ ፈፅሞ የማይታሰብና ረብ የለሽ ነው።
I believe you (4x)	እኔም ፡ አምነዋለሁ (፬x)
For the columns from F to J, we take the RTE data from the 2012, 2013 or 2014 tabs and we multiply by the multiplying coefficient in B5 or B6.	ከ 2012 ፣ 2013 ወይም 2014 ትሮች ላይ የ RTE መረጃን እንወስዳለን እና በ B5 ወይም B6 ውስጥ በሚባዛው ተባዝቶ እንባዛለን ።
Trying to not send them to a shelter.	ሆቴል እንዳይሆን ስላቸው.
I've wished it all my life.	በህይወቴ ሁሉ እመኘው ነበር።
your broken hearts.	ልባቸው የተሰበረውን።
It kills viruses that may be on your hands.	ምክንያቱም በእጆችዎ ላይ ሊሆኑ የሚችሉትን ቫይረሶችን ይገድላሉ ።
They know your body language.	አንጎልህ ዕድሜ ይወቁ.
There are variety of cash games for everybody.	ለሁሉም የሚሆን የገንዘብ ጨዋታዎች የተለያዩ አሉ.
"""Who are you to be listened to?"	ሲደረግ (ሲሆን) ማን ሰማ ?
If that were the case, then I would suspect YFZ was targeted in some way.	እውነት ከሆነ ግን ኢህአዴግን እንደተለመደው እታዘበዋለሁ ማለት ነው።
7:16 But if the sacrifice of his offering be a vow, or a freewill-offering, it shall be eaten on the day that he offers his sacrifice; and on the next day that which remains of it shall be eaten:	16፤ የቍርባኑም መሥዋዕት የስእለት ወይም የፈቃድ ቢሆን፥ መሥዋዕቱ በሚቀርብበት ቀን ይብሉት፤ ከእርሱም የቀረውን በነጋው ይብሉት፤
Your works of our Lord,Jesus are abundant in the blessings to be seen by the people of the !villages.	28_59_ጌታህም ከተሞችን በዋናዋ (ከተማ) ውስጥ አንቀጾቻችንን በእነሱ ላይ የሚያነብ
I postponed until the Bth.	እስከረፋዱ ድረስ ስፅፍ ቆየሁ።
Double Click cookies contain no personally identifiable information.	የ DoubleClick ኩኪዎች በግል ሊለይ የሚችል መረጃ የላቸውም ።
Ourselves knowing each other.	እርስ በርሳችን እንተዋወቃለን።
9 This is the story of Noah: Noah was a good man, an upright man among his contemporaries, and he walked with God.	9የኖኅ ታሪክ እንደሚከተለው ነው፤ ኖኅ በዘመኑ ከነበሩት ሰዎች ሁሉ ይልቅ ጻድቅና ከበደል የራቀ ሰው ነበር፤ አካሄዱንም ከእግዚአብሔር (ኤሎሂም) ጋር አደረገ።
When the solution is so effective that the problem never existed, who will need to think of a solution?	ክርክሩ የተነሳው በ ህገ መንግስት ውስጥ ፈጽሞ ባልተካተተ ጉዳይ ላይ ከሆነስ መፍትሄ የሚሰጠው ማነው?
What are the international human rights organisations doing?	የሰብዓዊ መብት ድርጅቶች ምን አሉ?
"I'm not somebody who has studied it."""	እኔ እንዳንቺ ያጠናሁት የለም››
So, there is a fair possibility that Google may share some breadcrumbs of its new generation technology piece.	በእውነቱ ፣ ለእንዲህ ዓይነቶቹ የመጫኛ ዘዴዎች ጉግል Google ሊቀጣዎት የሚችልበት ዕድል አለ ።
I don't see where the problem is...	ችግሩ የት እንዳለ አላየሁም....
I'm now nearly 6 months.	አሁን አሁን 6 ወር እርጉዝ ነኝ.
Muscular endurance training that is designed specifically for dental professionals is critical for preventing neck and back pain.	ትምህርት በመስጠትና በየጊዜው ምርምራ በማድረግ ላይ የተመሠረተው በመከላከል ላይ ያተኮረ የጥርስ ሕክምና የጥርስ ሕመምንና የጥርስ መውለቅን ለማስወገድ የሚረዳ ወሳኝ መንገድ ነው።
I am an apostle from the Lord of the Worlds,	ምንም መሳሳት የለብኝም፤ግን እኔ ከዓለማት ጌታ መልክተኛ ነኝ።
Question: What are the airlines' rules about the number and size of carry-on bags?	ጥያቄ የብየዳውን ተሽከርካሪ መጠን እና ክብደት ምንድነው?
As a teenager I battled with body image issues and by the age of 17 I had been admitted to an eating disorder hospital.	ከአልኮል ነፃ ፀረ-ተባይ መጥረጊያ
Please be reassured that the health, safety and welfare of our students and staff are of utmost importance to us.	የተማሪዎቻችን፣ የሰራተኞቻችን እና የቤተሰቦቻችን ጤና እና ደህንነት እጅግ አስፈላጊ መሆኑን እባክዎ ልብ ይበሉ።
He didn't cite a new estimate.	አዲስ ግምገማ አላስቀመጠም።
The day when all the	ሁሉን የሚገዛበት ቀን
And a lot of migrant workers also stuck and waiting for help from the government.	የስራ ባልደረቦቼም መጠባበቅ ትተው እየሰሩ ነው።
God created her in His image and likeness.	እግዚአብሔር እንደፈጠረው በአምሳሉ እና በአምሳሉ ነው ።
They do not consider themselves as owners of the land, but as caretakers.	ያላዩት ፡ አገር ፡ አይናፍቅም ፡ እንደሚሉት ፡ ሰዎች
The ICRC has no idea who kidnapped their employees.	ኦዴፓ አስኳል ጉዳይን የቤት ሥራውን ለማን እንደሰጠው አያታወቅም።
"To the extent, however, that French law is silent, the Vienna Convention would fill the gaps."""	"ቢቸግረው ጣሊያን አለ ፎርሳ ፎርሳ"""
Participants, especially the experienced trial attorneys, tended to give less weight to predictions made by others, and in the process, failed to benefit from the aggregation.	በህዳሴ ግድብ አስተዳደር ላይ ይታዩ የነበሩ ችግሮች በቀድሞ ሚኒስትር ዕይታ
This exercise ought to be done with regard to five minutes, every few hours.	ይህ ልምምድ ለአምስት ደቂቃ ያህል መደረግ አለበት, every few hours.
The church is no bigger than a congregation.	ሆኖም ፣ ቤተክርስቲያን እንደ ትልቅ ጉባኤ ተግባሮ congregationን መውሰድ የለባትም ።
21 me the money.	የተቀረው ገንዘብ 21.
To do this, use the following command line.	ይህን ለማድረግ የሚከተለውን ቅደም ተከተል ይጠቀሙ።
It took six days to learn.	ለመማርም ስድስት ወራት ነው የፈጀባት።
Chapter 6: Wednesday Is Spiraling Out of Control	ረቡዕ: የተጎናጸፈውን ሚስጥራት
"The Byrds - ""Wait and See"" lyrics"	"msgstr ""ይመልከቱ እና ይዳብሱ"""
I should obey the Ten Commandments.	በተረፈ አስርቱን ትእዛዛት በአግባቡ ነወ የምጠብቀው።
He pulled out the keys to the car and spun them around his finger.	የመኪናውን ቁልፍ አሹሎ፣ አንዲከተሉት በእጁ እየጋበዘ ፡-
9 - Staying On-Site	1 - የሚቀመጥ መሆን
Time is crucial to you and us as well.	ጊዜ እንደ እናንተ እንዲሁም ለእኛ ዋነኛ አስፈላጊ ነው.
I don't fit in nor belong in your society.	አንተ ውስጥ አለ ወይም በግድ ይኑር አላልኩም።
The apostles did not fully comprehend many of the prophecies that related to Jesus to prove that he was the Messiah.	ሆኖም በወቅቱ ብዙዎቹ አይሁዳውያን የአምላክን ስም መጥራት ተገቢ አይደለም የሚል አጉል እምነት ስለነበራቸው ሌሎች ምትክ ስያሜዎችን ይጠቀሙ ነበር።
Return from the Sun:	ተመልሰው ይምጡ: ፀሐይ:
an average month is 30 days.	በአማካኝ አንድ ወር ፴ ቀን ይሆ.
There is a new website in development	አዲስ ድረ ገጽ በስራ ላይ ዋለ
"He thought, ""I am a servant of Christ."	"ይህም ""እኔ የሽሪ ክርሽና አገልጋይ ነኝ።"
Now that the relationship is broken, how can I deal with the 280000 I want to get back?	አሁንም ቢሆን ችግር ፈጣሪ አለብኝ, የሚያስተላልፉት የ 8000 ማጣቀሻዎች ሲኖሩ ምን ማድረግ እንዳለብኝ .
"The cottages offer a ""home away from home"" feel, We can't say enough good things!"	"""ባላዋቂ ቤት እንግዳ ናኘበት"" የሚለው አባባል በኛ ላይ መፈጸሙ ያብቃ እስኪ!"
Recruit new consultants to earn more money.	ተጨማሪ ገንዘብ ለማግኘት አዳዲስ ተመልካቾችን ይሳቡ!
Furthermore, we, as spectator, are challenged to use our own creativity and thus contribute to the creation of the final image.	ያም ሆኖ ወጣትነት የራሱን መልክ ይዞ ብቅ ሲል ሕይወት በምትሰጠን ምርጫ ራሳችንን እናስጉዛለን።
inviting with smiles because it is a lover.[81]	ፍቅርን ለማጋራት እዚህ በቀላሉ ፈገግ ያለ ጎብitor (
The way I left you	ብዬ የወተወትኩህ
I remember nothing of what I've read.	ምን ላይ እንዳነበብኩት ለጊዜው ትዝ አይለኝም።
"Nobody wants to alive in that world."""	"""ዓለም ላይ ማንም በዚያ መልኩ መኖር አይፈልግም።"
Alas my hardware wasn't quite up to the task.	ሕክምናውን አጠናቅቅ
He has already shown me what he is made of.	አስመላሽ አሳየኸኝ (ወዲ ምህረት) የተደረገውን ያውቃል።
The S bit enables the setting of the conditions in the particular instruction.	ዲም ትምህርቱ እንዲሰጥ ቅድመ ሁኔታዎች በመመቻቸት ላይ ናቸው።
What that comes down to, if you are at a one, you are equal to others that do the same thing in your industry, in terms of loss ratios.	ያን ስታወግዝ በውግዘቱ ውስጥ ያንኑ አንተ የምትፈጽመው ከሆንክ እኩል ለኩል ነው።
These types of games are very popular all over the world.	ጨዋታ ርዕሶች እንዲህ ዓይነት በጣም በመላው ዓለም ግለሰቦች መካከል ታዋቂ ናቸው.
Trustworthiness The correct answer is B. Each of the other choices depends on the perceptions of others.	ስልጣን ወደ እምነት ይመራል - መተማመን እያንዳንዱ የቢ 2 ቢ ገዢ ውሳኔውን የሚወስንበት መሠረት ነው ።
These are difficult to prepare.	እነዚህ ደግሞ ዝግጅት ማድረግ ከባድ ነው.
caused a lot of guilt in your heart.	በብዙ ነገር ከልቡ አዝኖብሃል።
Maybe because I have that feeling ingrained in me by my mother to clean up before having people over, and by the mission my Lord has given me, I do plan on having people over.	ህልሜን አምላኬ የነገረኝ እኔነቴን ሰሞኑን እንደተዘጋጀሁበት ረጋ አብዬ አወራዋቸው .
simple non programable line follower project for all engineering students.........	የቡርና የማያቋርጥ ባቡር ፕሮጀክት ለፖለቲከኞች ብቻ...
"We, the ones who from heaven to earth came."""	ከምድር ለሰማይ ቀረብን።
With the way PS4's are selling, they have no need to whip up a money-saving bundle.	ሆኖም የ PS4 ባለቤት ከሆኑ አንድ ሳንቲም ማውጣት አያስፈልግዎትም።
People ridicule fetishists behind their backs, and I'm afraid of being lumped in with them.	ወደ ከለዳውያን በኰበለሉት በአይሁድ እጅ አሳልፈው ይሰጡኛል እነርሱም ያፌዙብኛል ብዬ እፈራለሁ አለው።
"We call the them ""the big three."""	"እነርሱንም ""Big Three"" ይሏቸዋል።"
Our God is the God of rightness.	አምላካችን ትክክለኛ አምላክ ነው ።
Initially, there were two hundred officers involved in the foot search though that number was reduced to 150 within the first few days.	ሦስት ሺ ሁለት መቶ ስምንት አስር አንድ
I think you can go another layer in on the app.	እርስዎ መተግበሪያው ላይ ማድረግ ትችላለህ ሌሎች ነገሮች:
Nothing is left of the avalanche of crumbs by the time it reaches my feet.	ዳርሊን በፍጥነት ሮጣ ላይ እስክመለስ ድረስ እግሮቼን ለመንከባከብ እስኪያግዙ ድረስ አንድም ጡንቻ አይንቀሳቀስም.
"Then they started again and she started ""assuming the position."""	ዳግመኛም አስተውሉ 'እንግዲህ' ብሎ መጀመሩን።
On the offense, the most important returning player in my eyes has to be Mark Walton.	ይህንን ስናገር በሃሳቤ ያለው ታላቁ የነፃነት ታጋይ ማርከስ ጋርቬይ ነው።
Hats Off on the consistency of the team !	ተባብረን ወያኔን እናስወግድ!
Don't do this disgraceful deed!	እንዲህ ያለውን አሳፋሪ ድርጊት አትፈጽሙ።
"He nodded and said: ""Were you following me?"""	""" ስለው አፈር ብሎ ""ምክሬን እንጂ አድራጎቴን አትከተል አላልኩህም?"
Preview from 00:00:00 in the timeline.	00 ሰዓታት ውስጥ ማሳያው ላይ ሊደረግ.
"""Now let's find out if I'm pointing this rocket launcher the right way!"""	""" ""እንግዲህ አሜሪካን እዚህ አመሳስሎ መጀመር አለብን ባይ ነኝ!"
I'm his friend, and friends support each other.	እኔ ድጋፍ አደርግለታለው፡፤የቡድን ጓደኞቹም እንዲሁ ከሱ ጋር ናቸው።
"""I don't understand what's wrong with my bosses!"	"""ጥፋቴ ምን ላይ እንደሆነ አልገባኝም ጌቶች!"
Let's make this year a success in preventing the number of eating disorders, raising	ያልተስተካከሉ ነገሮችን በማስተካከል የጎደሉ ነገሮችን በማሟላት ያልተመቹ ነገሮችን በማመቻቸት ይህን ዓመት የውጤት ዓመት እናድርገው።
local short form: Côte d'Ivoire	ገንቢ: ጎርኩğ ዩላ
If we decide not to make direct payments to you, or to recover an overpayment from you, you can appeal.	እኛ ደግሞ ገቢዎ እርስዎ እንዲፀድቁ ወይም ገቢዎን ለመጨመር እቅድ ለማውጣት የማይችል ከሆነ እነግርዎታለን ።
Your body weight is another aspect you need to take into consideration.	ሌላ ልብ ልትይው የሚገባሽ ክብደትሽን ነው።
"""If I lose, though, Voldemort will be against you."""	ተስፋ ፡ ቢስ ፡ ሆኜ ፡ አልቀረሁም ፡ አከብርሃለሁ
a request for advance in wages.	የደሞዝ ጭማሪ የሚጠይቅ ዘመቻ።
"Yesterday morning, as I left for school on what was the last day, I turned on the radio and heard the song, ""I am Redeemed."""	"አንድ ቀን ጧት ወደ ትምህርት ቤት እየሄድኩ ሳለ ""ፍስሃ"" የሚል ጥሪ ሰማሁና ዘወር አልኩ።"
He said Zimbabwe could also learn a lot from the former Spanish colony in the areas of science and research, agriculture and tourism.	እንዲሁም ኩባ በትምህርትና በሳይንስ እንዲሁም በእርሻ ለአገራችን ምጣኔ ሃብት የበኩሏን ደርሻ ልትወጣ ትችላለች።
How long you sleep in the day time?	"""በቀን ውስጥ ምን ያክል ሰአት ትተኛለህ?"
However, we have to wait and see whether this turns out to be true or not.	ግን ይህንን ማጣራት እና እውነት መሆኑን እና አለመሆኑን መለየት አለብን።
He came to cure the sick and poor in spirit and to heal our souls and restore our relationship with God.	""" ያ ሰብነውም፤ ያለመነውም፤ ቀልባችንም፤ መንፈሳችንም ተስፋችንም እንዲያርፍ ከለመነው ቦታ ፈጣሪ ቀብቶልናል።"
Certain factors such as the number of battles, the number of times they've killed the player, and the number of times they've cheated death are major influences, however.	እሺ ጊዜ ይሰጥ ግን ስንት ገለው ይብቃቸው፣ ኮታቸው ስንት ነው  ስርዓቱ እያለ  መግደል አያቆሙምና ደግሞ እሳቸው ስንት እስኪገሉ እንያቸው  ነው ያለው ገጣሚው።
When these were publicised the police went to the house again and issued threats.	ህዝቡ ሲሸሽ እንደገና ቤት ለማፍረስ ሲሄዱ ህዝቡ ተመልሶ በድጋሜ ተቃውሞውን ገልጿል።
Pregnant women should not use this ointment.	እርጉዝ ሴቶች ይህንን የምርመራ ዘዴ መጠቀም የለባቸውም።
Forty-three percent of the chains offered high-fat milk.	አርባ ሶስት በመቶ ያህሉ ደግሞ ለፍጆታ የሚውሉ የወተት ተዋፅኦዎችን ለማምረት ውሏል።
BETH LAST: I am so honored to be deplorable enough to receive a personal invitation from president Trump!	ማስታወሻ: ውይይቱ መጀመሪያ በወሰነው ጠባብ መዋቅር ውስጥ ሙሉ በሙሉ ማምለጥ መቻሌን በደስታ እገነዘባለሁ ክሪስቶፍ!
i'll put up a photo of him!	ፎቶ ልልክልዎታለሁ!
I've tried everything and I think your suggestions are the best.	ሁሉም ሰው እንዲሞክራት ሀሳብ አቀርባለሁ እናም የእሷ ትንበያ በጣም ትክክለኛ ነው ።
"Am I not more than ten sons to you?"""	ከአሥር ልጆች አልሻልልሽምን ወደ እኔ አልበልጥብሽምን?
Sometimes you may find it difficult to talk to family and friends about certain issues.	አንዳንድ ጊዜ የቤተሰብ ወይም ጓደኞች ጋር የተወሰኑ ነገሮች ማውራት ዓይነት ከባድ ነው እናውቃለን.
Sometimes it can be because of bad blood circulation.	አንዳንድ ጊዜ ደግሞ የደም ስሮች በመጥበባቸው ምክንያት ሊሆን ይችላል።
So there has to be function, the function has to be predictable	በእውነቱ ማስነሳት ነው ፣ ግን ስርዓቱ አስቀድሞ የሚሰራ መሆን አለበት .
Unity has the largest community.	አንድነት ምርጥ ማህበረሰብ ነው።
Just over a third of passengers (36 percent) have experienced the use of biometric data when traveling.	ከተሳፋሪዎች አንድ ሦስተኛ በላይ የሚሆኑት (36%) በሚጓዙበት ጊዜ የባዮሜትሪክ መረጃ አጠቃቀም አጋጥሟቸዋል።
"He said: ""As the Father sent me, so I am sending you."""	"""አባቴ እኔን እንደ ላከኝ እኔም እናንተን እልካችኋለሁ"" በማለት ይናገራል።"
It may seem successful for a time.	ለጊዜው የተሳካላቸው ይመስላቸው ይሆናል።
Why did they not fulfill their responsibilities at that time?	በወቅቱ መወሰድ የሚገባቸውን እርምጃዎች ለምን አልወሰደም?
They're all in her 10-year-old heart.	የሚኖሩት ከ10 አመት ልቻቸው ጋር ነው።
I'm gonna testify all over the world	መሠክራለሁ ለአለም ሁሉ፣
They can't sleep when they want to.	ሰው በፈለገው ጊዜ መተኛት አይችልም።
Still, we should remember that our health and well-being depend on us as individuals and communities.	ዛሬ የገጠመን አደገኛና ህልውናችንን፥ እንደ ህዝብና ሀገር የሚፈታተን ሁኔታ መሆኑን ጠንቅቀን መገንዘብ አለብን።
Otherwise, any excess of anger causes a visible increase in the production of certain hormones.	በተጨማሪም, ማንኛውም ከልክ ያለፈ ቁጣ አንዳንድ ሆርሞኖችን በማምረት የሚታይ ጭማሪ ያስከትላል.
i would like to, but who is Oliver? should i know him?	እንዳሉት እንዲሆን ምኞቴ ነው፣ ግን ስምዎን ማን ልበል?
By the end of June 2015, 1.	በሰኔ 2015 መጨረሻም ላይ ባንኩ ብር 1.
Any Urhobo man who fails to see it from that perspective is an enemy of Urhobo.	አሁን አንድ ሰው ይህን ያልገባው ጉለሌ ኦሮሞ ነው ቢል ይሳዝናል ።
In 2012, Dan Cathy made his opposition to same-sex marriage known publically, and this caused a national uproar.	በ 2012 ውስጥ, ዳኒ በቃላት በማይነጣጠሉ ሰርቢያውያን የዘረኝነት አቀንቃኞች የተቀበለበትን አሰቃቂ ስሜት ገልጸዋል, ይህ በሚከተለው ላይ በመግለጽ አስጸያፊ ነው.
You will know some details about their life.	ስለ ሕይወትዎ ዝርዝር ጉዳዮችን ያውቁ ይሆናል።
How is it that a relatively small group of oppressors (the famed 1%) can control a large group of oppressed?	እንዴት ነው 8% (ለምሳሌ) ድጋፍ ያለው ቡድን ሃገርን መቆጣጠር የሚችለው?
We're not afraid to make mistakes.	ስህተት እንሠራለን ብለን አንፈራም ።
What does it mean to you, then, that each of you have even climbed to the rooftops?	ይህ ለአንተ ምን ማለት ነው, እንግዲህ, ከእናንተ እያንዳንዱ እንኳ ጣሪያ ላይ ወጣ መሆኑን?
So, what is the Alliance for a New Humanity?	ስለዚህ አዲስ ትግበራ ምን ያስባሉ?
"He said, ""Grab him!"""	""" አለ ዋርካ ፍርሃት እያራደው።"
"You are my help and deliverer."""	"አንተ ረዳቴና አዳኜ ነህ"" በማለት ዘምሯል።"
Testosterone Enanthate, on the other hand, is required to be administered every week due to shorter esters though its effects are quicker than Sustanon.	ቴስቶስትሮን ኤንታንት በበኩሉ ውጤቱ ከሱስታኖን የበለጠ ፈጣን ቢሆንም በአጫጭር ኢስቴሮች ምክንያት በየሳምንቱ መሰጠት ይጠበቅበታል ።
burn for more than 1,000 hours.	ከ 1000 ሰዓታት ያህል ብቻ ይነዳ።
This level is exceptionally high compared with other provinces.	ይሄ ከሌሎች ክልሎች ጋር ሲነፃፀር ቁጥሩ ከፍተኛ ነው።
Although Spring is officially only 3 months each year, it can last all year.	ወንዙ ለሦስት ወራት ብቻ ነው ከዚህ ቀደም ይፈስ የነበረው፣ አሁን ግን ዓመቱን ሙሉ ይፈሳል።
It is not recommended to drink alcohol while using opioids.	ኤስኤስአርአይ ወይም ቤንዞዲያዛፔን በሚጠቀሙበት ጊዜ አልኮል መጠጣት አይመከርም ።
2 Chronicles 32:13 (NRS) Do you not know what I and my ancestors have done to all the peoples of other lands?	2ኛ ዜና መዋዕል 32:13 - Correct Me እኔና አባቶቼ በምድር አሕዛብ ሁሉ ያደረግነውን አላወቃችሁምን?
Our EBP60 Trailer-Mounted Concrete Pump is produced in high quality according to the needs of the Concrete Machinery sector.	ዲ ተከታታይ የኤሌክትሪክ አግድም ድርብ መምጠጥ የእሳት ማጥፊያ ፓምፕ ስብስብ በእኛ የገቢያ ፍላጎት መሠረት በእኛ ኩባንያ የተሠራ ምርት ነው።
Five hundred years after the historic	ሃምሳ ዐመታት የኋሊት
He left his family for years at a time to fight in a far away land.	እሱ ከትውልድ አገሩ ርቆ በሚገኝ አንድ ትልቅ ስራ ላይ ለመሳተፍ ቤተሰቡን ለበርካታ ዓመታት አሳልፏል.
It is designed to stand up instead of lying down or rolling on top of the other pieces.	ዝም ብሎ በመገፋፋት ወይም በሌሎች ቦታዎች ላይ እንዲወድቅ ከማድረግ ይልቅ ያንን አቧራ ይይዛል ።
That is normal but nonetheless disappointing.	ይህ የተለመደ ነገር ግን ተስፋ አስቆራጭ ጉዳይ ነው.
Because after all, when we're struggling to maintain connections with others, the last thing we want is to lose touch with ourselves.	ለነገሩ ሁላችንም የአንድ አካል ብልቶች ከሆንን፥ ከሌሎች ብልቶች ጋር የሚኖረን ግንኙነት በመጨረሻ እኛንም በግል ይነካናል።
Then, once you do get to the top position, you will live in fear because you have so much to lose.	አንዴ ከደፈርህ ደግሞ ብዙ የኖርክበት ነገር ነውና ተመልሰህ አትፈራም።
The language allows error handling that way.	ፍጅትን የሚያስከትል ስሕተት በዚህ መልክ ይፈፀማል።
There is no dispute as to the first statutory predicate.	የመጀመሪያው የሽግግር መንግስት ለማለት የሕግ መሠረት የለንም።
The man smirked as he pulled out a scroll from one of his pockets, and motioned them to walk over to him.	ወጣቱም እንደታዘዘው ባደረገ ጊዜ ከሰይጣናት አንዱ መጥቶ ወደ አለቃቸው አደረሰውና ያችንም የክህደት ደብዳቤም ከእጁ ወሰዳት።
These are the Monday, July 27, 2020 winning numbers for Lucky For Life.	እነዚህ ሐሙስ ሰኔ 25 ቀን 2020 አሸናፊ ለህይወት ዕድሎች ናቸው ።
Cook in chicken broth until tender, about 10 minutes.	እስኪቀዘቅዝ ድረስ ነጭ ቸኮሌት ተዘጋጅቷል ፣ 10 ደቂቃ ያህል።
That's pretty amazing in this day.	በጣም ያስገርማል ዛሬ ማታ።
Now the liquidated gypsies are a respectable fraction of the Soviet Union.	ኢትዮጵያ አባይ የተፋሰሱ አገራት የጋራ ሃብት ነው።
10:33 Thus the word of your Lord is fulfilled concerning the transgressors that they shall not believe.	10|33|እንደዚሁ የጌታህ ቃል በእነዚያ ባመጹት ላይ እነርሱ የማያምኑ መሆናቸው ተረጋገጠች።
There the lady served for about four years in two presidential Administrations.	እኚህ ሰው አራት ኪሎ ከሚገኙ የመንግስት መስሪያ ቤት በአንዱ ለበርካታ ዓመታት የሰሩ ናቸው።
Aerial view of Salvador.	አርማንዶ ሳልቫዶርመልዕክት.
Have mercy on me, O good Lord,	ለንስሓ አብቃኝ አቤቱ ጌታዬ
beg for bread are therefore not true.	ዳቦ ይቀድማል ብሎ ነገር ትክክል አይደለም ባይ ናቸው።
"I'm a Mexican, not a Mexican't!"""	እኔ ሜክሲኮአዊ እንጂ ጥቁር አይደለሁም!
but the will of my father who has sent me.	የላከኝ አባቴንም እንቢ ማለቱ ነው።
Tell me who (who), can stand it (who)	የሚያግደው ፡ እስኪ ፡ ማነው
Two nonzero vectors a and b are perpendicular if and only if ab = 0.	ሁለት መጠናቸው ዜሮ ያልሆኑ ቬክተሮች a እና b ትይዩ የሚሆኑት a × b = 0 ከሆነና ከሆነ ብቻ ነው።
Don't mess with females!	ሴቶችን አታማርር!
and finished his life there.	ኑሮውንም እዚያው አደረገ።
Rattling clean website, thank you for this post.	በእውነቱ የበይነመረብ ጣቢያን ግልፅ ያድርጉ ፣ ለዚህ ጽሑፍ እናመሰግናለን።
But I have to run the race first.	ግን በመጀመሪያ ወደ ምርጫው መሄድ አለብኝ ።
"""Mr. Rudolf, you need to control your righteous indignation."""	‹‹አቶ ሪርደንይህ አካሄድ ራስህን የመከላከል መብትህን ያጣበዋል››
People in the region are afraid that the groups have plans to pretend they are fighting each other, in order to displace the local peasant farmers.	ተቃውሞውን በመፍራት ይመስላል የአካባቢው ተወላጆች እየተባረሩ የጉልበት ሰራተኞች ከአንድ አካባቢ ብቻ እንዲመጡ እየተደረገ መሆኑን ሰራተኞች ይገልጻሉ።
"13 And again, ""I will put my trust upon Him."""	"13 ደግሞም ""እኔ እምነቴን በእሱ ላይ እጥላለሁ"" ይላል።"
The book contains five tales.	መጽሐፉ አምስት ታሪኮችን ይዟል።
He brought them forward as much as he could and admired the work that Reid had done on them.	25 እነዚህንም ይህንም የሚመስለውን ሥራ የሠሩትን ሰብስቦ እንዲህ አላቸው።
Warren Neidlich's black-and-white photographs are arranged in four parts.	የአቶ ንጉሤ የክርና የቀለም የሥዕል ሥራዎች በአራት ምድብ የተከፈሉ ናቸው።
We have our own Poly hose to produce seedlings of all kinds.	ለሁሉም ዓይነት እህል ተመሳይ ሙቀጫ የምናቀርበው የኛ እንጂ።
Let the thunder of God locate and destroy the throne of witchcraft in my household, in the name of Jesus.	አንተ የእግዚአብሔር ነጎድጓድ ፣ በቤተሰቤ ውስጥ የጥንቆላ ዙፋን አግኝ እና አፈርስ ፣ በኢየሱስ ስም ።
you know our innermost being better than we know ourselves.	ውስጣችን ከእኛ የበለጠ አዋቂ ነው ።
"Face ""Baking"" is not new."	›› መባባል አዲስ አይደለም።
"prove him: for he himself knew what he would do"" (John 6:6)."	ራሱ ሊያደርግ ያለውን ያውቅ ነበርና ዮሐንስ 6፥6
It remained a highly rated VPN service for quite some time.	ይህ ደግሞ አንድ ለተወሰነ ዙሪያ ቆይቷል አንድ የላይኛው ክፍል VPN አገልግሎት ነው.
An object-based file system is the foundation of the New Wave environment.	FOEN Ground Screw ለመሬት መወጣጫ ስርዓት አዲሱ የመሠረት መሠረት ነው።
What about Satanism and the use of magic?	የገዳማቱና አድባራቱስ?
Who wants to see us divided and fighting with each other?	እርስ በርሳችን በመነቃቀፍና በመለያየት ማን ይመስለናል?
I have been staying here since 2003 and have never had occasion to regret.	ከ 2003 ጀምሮ እራሴን አስተናግጃለሁ እና አልጸጸትም ።
Meanwhile, expeditions were sent out under the auspices of various governments.	ገጽ ለማውረድ አሁን ተከናውኗል
special letters (such as Ƿ Þ Ð Æ Ø W IJ).	ልዩ ደብዳቤዎች ።
those who stay remembered.	ብለው የዘፈኑትን ያስታውሱዋል።
It's only Men.	ሰው ብቻ ናቸው።
"The fear of the Lord tendeth to life, and he that hath it shall abide satisfied; he shall not be visited with evil"" (Proverbs 19:3,23)."	እግዚአብሔርን መፍራት ወደ ሕይወት ያዘነብላል: ያለውም ይረካል; በክፉ አይጎበኘውም (ምሳሌ 19:23)
All of this is a great pity and a great crime.	ይህ አስጠያፊ በደልና ታላቅ ወንጀል ነው።
They are expressing God's wrath and preaching Justice.	በፍትህ ሲጨቆኑ እና እግዚአብሔር እንዲያጸናዎት ሲፈልጉ ።
Indeed, the game turned out to be simple...	እንኳንም አደጋው ቀላል ሆነ ....
A minute of maximum sustained winds to the region of around 185 km is brought by Typhoon Parma.	የእሳት ወደ አስመራ ጉዞ
Television journalist who hosted his own show on MSNBC.	መህዲ ሁሴን በ MSNBC ቲቪ ስራውን በመስራት ላይ እያለ ።
Come to think of it, X20.	በቅርቡ ይወያዩ ፣ XXXXX።
One can't even make sense of what's written.	አንዳንዱ የጻፈውን እንኳን ማስረዳት አይችልም።
"""I have been exalted and cast down and confounded."""	- ተለከፈ {ተነጀሰ፥ ተለከፈ፥ ተነቼ፤
My brother-in-law currently lives with us.	በተለይ የእኔ ልጅ አሁን ከእኛ ጋር ሆናም ጎመን እያመረተች ነው።
And then I saw that people would pop into existence all over the plain, and some would see the city and the gates and the hideous angel and rush towards it.	እርሱንም በዝንጉ ሕዝብ ላይ እልካለሁ፥ ምርኮውንና ብዝበዛውንም ይወስድ ዘንድ እንደ አደባባይም ጭቃ የተረገጡ ያደርጋቸው ዘንድ በምቈጣቸው ሰዎች ላይ አዝዘዋለሁ።
It is a beautiful time of prayer.	መልካም የጸሎት ጊዜ።
In times of war they have of course fallen to a minimum.	በእርግጥም ጦርነቶቹ በተወሰነ አድክመውን አልፈዋል።
This and other issues must be addressed in the policy.	በዚህና በመሰል ጉዳዮች ፖሊሲው መታየት አለበት።
was for a man to be quick-witted, if he would excel as a beggar.	በሰው ፡ አቆጣጠር ፡ ቢመስል ፡ የዘገየ
I seem to needy to learn more.	ከዚያ የበለጠ መማር እንደሚያስፈልገኝ ገምቻለሁ ።
But when stress is in the picture, it speeds up the aging process in your digestive system and you develop issues that are common in older people.	ቃለ ጽቅ ግን ሐሣቡን በሐሳብ መተቸት ሲገባህ አቅም በማጣትህ ማነህ ወደሚል ተራ ነገር ውስጥ ገባህ።
He didn't want anybody to see her except for him.	በስተቀር ማንንም ማየት አልፈለገም ።
And in some people's opinions, SUPERIOR to flesh and blood human beings.	በአንዳንዶች ዘንድ አጥንትና ደም እንዲሁም ስጋ ከሐይማኖትም በላይ እየተመለኩ መጥተዋል ።
supply jumped more than 50 percent in two years.	በጀቱ በ2 ዓመት ውስጥ ከ50 በመቶ በላይ እድገት አሳይቷል።
Partnering together to improve our community.	በጋራ ትብብር ማህበረሰባችሁን ለማሻሻል የበኩላችሁን አበርክቱ።
Staggering Images of the California Drought - You Won't Believe Your Eyes	7 የሚገርም የባሕር ዕይታዎች እርስዎ የማልታ አያምኑም
Do I have enough information to disclose on this topic?	በዚህ ርዕሰ ጉዳይ ዙርያ መሸፈን ያለብኝ የተሳሳተ መረጃ አለን?
"One View."""	"አንድ አስተያየት ሰጪ "" ."
This helps us lose weight in a short period of time.	ይህም በአጭር ጊዜ ውስጥ ክብደታችንን ለመቀነስ ይረዳናል።
Who has had the biggest impact on you in your life?	በህይወትህ ከፍተኛ ተፅዕኖ ያሳደረብህ ሰው ማን ነው?
There are three methods to find the dbx file corresponding to an Outlook Express mail folder, as follows:	ከአንድ ጋር የሚዛመድ የ dbx ፋይልን ለማግኘት ሦስት ዘዴዎች አሉ Outlook Express የመልዕክት አቃፊ እንደሚከተለው
It is a dream that depends on your feelings to find the correct interpretation.	ሕልምን እንዴት መተርጎም እንደሚቻል
"""What do you say about a King?"	"""በጉልበት ልትነግስ?"
It is their moment of truth.	የእውነት ጌጡ ጊዜ ነው።
3 All these ioyned together in the vale of Siddim, which is the salt Sea.	3 እነዚህ ሁሉ በሲዲም ሸለቆ ተሰብስበው ተባበሩ፤ ይኸውም የጨው ባሕር ነው።
The United States has welcomed the decision of the United Nations Security Council's 1267 al-Qa'ida and ISIL (Da'esh) Sanctions Committee on February 23, 2020.	የተባበሩት መንግስታት የጸጥታ ምክር ቤት መፍትሄዎች 1267/1989/2253 ISIL (Da'esh) እና የአልቃይዳ ማእቀቦች ኮሚቴ በየካቲት 2016 በማእቀቦቹ ዝርዝር ውስጥ ጨምሮታል።
More than 400 steps.	ከ 40 በላይ ደረጃዎች!
"He said, ""What time is it, back there?"""	"ጥራዙን) ትንሣኤን አስታኮ የሚለቅበት ምክንያት ""ትንሣኤ!"
What's the main challenge facing the four organizations?	የአራቱ ዋና ዋና ድርጅቶችስ ሚና እንዴት ይታያል?
Do you recall the UN resolutions condemning Israel that were blocked by his administration?	ወገኖችህ እስራኤል እንዲህ በፈቃዳቸው በመጥፋታቸው አዘንህን ?
"At another time, Jesus called out, ""Listen to Me, all of you, and understand."""	"በዚህም ምክንያት ኢየሱስ አድማጮቹን ""ሁላችሁም ስሙኝ፤ የምናገረውንም አስተውሉ"" ብሏቸው ነበር።"
I have nothing but good things to say about my dealer.	በእውነቱ ፣ ስለአሁኑ አሠሪዬ የምናገረው ከመልካም ነገር በቀር ሌላ የለኝም ።
13 And all the people shall hear and fear, and not be presumptuous any more.	13፤ ሕዝቡም ሁሉ ሰምቶ ይፈራል፥ ከዚያም ወዲያ አይኰራም።
If I never walk in darkness,	በጨለማ ፡ ቦታ ፡ ብሄድ
Login or use an immunohistochemistry to print a monkey.	ማሳየት ወይም ባለሙያ መሣሪያዎች አሞሌ ለመደበቅ ባለሙያ ትእዛዝ ይጠቀሙ.
If i get good enough grades, i'll be able to go to anime expo.	አንድ ጥሩ የምስል ማያያዣ ስርዓት ካገኘሁ ለነፋስ አንድ እሆናለሁ።
When your health is good, you have it all.	ጤና ካለህ ሁሉም ነገር ሊመጣ ይችላልና
The problems of this world are very real.	የዚህች ዓለም ችግሮች እጅግ ከባድ ናቸው።
Certainly not a 10k.	ስለዚህ ፣ ምንም የ 10 ሴ.
Conference-CD is a Windows (2000 or later) application.	የ Windows 2000 በማስኬድ (ወይም ከዚያ በላይ) ወይም ቢሮ 2000 (ወይም ከዚያ በላይ) የተጫነ ነው.
Why would anyone fear something that is not going to happen?	ለምንስ ነው የምንፈራው ነገር የማይደርስ የሚመስለን?
The Spirit reaches the depths of everything, even the depths of God: these are the very things that God has revealed to us through the Spirit.	"""መንፈስም የእግዚአብሔርን ጥልቅ ነገር እንኳ ሳይቀር ሁሉን ይመረምራልና ለእኛ እግዚአብሔር በመንፈሱ በኩል ገለጠው።"
He was born not in a poor family.	እርሱ የተወለደው በሀብታም ቤተሰብ ውስጥ አይደለም ።
"35"" of rain in 33 days."	3 ቀናት ላይ ከሚወርድ በረዶ ጋር 33.
And this fellowship is also with the Father and his Son, Jesus Christ.	+ ደግሞም ይህ ኅብረታችን ከአብና ከልጁ ከኢየሱስ ክርስቶስ ጋር ነው።
Although skies will be calmer after the 18 May there should still be showers every few days until the month's end.	የሸዋል ስድስቱን ቀናት ከዒድ አልፊጥር በኋላ አስከትሎ መፆሙ በላጭ ቢሆንም እስከ ወሩ መጨረሻ ድረስ መፆም እንደሚቻል በርካታ ዐሊሞች ይገልፃሉ።
And two of the three, only a few WR make them.	በጥቂቶች በስተቀር ቁጥሩ አሥራ ሁለት ተቆጠረ ።
"Expediency is mat's wisdom: doing right is God's."""	ሰላም፥ ጽድቅና እግዚአብሔርን የሚያስከብሩ ተግባራት የሚመነጩት ከዚህ ዓይነቱ ጥበብ ነው።
Something has caused these people to become monsters, and if the security recordings are to be believed, that something could be hiding inside any one of the survivors.	በዚህ መሀል ሞቅታ ቢፈጠርና ስካር ቢኖር ደግሞ ማንንም መመከት እንደሚችሉ ለራሳቸው ይነግሩታል።
"One of the ministers replied: ""Young man, sit down!"	""" ሲል አንድ ወጣት 'እንዲያ በል አንተ!"
Then don't put all your money into Equity Mutual Funds.	ሁሉንም ገንዘብዎን በሸቀጣሸቀጥ ዕቃዎች ላይ አይውሉ ።
At the risk of being a bore, I'd like to reiterate my point.	የሚነገረኝ ባገኝም ደስ ይለኛል።
The police official denied there's a breakdown of law and order in Marawi.	በኦሮሚያ ልዩ የፖሊስ አደረጃጀት አለመኖሩን የክልሉ ፖሊስ አስታወቀ
On the 2nd day..	በሁለተኛው ቀን ነበር .
It also analyses the shortage of US Dollars in the financial crisis.	በአገሪቱ የዶላር እጥረት በከፍተኛ መከሰቱንም ጠቅሰዋል።
The people are different in those two empires.	በነዚህ ሁለት አውራጃዎች የሚኖሩ ህዝቦች ናቸው ራዮች።
But in life, every end is just a new beginning.	በህይወት ውስጥ, እያንዳንዱ መጨረሻ አዲስ ጅምር ነው
to read the explanation.	መግለጫውን ለማንበብ
But the intention is to persuade the population to revolt against their own government.	ምክነያቱም ሕዝቡን በመንግስት ላይ ለማሳመጽ ሲባል ነው።
or someone who identifies himself as Brian?	ወይስ አደም እንደሚለው የገዛ ራሱን ለመበቀል ?
Home newton's second law	Home አስረጅ ኒውተን
Ikaria, the island of long life	የኢካሪያ ደሴት - የረጅም-ጊዜ ደሴት
The next train is expected to arrive in 15 mins.	የመጀመሪያው የባቡር ቧንቧዎች በ 15 እንደሚደርሱ ይጠበቃል.
"We invite them to sit in, and they say, ""Wow!"	"አፋቸውን በነጠላ ሸፍነው ""አይ የሰው ነገር!"
"Next week we have one new ""AAA"" release on Xbox One, but there are still a few surprises here and..."	"በዚህ ሳምንት በ ‹Xbox One› ላይ አዲስ የ ""AAA"" ልቀቶች የሉንም ፣ ግን እዚህ እና እዚያ ገና ጥቂት የሚያስደንቁ ነገሮች አሉ ።"
Since then there have been 38 Ministers for Works in 33 Governments.	ም ጀምሮ በኢንዱስትሪ ሚኒስቴር የተመረጡ 38 ፋብሪካዎች አሰራሩን ተግባራዊ አድርገዋል።
29th in the league, that stings!	ከ 60 ዎቹ ክፍሎች - ይህኛው ክበብ!
What is really going on inside your heart and mind?	ይሁን እንጂ በእርግጥ ልብና አእምሮ ውስጥ ምን እየሆነ ነው?
"""Where am I going to focus my energy?"	ትኩረቴን መሰብሰብ የምችለው የት ብሆን ነው?
14She has been like a merchant's ship that brings its merchandise from far away.	14 እርስዋ እንደ ነጋዴ መርከብ ናት፤ ከሩቅ አገር ምግብዋን ትሰበስባለች።
D3 Where It'S At	3 መርሳት የሚኖርበት የት ግጥም ማለት ነው
We also provide products such as debit cards, mobile banking and internet banking services.	እኛ እንደ ዴቢት ካርዶች እና የኤሌክትሮኒክ ገንዘብ ማስተላለፎች ያሉ እኛም የዱቤ ካርድ አለን።
A: T/T and Paypal is acceptable.	መ: ቲ / ቲ እና Paypal ተቀባይነት አላቸው ።
This media can then be played on users' televisions through the Wii.	በዚህ መንገድ በአጠቃላይ መደበኛነት በቴሌቪዥኑ ላይ እነሱን መጠቀም ይቻላል.
The garter is tossed by the groom.	አዝማሪውም ይያዛል።
"And He will reign over the house of Jacob forever, and of His kingdom there will be no end."""""	በያዕቆብ ቤትም ላይ ለዘላለም ይነግሳል፤ ለመንግሥቱም መጨረሻ የለውም።
Now after his coronation, there is an atmosphere of celebration among the workers.	በዚህ ጊዜም ለሰራተኞቹ ማስተናገጃ ድግስ ይሰናዳል።
"Jesus said: ""Whoever divorces his wife, except for sexual immorality, and marries another woman commits adultery."""	"ኢየሱስ ""በዝሙት ምክንያት ካልሆነ በስተቀር ሚስቱን ፈቶ ሌላ የሚያገባ ሁሉ ምንዝር ይፈጽማል"" ብሏል።"
It was in 1973 when we welcomed the first international students in our university.	ይህ ነበር 1973 እኛ ዩኒቨርሲቲ ውስጥ ለመጀመሪያ አቀፍ ተማሪዎች አቀባበል ጊዜ.
For whether we live, we live unto the Lord; and whether we die, we die unto the Lord; whether we live therefore or die,we are the Lord's.	""" እንዲኹም ደግሞ በአጸደ ሥጋ ኾነ በአጸደ ነፍስ ብንኾን እንኳ፦ ""በሕይወት ሆነን ብንኖር ለጌታ እንኖራለንና፥ ብንሞትም ለጌታ እንሞታለን።"
In actuality, the Spurs are already kind of moving on from him.	ለአሁኑ ዘመን ደግሞ ማርከሻው ከእዛው ከመዲናዋ አለላቸው።
It will be called true democratic government.	ጣሊያን እውነተኛ የግዢ መንግሥት ተብሎ ሊጠራ ይችላል ።
The top tax rate on long-term capital gains -- that is, returns on the sale of stocks or other investments -- would increase to 39.6% from 20%.	በረጅም ጊዜ የካፒታል ግኝቶች ላይ ከፍተኛው የታክስ መጠን - ማለትም የአክሲዮን ሽያጭ ወይም ሌሎች ኢንቨስትመንቶች ከ 20% ወደ 39.
And why aren't you saving Ukrainians from drug addiction and alcoholism?	መንግሥትስ ቢሆን የአረቄ ወይም የአልኮል መሸጫና መጠጫ ሰዓት ሥርዓት ለምን አያበጅም?
I'm sure that one day I'll succeed!	እኛ ተሳክቶልን ስንሰራው አንድ ቀን መቼም አይቀርም!
Till nowadays nobody knows what happened in the basement of this luxurious palace in December 1916.	በጥቅምት ወር 2015 በጣም መጥፎውን የቡንደስ ሊጋ የግብ ጠባቂነት ብልሹነት ባሳየበት በዚህ በጣም መጥፎ ቀን ምን እንደደረሰበት ማንም አያውቅም ።
"They cannot speak in ""his"" voice."	በ ‹ሆሄ› ስር መሆን አይችሉም ።
I will establish thy seed forever....	4'ዘርህን ለዘላለም እተክላለሁ፤
And finally, its doors were open for them!	በዚህ ጊዜ ግን በሩ ወለል ብሎ ተከፈተላቸው!
He would sleep with it every night.	በየምሽቱ ከእርሷ ጋር ይተኛ ነበር ።
We started this adventure together in 2014.	በመቀጠል የመጨረሻውን መነቃቃትን በ 2014 ውስጥ አብረን ሠራን ።
And with them, there was a fourth man.	ከእነርሱም ጋር ሌላ አራተኛ ሰው ይታይ ነበር።
Now there are additional units for women and mothers and children.	አሁን ለሴቶች እና እናቶች እና ለልጆች ተጨማሪ ክፍሎች አሉ ።
NANAKO: We'll keep the kittens for today!	Pokkaloh: መተግበሪያዎች ዛሬ!
But I'm originally from Jamaica.	እኔ መጀመሪያ ከጃማይካ ደሴት ነኝ ።
We shall be in prayer for you.	እኛም እንኳን በጸሎታች ወገን ለይተን አንተውም ።
We see Him and hear from Him and record what He reveals.	እርሱም ያያሉ ሁሉ ከእርሱ እናሳውቃለን ይስማ.
"They don't always want what they say they want to do."""	የጠየቁትን ሁሉ ማድረግም ተገቢ አይደለም›› ይላሉ።
That is, 74 males and 29 females - (Time expired)	አ 40 ወንድና 2 ሴት የአንድነት አባላት ታሰሩ (ስም ዝርዝራቸውን ይዘናል)
That is a decrease of 80% versus a year ago.	ይህ ከባለፈው ዐመት ተመሳሳይ ጊዜ ሲወዳደር በ80% የቀነሰ ነው።
their time together in face-to-face conversation free of distractions.	ሁሉም ነጻ መገለጫዎ ጋር ይገናኛሉ ነጻ ግምገማዎች.
The participation fee has to be fully paid with the first payment.	ካፒታሉ ግብር ከመጀመሪያው ክፍያ ጋር ሙሉ በሙሉ መከፈል አለበት ።
The fear of God is not terror or dread.	እግዚአብሔርን ፡ መፍራት ፡ ጠፍቶ ፡ የለም ፡ ወይ
So she discovered her whoredoms, and discovered her nakedness: then my mind was alienated from her, like my mind was alienated from her sister.	ግልሙትናዋንም ገለጠች ኅፍረተ ሥጋዋንም አሳየች፤ ነፍሴም ከእኅትዋ እንደ ተለየች እንዲሁ ነፍሴ ከእርስዋ ተለየች።
The Human Rights Watch statement came as the Security Council was expected to meet for a fifth round of reporting on the resolution - and at least 11 people were killed by the bombs overnight.	ኤኤፍፒ የዜና ወኪል በጥቃቱ ቢያንስ 11 ሰዎች መገደላቸውን ከአካባቢው የተገኙ ምንጮቹን ጠቅሶ መዘገቡን ያስነበበው ቢቢሲ ነው።
What is the Shona word for one-sidedness?	ምን በጣም የጣት ጸናጽል ስለ አንድ ጥንድ ስለ ?
Take delight in the happiness of others.	በሌሎች ደስታ ተደሰት!
"Who is this ""son of man""?'"	ይህስ 'የሰው ልጅ' ማን ነው?
women and men clothing,	የተለያዩ የሴትና የወንድ ደንብ ልብሶች፣
Thank You for Your salvation that protects us.	ሊያድነን ያነሳኸውን ምህረት እናመሰግንሃለን.
The other pattern is people who can not fall asleep.	ሁለተኛዎቹ ወገኖች የሚተኙት ለመተኛት የሆኑ ግለሰቦች ናቸው።
Tammuz, July 12.	ሐዋርያው ታዴዎስ ሐምሌ 2 12.
the people love me.	- ሰዎች ይወዱኛል።
"Take the origins of Pence's reference to the ""lunar strategic high ground."""	"""ተንደርበርድ ፍሪ ዳውንሎድ"" በሚለው አረንጓዴ አዝራር ላይ ጠቅ ያድርጉ።"
I'm allowed to argue against someone's opinion with my own.	እኔ የአንዲትን ሰው ተቃራኒ ንግግር አቀርባለሁ:
practical use in some cases.	አጠቃቀም በአንዳንድ.
How do you achieve balance between your mind, body, and spirit?	ሙስሊም በአካሉ፣ በአእምሮውና በመንፈሱ መካከል ይህን ሚዛናዊነት እንዴት ሊያረጋግጥ ይችላል?
"Money represents the power to buy the necessities, as well as the ""good things"" of life."	"ገንዘብ ሁሉን ነገር መግዛት ይችላል፤ ""ደስታንም"" ጭምር።"
We have not that possibility.	እኛ ያ እድል የለንም።
When acquaintances, friends, churches, or organisations send their New Year's wishes, they always write something...	"መቼ ቤተሰብ, ጓደኞች, አብያተ ወይም ክርስቲያን ድርጅቶች ያላቸውን የአዲስ ዓመት ምኞቶችን ላክ, እነሱ ሁልጊዜ የሚመስል ነገር ጻፍ: ""ይህ ዓመት ይሆናል..."
He hasn't known anyone for a couple of years now.	ሚያ ለጥቂት ዓመታት በይፋ ማንንም አላወቀችም ።
The long message should be a good idea if you want to dissuade people from leaving a msg. what is your phone number:-)	ይኼ ሁላ በጥባጭ ትተህ ከመነኩሴ የሚያጣላ ምን ኣይነት ጋኔን ተይዘህ ይሆን ወዳጄ:-)
Love with them.	ከእነሱ ጋር ፍቅር።
God bless you today, and everyday!	ዛሬም ዘወትርም እግዚአብሔር ይባርክሽ!
"In addition, Massachusetts is the only ""Right to Shelter"" state in the country, which protects families in crisis who meet certain criteria."	"በነገራችን ላይ በዚህ ደረጃ በወንጀል የሚፈለግን የፍርድ ቤት ማዘዣ የወጣበትን ሰው መንግስታዊ ሹመት እየሰጡ ለወንጀለኛ ""ህጋዊ"" ምሽግ በመገንባት በአለም ብቸኛ አገር ኢትዮጵያ ብቻ ነች።"
My midwife and relation: 12:33.	ሥልጣኔና እንጉርጉሮው ; 12:49 .
Now, I throw to you the same question: Why, do you think, we make the sign of the Cross?	ገመናዬ: ለምን ግድ ይለናል?
and beautiful, and so he gave his life for her; but the love of Christ for the	እሷን፤ የእግዜር ፍቅር እንጂ፣ የሰው እሳቱም
It's obvious that there is joy in both of them.	የሁለቱም ደስታ ያለው በሁለቱ ውስጥ ነው።
joy and healing to all of life.	አዝናኝ እና ለሁሉም ዕድሜ ፈታኝ!
first half until the final one-minute mark	መጨረሻ የተጠቀመው 1 ደቂቃዎች በፊት
In this essay, first published in 1932, Russell argues in favour of a four-hour working day.	ልጅቷ በ 1935 ራስል በተጻፈው መጽሐፍ ላይ በመመርኮዝ መፍትሄው በቀን 4 ሰዓት መሥራት ነው ወደሚል ድምዳሜ ትመጣለች ።
He's her best friends brother who's been away for three year.	እርሷ ታላቅ እህቱ ናት ፣ እርሷም በሦስት ዓመት ታልፋለች ።
"The principle - ""do not steal - you will not live."""	"ጉዳዩም ""እወርሳለሁ - አትወርስም"" የሚል ነበር።"
So wickedness can't rule them.	ክፋት ግን እርሱን ሊቈጣጠረው አይችልም።
What did you say that encouraged people to share their ideas?	ምክንያቱም ተቃዋሚዎች ካለፈ ስህተታቸው ተምረው ምን ያልህ ሕዝቡን አደራጅተዋል?
It is more likely that he intended to discipline the mind in thinking, so that by one's own thinking he would be enlightened and led to knowledge of his subject.	በራስ አስተሳሰብ በራሱ እንዲበራ እና ወደ ርዕሰ ጉዳዩ እውቀት እንዲመራ በአእምሮ ውስጥ አእምሮን ለመቅጣት ያሰበው ሳይሆን አይቀርም።
he meant by these words.	የሚሉትን ያካተተ ነው።
11 There will be great earthquakes, famines, and pestilences in various places, and fearful events and great signs from heaven.	11 ታላላቅ የምድር ነውጦች ይከሰታሉ፤ በተለያየ ስፍራም የምግብ እጥረትና ቸነፈር ይሆናል፤+ ደግሞም የሚያስፈሩ ነገሮች እንዲሁም ከሰማይ ታላላቅ ምልክቶች ይታያሉ።
Also, one should not be afraid of negative emotions and consider them as something terrible.	በተጨማሪም, አሉታዊ ስሜቶችን መፍራት እና እነሱን እንደ አስፈሪ ነገር መቁጠር የለባቸውም.
> input from I/O devices.	★ O ኤ መሣሪያዎች ማፈን.
God will be pleased with you; and you will live there forever.	አምላክ ፡ ከእናንተ ፡ ዘንድ ፡ ይሁን ፡ ለዘለዓለም
it's the stretching it's the breathing	ዋናው መተንፈስ ነው
Thus, so little time has been devoted to actual peace negotiations despite the passage of so many years.	በዚህም ሳቢያ ስምምነቱ ሰላም ሳይሰፍን ዓመታት አልፈው አሁን ያለንበት ወቅት ላይ ደረስን።
The route may be longer than we expected.	ጒዞው ከገመትነው በላይ ጊዜ ሊፈጅ ይችላል።
That was in sharp contrast to thriving life recorded at the site in the years before.	ደረጃ በጣም ይህ ቦታ ቀደም ነው
Don't be left out of a great night of entertainment!	ታላቅ የሳቅ ምሽት እንዳያመልጣችሁ !
