እቺ ቀን እንግሊዞች የአበሻ እጅ ሊይዙ መቅደላ ጫፍ ላይ ወጥተዉ አፍረዉ የተመለሱባት ቀን ናት...	"""Today is the day when Britain steps back from the brink, when we confront the bills from..."
ሕልምህ ሕያው ነው።	Your dream is still alive.
"""አለማትን ካለመኖር ወደ መኖር የጠራቸው በእግዚአብሔር ቃል ውስጥ ያለው የመፍጠር ሀይል ነው።"	'The creative energy that called the worlds into existence is in the word of God.
ወደ ቀጣዩ ነጥቤ የሚያደርሰኝ...	Which leads me onto the next step...
የባህል አስተዋጽኦዎን ለማንቋሸሽ ሳልፈልግ ብቸኛውን ምልከታ አጥብቄ እቆያለሁ ።	While they seem to shy away from direct engagement, I admire their staying power.
ያንብቡ እና ይጻፉ	them to read and write
ስለዚህም ሕገመንግሥቱ በአምስት ዓመት ይደረጋል በሚል ያስቀመጠው ግልጽ ድንጋጌ ነው።	We have a constitution which clearly stipulates a parliamentary term of 6 years.
በአሁኑ ወቅት የአካል ብቃት እንቅስቃሴ ካላደረጉ በቴላ የሚገኙ ባለሙያዎች የአካል ብቃትዎን ይገመግማሉ እና ብጁ እንዲያደርጉ ያግዙዎታል.	If you do not currently hold a license in ID, CompHealth's licensing team can help you with the processing and application.
‹‹ሆኖም አሁን ሁለት አይነት ክትባቶችን እየሰጠን ነው፤ ሦስተኛውንም የክትባት አይነት በቅርቡ መስጠት እንጀምራለን›› ብለዋል።	"""We are in the process of concluding our third viticulture certification series and can soon begin accepting applications for the next one."""
ኡጁሉ ፈራ, ሚስተር ጌታቸው, አልጋነሽ አልቴ,	Ulysses as an old man, in his bed,
← ቅድሚያ የሚሰጡዋቸውን ይገናኛሉ _ የሚሰጡዋቸውን ውይይት	Vienna, engaged in a conversation
ቁሳቁስ100% ኒው ቀናኒላንድ Wool ፣ ወይም ብጁ	Handmade of 100% New Zealand Wool pile.
በቅርብ ጊዜ ያልተነበበ መልእክት አሳይ የሰው ልጅ ሙቀት መታጠብ ካለበት ምንም ለውጥ የለውም	using the latest technology, there will be no smell to annoy the inhabitants of
ቀደም ሲል ብዙ ጊዜ ታስሮ ተፈታ።	He'd been arrested several times in the past and released.
ይህ መንግሥት ሁሉንም መንግሥታት ያጠፋና ለዘላለም ጸንቶ ይኖራል።	This is the Kingdom which will surpass all kingdoms, and which will remain forever.
ለሉላ ሎፔዝ መልስ ይስጡ	What's your message to Lola Luscious
የተማራችሁትንም መከለስ ተገቢ ነው።	It's essential that you use what you were taught.
ከ፡ ቀድሞው የሳጥንህ ባለቤት	Barata, former owner of the jewelry store
ይድረሰው አይድረሰው ባላውቅም በርካታ ደብዳቤዎችን ፅፌለት ሁሉ ነበር።	Although I didn't purchase everything on her list, I did end up ordering many of her suggestions.
ሳኡዲ አረቢያ የቀንደኛ የዋሀቢ እስላማዊ አክራሪ እምነት ተከታዮች ዋነኛ ሀገር ናት።	The Bengal Sultanate was one of the major Islamic states established after the Muslim conquest of the Indian subcontinent.
እሷ፡- እንሳደብ ካልክስ- ስድብ ባንተ ይብሳል	And then it hits you - it's the 'snap-snap' of someone's flip-flops chipping away at your sanity.
ከምንም በላይ ሕዝቧ እንጂ.	most of all, your people.
ተከታዮቹም ስሙን እንኳ ሲጠሩ አይሰሙም ።	fellows have never even heard his name.
ኬኒያና ኢትየጵያ ግዙፍ የትስስር ፕሮጀክቶቻቸውን እውን ማድረግ አልቻሉም	Kenya and Ethiopia are not really known for their large water reserves.
የተፃፈበት ቋንቋ ቋንቋ ብቻ ሳይሆን ባህልም ሆኗል።	acts as translator, not only of language but also of culture.
"""ፈልጌ አይደለም እንደዚህ የሆንኩት ."""	"""That is not the way it was."""
እዚህ ላይ, ተጨማሪ መረጃ / በወር $ 2.	Click here for more details. - Dues: $70/year.
ወደ አዲሱ የትምህርት ዓመት ወደ ሁለት ሳምንት የምንገባ ሲሆን ተማሪዎቻችን እና ሰራተኞቻችን ወደ ትምህርት አሰጣጥ ልምዶች እየሰፈሩ ናቸው ።	Now that we are at the end of our first two 'short' weeks of school, the students and staff are beginning to get used to our new building, and it feels as though the academic year has started in earnest!
"""የእኔ እዚሀ አገር 'እስካሁን' መኖር ሰበር ዜና የሆነበት ምክንያት ለምንድነው?"	"""Why 'withering' of local news landscape is dangerous for democracy."""
እንደ ሸማቾቹ ገለፃ ፣ 90% የሚሆኑት ሸማቹ የምርት ስሙ ጥቅሞችን የሚያስገኝ ከሆነ የባህሪይ መረጃዎቻቸውን ለማጋራት ፈቃደኛ ናቸው ።	According to The Shelton Group, 90 percent of millennials say they're willing to purchase from a brand when they trust that company's social and environmental habits.
ማስተማር መማር መሆኑን አውቃለሁ።	I know he is learning.
ዛሬም መብራት የለም።	There was NO light today.
አቶ ጌታቸው ረዳ የሸገር ካፌ ቆይታ ....	The performance was an important step toward the recovery of an ailing man whom Arturo...
The Theory of Moral Sentiments በተባለ ስራው ውስጥ የተሰጠው ሰፊ ማብራሪያ ለዚህ ዓይነቱ የአረዳድ ስህተት [...]	The Hidden Truth on Physic Theory The trouble with this [...]
ምን ላድርግ ጠፋችብኝ እኮ!	What did I have to lose!
እዚህ ግን ከሳምንት በላይ አልቆዩም።	but I did not spend more than a week here.
ከዛ በኋላ ደቡብ ፖሊስ ላይ የተሻለ ነገር ሰርቻለሁ።	I wanted to get more done on my Southern Cross next.
ቄስ በሪሁን እባላለሁ ተወልጄ ያደኩት ወሎ ክፍለ ሀገር ነው ።	Preparation: My bosom friend, Rana was born in a village.
ከንቲባው አንድ ጎብ visitor ፖሊሶቹን ይዘውት እንዲወስዱት ዛተው ።	Of course, a nosy neighbor took it upon themselves to inform the police.
አርፌ እንዳልተኛ አይመች አልጋዬ	I lay in my bed I don't sleep a wink
ቀጣይ አቅጣጫዎችንም አስቀምጧል።	has given other directions.
በውስጡ ሌሎች ገጽታዎች መካከል, ብዙዎች ግን ጨምሯል የፋይል መጠን ድጋፍ የሚሰጥ መሆኑን እውነታ ጋር ደስ ናቸው.	Another important aspect of content is its length, some people believe that the future of content marketing depends on more concise content.
21|43|ለእነሱ ከእኛ ሌላ የምትከላከልላቸው አማልክት አለቻቸውን ነፍሶቻቸውን መርዳትን አይችሉም።	So do we believe in a God who cannot or will not prevent our suffering?
"""ጦጣ ነው እኮ ያስመሰልከኝ!"	"""It makes me a whore!"""
ድጋፍ ማጣታቸውን በግልፅ ያሳያል።	This shows that they were losing public support.
ዲ ባንክ ወይ የባንክ ፍላጎቶቻችሁን አማራጭ እናቀርባለን ።	The first option would be to use your bank's Billpay or other bill payment options.
አንድ ሥልጣኔ እናሳድጋለን.	We're establishing authority.
በእርስዎ ፀልት ዎቹ ውስጥ አስታውሰኝ	You fashioned us from the depths of the earth and bid us to follow your gospel call in the company of the Church.
ኢየሱስም መልሶ እንዲህ አለው፦ ከትእዛዛቱ ሁሉ ፊተኛይቱ፦ እስራኤል ሆይ፣ስማ፤ጌታ አምላካችን አንድ ጌታ ነው፣አንተም በፍጹም ልብህ በፍጹምም ነፍስህ በፍጹምም አሳብህ በፍጹምም ኃይልህ ጌታ አምላክህን ውደድ የምትል ናት።	"For the Jew the daily prayer is: ""Hear, O Israel: The Lord our God is one Lord: And thou shalt love the Lord thy God with all thine heart, and with all thy soul, and with all thy might."""
ውሻዎ መራመድ ይወዳል.	The Kid likes walking the dog.
እኔ ይህንን ለሠራው ወዳጄ ብቻ አስተላልፌያለሁ	"After that, I just let it go and do what I was supposed to."""
"ግን አብዮተኛ"" አይደለም።"	"and not appeasement."""
አንጎል ፣ የአከርካሪ ገመድ እና ነርቮች ፣ እንዲሁም ጡንቻዎች ፣ ጅማቶች እና ጅማቶች ከመደበኛ ኤክስሬይ እና ከሲቲ ይልቅ ከኤምአርአይ ጋር በግልጽ ይታያሉ።	The brain, spinal cord and nerves, as well as muscles, ligaments, and tendons are seen much more clearly with MRI than with regular x-rays and CT.
3272 ነገር ስብስብ አይደለም።	Height 172 is not too short.
PrankDial በመምረጥ እና በዓለም ዙሪያ እኛን # 1 በጎብኝዎች ጥሪ መተግበሪያ በማድረጉ እናመሰግናለን!	We would like to thank everyone for voting us the #1 Family Attraction and the Best Place to Host a Birthday Party!
አደጋው የተከሰተው ባለፈው ማክሰኞ ላይ በሀምስኪይፍ መንገድ ላይ ምልክት ባለመደረጉ ነው.	Testing on Tuesday revealed no trace of fuel in the water.
ከሌሎች ነጠላ ሰዎች ጋር መገናኘት እና መገናኘት isn 't ግጥሚያ ስለማድረግ እና ከዚያ መሄድ ብቻ ፣ ጉዞ ነው።	Dating and connecting with other singles isn't just about making a match and then walking away, dangerous it's a journey.
ጀርመኖች በተከፋፈለ ሁኔታ ሰለ ጀርመንነት.	German courts are divided.
በእኔ ምክንያት ታመምሽ አሉኝ።	I do feel that I got sick because of him.
_ ቶር የተገነባው በአሜሪካ ጦር ኃይል ሲሆን አሁን ያለው ቶርም በቶር ፕሮጄክት ተገንብቷል።	Tor was developed by US Army, but current Tor is developed by the Tor project.
በቁሳቁሶች ውስጥ ፣ እኔ አስራ አምስት ዩሮ ነበረኝ መሆን አለበት .	I must have impressed cause I was drafted round 15 by the tigers.
ይህ እንግዲህ የሚሆነዉ በወላጆቻቸዉ ንብረት ላይ ነዉ።	That just happened to be on her parents' property.
አዳዲስ ተሿሚዎችን መመደባቸው ታወቀ።	New investigators have been hired.
በሁለት ወንድማማቾች መካከል አንድ ሺ ልዩነት ሊኖር ይችላል።	A group of strangers can have a thousand contradictory realities.
ምናልባት ጥያቄዎ ቀድሞውኑ እዚያ ተመልሷል ።	It's likely your question has already been answered in there.
ታድያ አሁን ላይ ሆኜ ከ 2 አሥርት አመታት በፊት የሆነን እና በአግባቡ ያልተገለጠን ነገር እንድህ ነው ማለት አልችልም።	I can almost promise you that none of us are smart enough to ask a question that hasn't already been asked and clearly answered over the past 2000 years.
ሚስቱን፣እናቷንና አክስቷን የገደለው ራሱን አጠፋ	past in which his grandfather killed his own mother and brother, his father
ባለቤቴ አንድ ወጣት ወንድ ልጅ ይከተለን እንደ ነበር አስተዋለች።	I noticed a member of staff following us.
""" እና ""የሚፈለገውን ለውጥ ያመጣል ወይስ አያመጣም?"	Does that then [mean] that issues are to be left open for anyone to do whatever he or she wants to do?
ሲ ፕሮስፔክ እና ፕሮ ተጋዳላይ ቪታ ቮን ስታር ጋር	Do business with the supply chain Get in front of savvy prosumers and the press
አዲስ ደንበኞች ብቻ	Second only to Rapture's Delight.
ተመሳሳይ መፍትሔ ለመርካቶ ያስፈልጋል።	Seems to me to be needing a similar solution.
ለክፍል 1 ይመዝገቡ	In accordance with Class 1
'በነጻ የተቀበላችሁትን በነጻ ስጡ።	"""What you took was freely given."
መጽሐፉ የተቀረፀው እና ለእኔ እና ለአዘጋጁ የኔ ማስረጃዎች ተዘጋጅቶ ነበር.	Really enjoyed it (if that is the right word for it) the book, it opened my eyes.
9 ኣክራሪዎች የሁቱ ጀነራሎች ስልጣን ተቆጣጠሩት800 000ህዝብ ተፈጁ።	The cybersecurity consulting firm was created by former members of Israel's 8200 unit.
"በድጋሚ አንኳኳሁ ""ይግቡ!"	"and yelled again, ""Up!"""
የዕፅ ቫይረስ ተፅዕኖዎች.	effects of the influenza virus.
ወቅቱ 2016/2017 ውስጥ እውነተኛ የእግር ኳስ ጀግና ሁን!	It's time to get excited about the 2017-18 basketball season!
ከፍዬ ልሂድ መርካቶ››	"""I'm ready for to fade into my own parade."""
MOQ: ምንም MOQ አይገደብም ፣ የበለጠ ብዛት ፣ የተሻለ ዋጋ	MOQ: One piece can be acceptable, no plate-making, lower cost, suitable for the small quantity.
ወደ የእኛ የአድራሻ ዝርዝር ይመዝገቡ!	I'll put it on our list of destinations!
休 /ሥዩ/ እረፍት	he/she/it does recreation
ጥቂት ቆይቶ ወደስራው ሲመለስ ግን ሁሉን ረስቶ ከብዙዎች ሲጫወት ይውላል።	But once he becomes part of the in crowd, he seems to forget all about his old friends.
እግዚአብሔርን እናገለግላለን እና እርሱን ብቻ እናከብረዋለን ።	We are to serve God and HIM alone.
እናም 100% አትበሳጩ።	and don't forget not 100% accurate.
በጣም መጥፎ ነገሮች አሉ እና በአካባቢያቸው ውስጥ ያሉ ሰዎች ለእርስዎ ከባድ ውጤት ሊያስከትሉ ይችላሉ.	There are very bad things and people you meet could have dire consequences for you.
መኝታ ከአልጋ ጋር	in bed with the widow of
ጂጂ ሴሮጥ ቆይቶ ቁጭ እንዳለ ህጻን እያለከለከችና እንደመሳቅ እያለች የገጠማትን ትተርክላት ጀመር...	Reba was red in the face to match her hair color as the waitress arrived with a smile and began to set their food in front of them...
አሁን ግን የማንክደው ሉዕላዊ አገር ናቸው።	But they are now independent states.
እኛ አለባቸው:	We've got to:
በነገራችን ላይ ማንም ሰው ቢሆን የራስን እድል በራስ የመወሰን መብትን መጋፋት ወይም መቃወም አለበት ብዬ አላምንም።	I do not believe that anyone should be prevented or prohibited from making his or her own choices about reproduction.
መጋረጃ ኋላ ሆኖ መዘወር ነው ዘዴአቸው።	Tracking them down by their drumming is the usual approach.
አካባቢ ሎየር-አትላንቲክ (44)	Places to visit in Loire-Atlantique (44)
ስቶን ለሙዚቃ ኢንዱስትሪ ባበረከተው አስተዋፅዖ የሚታወቅ ነው ፣ በተለይም በአማራጭ የሮክ እና ግራንጅ ዘውጎች ።	Stone is well known for his contribution to music sector, particularly for the choice rock and grunge genres.
ነባር የ MidPhase ደንበኛ ከሆኑ እባክዎ ተሞክሮዎን ለእኛ ያካፍሉን.	If you are a daughter in-law, please share your experience with us.
ከእናንተ ለሁሉም ሕግንና መንገድን አደረግን።	We have appointed a law and a practice for every one of you.
ቀኑ መሽቶአልና፥ የማታውም ጥላ ረዝሞአልና ወዮልን።	evening, and the time has come at length when the shadow must fall.
ለውጥ ያስፈልጋል ከሚሉ ሰዎች አንዱ ነኝ።	I'm someone who wants change.
የአእምሮ ብርሃን።	lightenment of the mind.
የክልሉን ነዋሪዎች ለመጀመሪያ ጊዜ ሣገኛቸው ከሚነገረኝ በላይ ፍቅራቸው ትኩረቴን ሣበው።	In the city I saw people with different skin color than mine for the first time.
ሰይጣን በስስት ጌታችን ፈትኖ ድል ቢደረግም ተስፋ ሳይቆርጥ እንዲህ እያለ በትዕቢት ይፈትነው ጀመር።	Satan did not try to make our Lord sin in the wilderness.
ከመጀመሪያው በ Depo-Testosterone ስም ስር የተሸጠ ሲሆን አሁንም በተመሳሳይ ስም ይታወቃል.	Originally it was sold under the Depo-Testosterone name and is still popular with the same name.
ከእራስዎ ሁኔታ ጋር ለሚዛመዱ ጥያቄዎች እባክዎ የገንዘብ አማካሪዎን ወይም የገቢዎችን መምሪያ ያነጋግሩ።	Talk to other business owners or financial advisors about their experiences.
ምክንያቱም ሁለት ወይም ሶስት መልሶችም ትክክለኛ ሊሆኑ ይችላሉና።	In many questions, two or three choices might be correct.
"^ ወይም ""ጥቅም።"	Org. of Prog.
ጉዳዩን በጥንቃቄ መመርመር።	Get a thorough examination.
የእኛ የተለያዩ የእርሻ ሰንሰለቶች በተቻለ መጠን ሁሉንም ዓይነት ፍላጎቶች ለማስማማት ይገኛሉ ።	Our various home loan products are tailored to fulfill all your needs in the best possible way.
ም ጥያቄ አቅርበው ተቃውሞ ያላቸው አካላት በ15 ቀናት ውስጥ እንዲያሳውቁ ይጠየቃል።	E When the application is lodged, the opposing party is summoned to file its opposition within 15 days.
በኢትዮጵያ ትኩረት አድርገህ ልትሰራበት ያሰብከው የትኛውን የሙዚቃ ዘርፍ ነው?	What kind of feature film are you trying to make in Hong Kong?
እና ሽልማቱ ከእሷ ጋር ደስተኛ ሕይወት እንደሆነ ከተሰጠኝ ፣ የቅርብ ጓደኛዋ በመሆኗ ደስተኛ እንደምትሆን እገምታለሁ።	And given that the reward is a happy life with her, I'm guessing you'll be happy being her best friend.
መርከበኞቹም ፈሩ።	The sailors were afraid.
ከዚያን ጊዜ ጀምሮ በዓለም ላይ ከፍተኛ ጥራት ያላቸውን የኢንዱስትሪ መብራቶችን ፣ የሱቅ መብራቶችን እና ማጉያዎችን ለማምረት መሪ-ቴክኖሎጂን ይጠቀማል ።	Ever since, it has developed to one of the world's leading companies for machine tools, lasers and electronics for industrial applications.
አንተም ተመሳሳይ ነገር ታደርጋለህ ብዬ ተስፋ አደርጋለሁ	Hoping that you'll do the same
ለዚህ የጠቀሰው ኢያሱ 5:13-14 ን ነው፤	One of my favorite passages is Joshua 5:13-14.
በሀገሪቱ ውስጥ በሺዎች የሚቆጠሩ የፖለቲካ እስረኞች አሉ።	We have about one thousand political prisoners inside the country.
አንዳንድ ብቻ ነው ውጭ ለ 24 ሰዓታት ስላልሆኑ, አዲስ ቅናሾች በየቀኑ ይመልከቱ የተሻለ ነው.	Secondly, since stories are live for only twenty-four hours, one gets to view fresh content every day.
19 እጄን የምጭንበት ሁሉ መንፈስ ቅዱስን ይቀበል ዘንድ ለእኔ	on whomsoever I lay hands, he may receive the Holy Ghost.
ወላጆቹ እሱን ለማስተማር አቅሙ ነበራቸው።	His parents were unable to teach him.
★ በርካታ ቋንቋዎች የሚደገፉ	Y = Multiple languages are supported.
ፈለቀ ማሩ (ክፍል አንድ) አንድ ወዳጄ ያለ ወትሮው ከአዘቦት ቀናቶች ውስጥ በአንዱ ደወለልኝ።	In High School, one of the popular boys asked me out on a date one night.
"""አምስት ደቂቃዎች"" ፖም"	"A five-minute ""pitch"""
ፎቶግራፉ ብታነሳውም፤ ይቅርታ ግን አልጠየቀቺም።	Once you've received the complaint, don't apologize.
ለእነሱ የውጭ ዜጎች ናቸው በጣም ርካሽ ስለሆነ.	That is why they are so friendly to foreigners.
በተቀናጀና በተደራጀ መልኩ የሚመራ ነው።	It is a structured and organized subject.
አይነት: አስገራሚ	What it feels like: Amazing.
ከዛ በፊት በንጉሱ ግዜ ቀደም ብሎ እንደተባለው ብዙ ነገር የተጀመረበት ነበር።	it was written long ago in the laws, after the first king.
ቢባል፤ ልብስ አጥታ እቤት የቀረችውን ባየህ አለ	She says she saw a man who lived in home pull a burning mattress out of the house.
ተመራማሪውን ጨምሮ የስድስት ባለሙያዎችን ተሳትፎ ይጠይቃል።	It seats six people, including the pilot.
+ 17 የልጅቷ አባት ልጁን ለእሱ ለመስጠት ፈጽሞ ፈቃደኛ ሳይሆን ቢቀር ይህ ሰው ለደናግል የሚከፈለውን የማጫ ዋጋ መክፈል አለበት።	17 If her father utterly refuses to give her to him, he shall PAY MONEY according to the bride-price of virgins.
ይህ የአበባው ደሴት በመባል ይታወቃል.	It is known as the Peacock Island.
ሆኖም ፣ ከእርሷ የበለጠ ከእርሷ መስክ በ 10 ዓመታት ውስጥ የበለጠ ልምድ ይኖርዎታል እናም የላቀ ድግሪም አለዎት ።	He's got decades more political experience than her, and a much better track record.
በእርግጥ እነዚህን ፈቃዶች አጋጥመውዎት ይሆናል ።	You may not have discovered these advantages.
በጨዋታው አንድ ስህተት ብቻ ነው የፈጸመው።	The team committed only one error in the game.
ስንዴ ከዓለም ዋነኞቹ ሰብሎች ውስጥ አንዱ ነው.	Gold is among the substances in the world.
እንዲያውም እናንተ እ/ር ይስጣችሁ ወረቀት ነው ያመጣችሁት።	As a result, you are getting to get yourself a paper.
"""ለኃጢአት ሞተን ለጽድቅ እንድንኖር እርሱ ራሱ በሥጋው ኃጢአታችንን በእንጨት መስቀል ላይ ተሸከመ።"	"""He Himself bore our sins in His body on the cross, so that we might die to sin and live to righteousness."""
እባቡ በእውነቱ የጥበብ ምልክት ተብሎ የሚጠራባቸው ብዙ ምክንያቶች አሉ።	There are many reasons why the snake may truly be called a symbol of wisdom.
ልጆች የእግዚአብሔር ርስት ናቸው ፣ በልጆቻችን ልንኮራ ፣ ልንደግፋቸው እንዲሁም ለእነሱም መጸለይ አለብን ።	Our children are gifts from God, we are responsible for their care and we need to nurture them.
የሕይወታችንን ዝርዝር ትንተና ለማካሄድና ከዚህ ፕላኔት ሌሎች ባለድርሻ አካላት ጋር የሚስማሙ ሚዛን ለመፍጠር ጊዜው አሁን መሆኑን አይተናል።	Perhaps it's time we started thinking hard about the relationship of our species to the rest of the planet.
እኔ ደግሞ በጊዜው እነዚህን ዳኞች አላቃቸውም።	I don't even know those judges.
አንዳርጋቸው ለመለስ ዜናዊ የቅርብ ሰው እንደነበር ይሰማ ነበር።	Their journal tells us that they came to live closely with the Aquanauts.
አባቱ ሁልጊዜ ከእሱ ጋር ነበር.	But the Father was always with Him.
ነገር ግን, የፅሁፍ ትርጉምን ወይም የድረ-ገጹን ቃላት ወደ የ 150 ቃላት ይገድባል.	Political or campaign-related letters are limited to 150 words.
ደግሞም ልጁን ስለእነሱ የሰጠው እግዚአብሔር ፣ እግዚአብሔርን የሚመርጡትን የዲያብሎስ ልጆች ሆነው ለመቆየት ያላቸውን አስከፊ ውሳኔ በቀላሉ ይቀበላል ።	To those who did accept him he gave power to become children of God...
fone - ማስተላለፊያ (iOS) የተሻለ ሆኖ ሊታይ ይችላል.	"""Its user interface (UI) can be improved."
ልክ እናንተ እይታዎች ውስጥ ማስገባት አማራጮች የማያወጣው ማን.	Those who don't should be allowed options according to their light.
አዳምም እንዲህ አለ፤ 'እነሆ፤ ይህች ዐጥንት ከዐጥንቴ፤ ሥጋም ከሥጋዬ ናት።	"Adam replied, ""This is the bone of my bones and the flesh of my flesh."
ባጣሁት ስቸገር - ባለኝ ሰው አ'ረግሽኝ	I'll always remember you for how badly you treated me - Letter To My Ex
የጥበቃ ሠራተኛ አ.	avaricious ward worker.
ለሀገራዊ ችግሮች መፍትሄ ያስቀምጣል።	respond to national issues.
ከመጠን ያለፈ ከሆነ ግን ወንጀል ይሆናል።	But, if it is too heavy, it will become a problem.
ምግቡን ለመግዛት ከሚገኘው ገቢ በጀት ይመደባል.	An velvet is a good to an output from a financial system.
ብዙውን ጊዜ እኔ ሌላ ሰው ነበርኩ ።	I was always one other person.
አላርፍ ያለች ታት ምናረገች ነው የሚባለው ወያነ ብሎ ብሎ የአሜሪካንን ሰዎች ማሰር ጀመረ	The slang term has become so popular among black Americans that it became fodder for a comedy
መንግስት ሁለቱንም ጉዳዮች ለሕዝብ ይፋ ያደረገው በዚህ ሳምንት ነው።	And both are set for public hearings this week.
እና ወደ ተሰበሰቡት ሀብት ወደ እርሱ አመጡ;, እና ብዙ ክብር.	He brought with him a great wealth of treasure and a magnificent entourage.
›› ማለቴ ወጌን ላተጋ እንዳይመስልሽ፤ የዛሬ ስልጣኔሽ ውስጥ የአንቺ አሻራ ቢደበዝዝብኝ ነው።	Like, you don't talk about baptizing my younger brother, so you're already in a fed position if you fight with me.
በደበሎ ተመልምሎ።	He blames it on his contact lense.
ብቁነትን ያረጋግጡ።	Proving Worthiness.
ብልህ ውጣ ውረድ:	go out to you:
"""ጠላት ከ40 ያላነሱ ሞርታሮች ሲኖሩት ወገን አንድም ሞርታር አልነበረውም።"	A friend had a Siamese who had no more than 4 teeth in his mouth.
የዛሬ ሳምንት መልሱን በግጥም እናቀርባለን።	This week, we learned the answer.
አጠቃቀሙ ደንቦች በጠረጴዛ ላይ ይጻፋሉ.	The keywords are written on the board.
ቡድንህ ከተወሰኑ ተጨዋቾች በቀር ቋሚ 11 የለውም።	You will not build a team with 11 players.
እህል ከቀመስኹ ከ24 ሰዓት በላይ ሆኖኛል።	I was bricked for over 24 hours.
መኖር ባለመቻላቸው አዲስ አበባን ለቀው ወጡ።	Refusing to die, you escaped from Anubis.
ወደ ላይ ፣ እኛ በመጥፎ ቦታ ውስጥ ብናገኝ ትንሽ ኢንሹራንስም ሰጥተውናል።	We rarely have bad weather, being located at a lower elevation gives us a temperate climate.
[ደራሲ ስለኾነ ይኹን እንጃ] ብቻ፣ ያ ግዙፍ የቴአትር ቤቱ መድረክ.	"""We're the only ones that survived that massive milestone (on the Esplanade)."
አንቺ ደግመ ሳንሱር አታደርጊ ያለውን እንዳለ መንገር ነው።	Say that that you'll do your best not to repeat it.
(አጻጻፉን ዘመናዊ አድርጌዋለሁ ፣ ግን በጭራሽ በጣም የሚስብ አልነበረም ።	(I currently write it in the Additional comments, but it doesn't look very consistent.
ይህን ተከትሎም የዲጂታል አገልግሎቶችን የሚያቀርብበትን መተግበሪያም ይበልጥ ማዘመን እና አስተማማኝ ማድረግ ተችሏል።	However, further development is possible by increasing the accuracy and utility of genomic prediction.
ዘይነግሥ በእንተ ሀገር	A new Nation-State was born on the ashes of the empire.
ጥያቄ በሚነሳበት ጊዜ ፣   እሱ አሁንም ጽንሰ-ሀሳብ ነው ፣ በእርግጠኝነት አይደለም!	If he stays healthy he's still a force, there is no doubt.
ቀረጥ ከፍተኛ ነው እና ወንጀል ደግሞ ዝቅተኛ ነው.	Employment levels are high and crime is low.
በአካባቢዉ የሚገኙ መሳሪያዎችን ሊሰሩ የሚችሉ ሰዎችን ማግኘት ጠቃሚ ነዉ።	Made possible by people there having access to proper weaponry.
ስለ ማይክ አደንጓ እናት	Unknown to her, Mick was hired by Beth's mother to find her daughter.
እንደዚህ ያለ ማስታወቂያ ጥቅም የሚፈልጉ ሰዎች ተጫዋቾች, አንድ ሥርዓት ውስጥ የማስተዋወቂያ ኮድ ማስገባት አለባቸው.	Players who wish to benefit from such a promotion, must submit a promotional code in a system.
ፋሽሽቱ ftድን ፍጹም ከማይወጣዉ አረንቋ መዘፈቁንም በእርግጠኛነት መናገር ይቻላል።	You can be sure that the safety of the diffuser is good due to the of the aroma oil intact.
በ 2018 ውስጥ ትልቅ ስኬት እንደምንችል ተስፋ እናደርጋለን.	I hope you will have a successful 2018.
ደቀ መዛሙርቱ ምግብ ለመግዛት ወደ ከተማ ሄደው ነበር።	The disciples had gone to the city to buy food.
ኢስኪሼር የአገር ውስጥ ምርት ማመንጫውን በተሳካ ሁኔታ ያዘጋጃል.	The Jahrbuch will be turned to successful field development.
"""ይህ ያ በእርሱ ትጠራጠሩበት የነበራችሁት ነው"" (ይባላሉ) ።"	This is what you used to doubt!'
ብዙ ጊዜ በአቅራቢያ ይገኛሉ።	They often exist in proximity.
እሱንም አደራ እንዳትረሳ.	But do not overreach on him.
ሁሉም ይዘቶች ፣ የንግድ ምልክቶች ፣ የአገልግሎት ምልክቶች ፣ የንግድ ምልክቶች ፣ አርማዎች እና አዶዎች የ Forex ዲጂታል ወይም ተጓዳኝዎቹ ወይም ወኪሎቹ ንብረት ናቸው እንዲሁም በቅጂ መብት ህጎች እና በዓለም አቀፍ ስምምነቶች እና ድንጋጌዎች የተጠበቁ ናቸው ።	All content, trademarks, services marks, trade names, logos and icons are the property of the Company or its affiliates or agents and are protected by copyright laws and international treaties and provisions.
ይህም ቀላሉና በጣም ውጤታማ ሳምሰንግ ምትኬ softwares አንዱ ነው.	This is one of the simplest and most effective automated trading bots.
እባክዎን እኛን ለመጠየቅ ነፃነት ይሰማዎ	The experience moved him so much he had to write a song about it asking for Godís forgiveness for the wrongs that had been done to the Indigenous people.
ሁለት ዘዴዎች በጣም ተወዳጅ ናቸው:	There are two configurations that are highly recommended:
ደግሞ አንድ ቀን ልጁ ሲገልጥ በሙላት እንድናለን።	One day, his father announces that he is getting remarried.
አውድማ: - መስከረም 30 እና ምርጫ - September 22/ 2020/	Committee attendance - Appointments and Conditions of Service Committee, 30 March 2020 - 22 September 2020 - Modern Council
እናንተ ሰላማዊ ለመዳሰስ እየፈለጉ ይሁን የባሕር ዳርቻዎች እና ቆንጆ ወደብ ሆላንድ ሰሜን ባሕር ዳርቻ መንደሮች, የአገሪቱን በቀለማት ያሸበረቀ አምፖል የሚያድጉ ማሳዎች, ወይም አምስተርዳም ውስጥ የተሞላበት ዋና ከተማ ዙሪያ መስመሮች, አንድ ዘና ፍጥነት ገቢር ብስክሌት ስለ ታላቅ ነው ሁሉ የያዘ መሆኑን ዑደት ዱካዎች ያገኛሉ.	Whether you're looking to explore the peaceful coastline and pretty harbour villages of Holland's North Sea coast, the country's colourful bulb-growing fields or routes around the vibrant capital city of Amsterdam, you'll find cycle paths that embody everything that is great about active cycling at a leisurely pace.
በቀዳሚ ግምገማዎች ላይ 5 መካከለኛ ይገናኛሉ	1- There are five (5) watches in the primary collection.
እርግጥ ነው ሰውየው እጅግ ብዙ	The man is obviously very poorly
የማንነትህ እትብቱ።	Whoever you have it.
እናንተ የምትናፍቁትን የዚህ አለም ሙገሳና ክብር አይደለም።	You will not go without the dignity and honor you have earned.
ጾ ምን እንጹም ባልንጀራችን እንውደድ	There are no exceptions to the command to love our neighbor
ምንም እንኳን ሁሉም ነገር ቢኖርም ኢኮኖሚያዊ ሕይወት ቀስ እያለ ነው ።	Despite the gloomy reality, economic recovery is underway.
"""የኢትዮጵያን ታሪክ ባያውቁ ነው!"	"They didn't tell the story of European slavery."""
, ሁሉንም ቁልፎች መልቀቅ.	Release all the keys.
የጠቢብ ልብ አፉን ያስተምራል ፥ ለከንፈሩም ትምህርትን ይጨምራል።	The heart of the wise instructs his mouth, and adds learning to his lips.
ጌታውንና ጅቡን የኤርትራ መንግሥት ተማምኖ።	Hand to the King and Lord of the Eryie.
የትኛውም መንግስታዊ አካል ግን ጥያቄው የቀረበበት አግባብ ምን ግድፈት እንዳለበት ወይም ግድፈቱ እንዴት መስተካከል እንደሚገባው አፍታቶ ሲናገር አልተሰማም።	Blogger has never officially made a statement about what the problem is or how to fix it.
ስሞች ፊደሎች እና ቁጥሮች ብቻ ሊኖራቸው ይችላል.	Character names can only contain letters and numbers.
"የሁለቱም ዓይኖች ተከፈቱ፥"""	"Then their eyes were opened...."""
በዚያ ቀን መንፈስ ቅዱስ ወደ ሰዎች ልብ ውስጥ ገባ።	'So it is when the Holy Spirit descends into the hearts of men.
ሁሉም ነገር ተዘጋጅቷል ፣ ትዕዛዙ ደስተኛ ነው።	Everything is fine, orders are satisfied.
እውነተኛ ክርስቲያኖችም እንኳ አልፎ አልፎ እንዲህ ያለ ስሜት ሊሰማቸው ይችላል።	Even Christians can be bewildered in such a time.
ሁሉን የሚሰጣችሁ መኖራችሁ ሳይሆን በመኖራችሁ ውስጥ የምትገነቡት ታላቅ ፍላጎት ነው።	Loving isn't giving everything you have, but giving what's best in you.
"ለዚኽም ነው ሐዋርያው ጳውሎስ፡- "" ምናልባትም እየመረመሩ ያገኙት እንደ ኾነ፥ እግዚአብሔርን ይፈልጉ ዘንድ በምድር ኹሉ ላይ እንዲኖሩ የሰውን ወገኖች ኹሉ ከአንድ ፈጠረ፥ የተወሰኑትንም ዘመኖችና ለሚኖሩበት ስፍራ ዳርቻ መደበላቸው።"	""" And he made from one man every nation of mankind to live on all the face of the earth, having determined allotted periods and the boundaries of their dwelling place, that they should seek God, and perhaps feel their way toward him and find him."
አጫጫን እና iTunes ማስጀመር.	Rethink the use of icons and emoticons.
ስንሞት ሁሉም ነገር ያከትማል፤	In death, all things must pass away,
ይህም የዓለም የነዳጅ ገበያ ላይ ተፅዕኖ እንዳሳደረ ገልፀዋል።	This has also had a measurable impact on the global market for commodities.
የባንክ ሂሳብ በንጹህ ውስጥ ምን ማለት ነው?	What makes the bank's actions reputable at all?
እንግዶችንም አማልክትና ጣዖቱንም ከእግዚአብሔር ቤት አራቀ፥ የእግዚአብሔርም ቤት ባለበት ተራራ ላይና በኢየሩሳሌም የሠራቸውን መሠዊያዎች ሁሉ ወስዶ ከከተማይቱ በስተ ውጭ ጣላቸው።	And he took away the foreign gods and the idol from the house of the LORD, and all the altars that he had built on the mountain of the house of the LORD and in Jerusalem, and he threw them outside of the city.
በጣም ሀሳብሽን አደንቀዋለሁ: ግን ስለ ኢትዮፕያ ብዙም ያለፈውን ታሪክ ለማዎቅሽ ትንሽ እጠራጠራለሁ::	I like your insight, but I have to disagree about the historicity of Exodus.
8:29 እና እኔን የላከኝ እርሱ ከእኔ ጋር ነው;, እርሱ ብቻውን እኔን አልተወንም.	8:29 And He who sent me is with me; He has not left me alone,
ደቡብ ሱዳን እና የተመድ ተልዕኮ 13.	13 northern and a southern part.
"""ጎ ፈንድ ሚ"" ተከፍቶ የሚሰበሰበው ገንዘብ ለትክክለኛ ዓላማ ለትክክለኛው ተረጂ መዋል አለበት እንጂ የግለሰብ መጠቀሚያ መሆን የለበትም።"	"Exempt, tax-free dollars must be used to support a ""public"" purpose, and not to benefit individuals."
ንጉ Ahab አክዓብ የእስራኤልን አምላክ እግዚአብሔርን አስvokeጣ ነገር አደረገ, ከእርሱ በፊት ከነበሩት ከእስራኤል ነገሥታት ሁሉ ይልቅ.	Ahab did more to provoke the LORD God of Israel to anger than all the kings of Israel who were before him.
"ነብዩ ኢሳያስ በምዕራፍ 58፡6-7 ላይ ""የጭቈናን ሰንሰለት እንድትበጥሱ፣ የቀንበርን ገመድ እንድትፈቱ፣ የተጨቈኑትን ነጻ እንድታወጡ፣ ቀንበርን ሁሉ እንድትሰብሩ አይደለምን?"	"The first reading for February 5 was Isaiah 58:6-7: ""Is not this the fast I choose: to loose the bonds of injustice, to undo the thongs of the yoke, to let the oppressed go free?"""
ሆኖም ለግብር ቅነሳ በተለምዶ ውጤታማ አይደለም ።	Revenue sharing is generally not viable.
የክፍሉ ተወካዮች ነበሩ ።	They were members of the band.
ሰላም ሰላም ይህ ፍቅርን በፍቅር የምንማማርበት ኤላ ዋን ቲዩብ ነው Ela 1 tube	P.S. The song playing on this video is Love Love Love by Avalanche City
በአሁኑ ወቅት በእርስዎ ዝርዝር ላይ የለም.	You are currently not logged into your account.
የመስቀሉ ቃል ለሚጠፉ ሞኝነት ነው፤ ለእኛ ለምንድ ነው ግን የእግዚአብሔር ኀይል ነው፤ 1 ቆሮንቶስ 1:18 NASV	For the message of the cross is foolishness to those who are perishing, but to us who are being saved it is the power of God 1 Corinthians 1:18 NIV
ሙሉ ለሙሉ በኤሌክትሪክ ኃይል የሚሰራ ነው።	It is operated wholly by electricity.
አዲስ ፍራፍሬዎች እና አረንጓዴዎች በየቀኑ የግድ አስፈላጊ ናቸው ።	Fresh fruits and vegetables are a daily must.
አ በፕሬዝዳንት ኦባማ ላይ ዳግመኛ ተግብሮታል።	He's trying again with President-elect Barack Obama.
ሁለተኛ ባሏ ሞተ.	And her second husband dies.
"""የእኔን ህይወት ሙሉ ያደረጉትን፣ እና አዎ፣ ዘለአለማዊ ያደረጉትን ባለቤቴን፣ ልጆቼን፣ የልጅ ልጆቼ እና የልጅ ልጅ ልጆቼን እና ሌሎች ቤተሰቦችን አመሰግናለሁ።"	I give thanks for my wife, for my children, for my grandchildren, and for my great-grandchildren and for... extended family who make my own life so rich and, yes, even eternal.
በአሁኑ ጊዜ በፒ.	It's on PBE now.
የሰው ልጆች ለበሽታ እንዲዳረጉ ያደረገው ማን ነው?	WHO has confirmed human to human transmission of the disease.
ለብራቮ ጉብኝቶች ሲሠራ ቻኒያ ሐሙስ ፣ አርብ እና እሁድ ሶስት ሳምንታዊ በረራዎችን ያያል ፣ ለደንበኞች በቀርጤስ ለ 7 ፣ 10 ፣ 11 እና 14 ሌሊት ዕረፍቶች አማራጮችን ይሰጣል ፣ ዛንቴ (ሰኞ) ፣ ኮስ (ሐሙስ) እና ሮድስ (አርብ) ሁሉም ሳምንታዊ አገልግሎት ያያሉ።	Operating for Bravo Tours, Chania will see three weekly flights on Thursdays, Fridays and Sundays, giving customers options for 7, 10, 11 and 14-night breaks in Crete, while Zante (Mondays), Kos (Thursdays) and Rhodes (Fridays) will all see a weekly service.
ታድያ ተደራጅተውበታል ማለት ነው።	means vouchsafed to him.
ተነሳታ ልትደባደብና ልትማታ	As it turns out, her multivitamin tested positive for the impurity.
io የቀረቡ) ወደ ጠፈር ለማሰስ ይረዳናል.	// SendBehind () to bring it closer to the front.
አስቀድሜም እንዳልኩህ ዘመኑ የልዋጭ ነው።	The day in question was a hot one as I said earlier.
አየር መቆጣጠሪያ SUV መኪና ለ 8 ቀኖች / 7 ምሽቶች	Air-conditioned private car for 4 nights and 5 days
ይህም የምትተባበሩን ከሆነ ነው።	If you joint to it.
እነርሱም በጣም ጠንካራ እና ታዋቂ ተዋጊዎች ነበሩ,	Both men are well-known and highly ranked fighters,
ሀብትስ እንዴት ነው የሚከፋፈለው?	How assets will be divided.
ማሰባሰቢያ ግዜ እየሰጡ እንደሆነ ያውቁታል።	They know whether they have time to sit around.
ሌላው ቀርቶ የኢንዱስትሪው የካሳ ክፍያ አስተዳደር እጅግ አሰልቺ ነው።	Even the Small Business Administration is an embarrassment.
ይህ ቡድን ሁሌም እሱ የሚለው ብቻ ነው ትክክል ብሎ የሚያምነው።	The ou man think he is the only one that is always correct.
በሃገሬ ያጣሁትን ነጻነት በጀርመን ሃገር ሊያሳጡኝ መሞከራቸውም ከቶ አልገረመኝም ።	I guess they didn't want to risk me getting lost in the German countryside.
እኔ መፈለግ እና እነሱን እንደገና redownload ወደ የላቸውም ስለዚህም ሁሉ የእኔ መተግበሪያዎች ለማስተላለፍ ይህንን ሶፍትዌር መጠቀም.	I use this software to transfer all my apps so that I don't have to search and redownload them again.
ኢዮብ 21:5 - Correct Me ወደ እኔ ተመልከቱ፥ ተደነቁም፤ እጃችሁንም በአፋችሁ ላይ አኑሩ።	Job 21:5 (CEB) Turn to me and be appalled; lay your hand over your mouth.
2012 በኋላ ባሉት ግዴታዎች ላይ ለመስማማት እየታገሉ ነው ።	Since then, several countries seem to be on track towards meeting their commitments by 2012.
በጊዜው በጣም ግራ ተጋባሁ።	At that time i was very confused.
ለኤል xino መልስ ይስጡ	Take care from Elin Synnøve
እና በተለይም ደንበኞቻችንን ስለማያውቁት መረጃ .	Especially information I did not know about animals.
ጥቂቶች ለሀገሬ ብለው መጡ።	A few kids came to my house.
"እርሱ አፈጣጠራችንን ያውቃልና፤ ትቢያ መሆናችንንም ያስባል"" በማለት ይናገራል።"	For He knows how we are formed, he remembers that we are dust . . .
ግጥሚያ እና ተጓዳኝ - ያለፉ እና አሁን ያሉ	Cher, then and now: The bold and the banal.
እግዛቢሄር ይመስገን ስለሁሉም ነገር says:	Let's honor God, in all that He speaks,
ወደ ውሀው መውረድ ረጋ ያለ ነው ፣ ምንም ሹል ድብርት የለም።	The beach slopes gently into the sea and there are no submerged rocks.
የቀጥታ ሻጮች በጣም በቅርቡ የቁማር የሚመጣው ይሆናል!	One of our favorite Animals will soon be arriving in Play Wild!
የምዝገባ ጉርሻ	'Tis enough that I have incurred the
እባክዎን ስለ ‹ጫካ ውስጥ ስለሚቀላቀሉ የጭረት ጣሪያዎች ስብስብ› ይንገሩን ።	Please tell me about bait stores in the Florida Keys.
ንጉሡም በይሁንታ ተቀበሏቸው።	the king rewarded them for it.
ህዝብ እርስ በእርስ እንዳይተማመን ሆነዋል ።	People don't trust each other.
ይህን እውነተኛ ሐዋርያዊ ትምህርት ኑፋቄ አድርጋ ነው የምትቀበለው።	This is supported by reputable academic literature.
የሚሠሩአቸውም የሚያምኑባቸውም ሁሉ እንደ እነርሱ ይሁኑ።	Those who make them become like them, so do all who trust in them.
ዳግማዊ, ከሉዊስ ሪቬራ ጋር ስላስተዋወቅከኝ በጣም አመሰግንሀለሁ!	Thank you, Paul, for the kind remembrance of Ira Louvin.
+ አንተ ብርታቴ ነህ፤ እኔን ለመርዳት ፍጠን።	You are my strength: come quickly to help me.
â € ¢ የኮምፒውተር ቫይረሶች ፍሬድ ኮኸን በ 1984 የተፈለሰፈው ነበር.	A computer virus was coined by Fred Cohen in 1984.
ወደፊት ሂድ, የእርስዎን ምርጥ ምት ውሰድ!	Go ahead and take your chances!
ልጆቼ አልሓፍ ዓምር መልክ	Hi, my boy goes through stages of having a husky voice.
5:10 እርሱም ብዙዎች አወጣ, ሳይቀበር, ራሱ ደግሞ ተጣለ, unlamented እና ሳይቀበር ሁለቱም, እና የውጭ የቀብር ወይም የአባቶችን ከመቃብር ድርሻ ወይ መጠቀም ሳይኖረው.	5:10 And he who cast out many, unburied, was himself also cast out, both unlamented and unburied, and without having use of either foreign burial or a share of the sepulcher of his fathers.
እግዚአብሔር የሚባርካቸው ይህ ሲሆን ብቻ ነበር።	Only God could heal them.
አዲስ ዘመን፡- ወደ ፓርቲ የገቡት መቼ ነው?	teen mommies, when did you go back to school?
ኢሳይያስ 52:6 - Correct Me ስለዚህ ወገኔ ስሜን ያውቃል፥ ስለዚህም የምናገር እኔ እንደ ሆንሁ በዚያ ቀን ያውቃሉ፤ እነሆ፥ እኔ ነኝ።	Isaiah 52:6: Therefore my people shall know my name: therefore they shall know in that day that I am he that doth speak: behold, it is I.
በማንኛውም ነገር አልረካህም?	ain't you glad for nothing?
"ጥፋተኛ መሆኑን እንደተገነዘበ በሚያሳይ መንገድ ""ይቅርታ እማዬ፣ ረስቼው ነው"" አለ።"	"She hugged my head and said, ""I forgive you, Mama."""
ሲ ዲሲ የተከፈለ የኃይል መሙያ ክምር (በ R&D ማረጋገጫ ስር)	Energy Technology Laboratory (previously amended by G&C
ሌሎች በባዕድ ቋንቋዎች የምንሠራቸው አስቂኝ ስህተቶች አሉ።	We notice more than usual we make mistakes in foreign languages.
"""የመተከል ተፈናቃዮች በቂ ሰብዓዊ ድጋፍ."	"""Few institutional custodians are able to provide an adequate level of protection."
ህንጻውን ገንብቶ ለማጠናቀቅ 10 ዓመታት የፈጀ መሆኑም ተመልክቷል።	It is said that it took six years for the construction of the building.
አሁን እኛ በምናደርገው መንገድ መቀጠላችን ከተከሰተው አስደንጋጭ ሁኔታዎች ለማስወገድ ከፈለግን አኗኗራችንን መለወጥ እንዳለባቸው ያውቃሉ.	They know we are going to have to change our lifestyle though if we want to avoid the after effects of continuing to live the way we do now.
መልካሙ ዜና ነው የሚሰራው በእውነትም በትክክል ነው የሚሰራው ።	The good news is, that it really does.
ይህ ደግሞ ጥንካሬ እንጂ ድክመት አይደለም።	This is their strength, not weakness.
መዝገበ-ቃላቱ ተሻሽሎና አዳዲስ ቃላቶችን በማከል እንደገና ታትሞ ለገበያ ቀርቧል።	Outdated material has been removed, while newly emerging words and phrases have been added to the collection.
2:13 እኔ ወደ አንተ እጽፍላችኋለሁ, አባቶች, አንተ አውቃችኋልና ስለ ማን እንደ ሆነ ከመጀመሪያ ነው.	2:13 I am writing to you, fathers, because you know him who is from the beginning.
በሩስያ ዙሪያ ይጓዙ:	dating around the russia...
በማንኛውም ጊዜ ኩኪዎችን መጠቀምን መቃወም ይችላሉ ፣ ምንም እንኳን ይህ የድር ጣቢያውን የአጠቃቀም እና የአጠቃቀም ቀላልነት ሊገድበው ይችላል ።	You can disable the use of cookies, although this may limit the website's functionality and ease of use.
"14እነርሱም ወደ ካህናት አለቆችና ወደ ሽማግሌዎች ሄደው እንዲህ አሉ፤ ""ጳውሎስን ሳንገድል እህል ላለመቅመስ ጽኑ መሐላ አድርገናል።"	"14 They came to the chief priests and the elders and said, ""We have bound ourselves under a solemn oath to taste nothing until we have killed Paul."
ሁሉም ህጻናት ደስተኛ እናቶች ለማለት ያስባሉ.	All parents want their children to be happy.
ፈጣን አይደለም ፣ ነገር ግን በንግዱ ውስጥ በጣም ትንሽ ነው ።	It is quite fast but it isn't as quick on the highway.
11 በቤቱ ደጃፍ የነበሩትንም ሰዎች ከታናሻቸው ጀምሮ እስከ ታለቃቸው ድረስ አሳወሩአቸው ደጃፉንም ለማግኘት ሲፈልጉ ደከሙ።	19.11 But they struck the men who were at the entrance of the house with blindness, from the least to the greatest, so that they wore themselves out trying to find the doorway.
እችን ያገባ የታደለ	The stories of my wedded pair captured in memories
ፕላኔት ላይ በጣም ታዋቂ ስፖርት, በዚያ ውድድሮች የተለያዩ ዓይነቶች ሲሆኑ መንገድ ሁላችንም እንዳለን ኳስ ለማግኘት የተራቡ ይህን ታላቅ ስፖርት እና 1xbet ጥቃት አከራካሪ.	The most popular sport on the planet, there are a number of types of tournaments and the way in which disputes this great sport and 1xbet assault hungry for football that all of us have.
ምክንያቱም እርሱ እጅግ የተከበረና በሁሉም አቅጣጫ ከፍተኛ የሆነ ሰው ነው።	He is almighty and perfect in every way.
"""ድሮኖች""፣ በዋጋም በስሪትም ይለያያሉ።"	"""normal,"" and ""dry"" years, with different allocations for"
"በአሜሪካ የሚገኙ ""መረብ"" እና ""መሰሌ"" የተባሉ የመፅሐፍ ሽያጭ ጉልበተኞችን ሃይ የሚላቸው ማን ነው?"	"Who the hell in the media and on the left is fixated on ""canceling"" voices in Arkansas?"
እንደገና ወደ ውጭ ምክንያቱም ምናልባት ሁሉም መብት	Maybe they'll come back again maybe they're all gone
ለብዙ አመታት አይታወቅም ነበር።	It had not been knew for years.
በተለያዬ ቃለ ምልልስ ይህን አዳምጣለሁኝ።	I heard this phrase in an interview.
እርሱም አላቸው, የሙሽራ ቤቱን ልጆች እንዲጦሙ ማድረግ ትችላላችሁ?	"He said, ""You mean the baby feeders?"
ለዛሬ ከመጽሐፈ ጥበብ ምዕ.	Today we're finding bits of wisdom from Books.
ከገባን ባለመታገዳችን ከምናገኘው ገቢ ይልቅ፣ በመታገዳችን በመማር የምናተርፈው ትርፍ የበለጠ ነው ብለዋል።	He hoped that, in the long run, what we gained by learning more about our experiences would more than replace what we would lose.
ተመልሰው መጥተው በመንገዱ ላይ በማንኛውም ጊዜ አመሰግናሉ!	Come back anytime and thank you again with all my heart!
‹‹በፋሽኑ ብቻ ሳይሆን ሌሎች ዘርፎችም የጥቂቶች ሳይሆኑ የሁሉም መሆናቸውን በማሳየት ድንበሩ መፍረስ አለበት፤›› ስትልም ታስረዳለች።	"""It really is about ensuring voting rights,"" she said, ""and that each district not only has the same number of people in it but that those people are not segments of communities but entire communities so that those communities can be empowered."""
በመሆኑም ሁሉም የዒድ ሰላትን በየቤታቸው ሆነው እንዲሰግዱ አሳስበዋል።	This is why the Jews remove all the yeast in their houses.
አስከሬኖቹ በወንዙ ውስጥ ለብዙ ቀናት እንደቆዩ ጠቅሰዋል ።	Authories believe the body has been in the water for several days.
ልብህ ደስ ይበለው።	Let your heart begin to rejoice.
"በዚህ ጊዜ አንድ እናት ""ሰዎቹ የሰጡት ሀሳብ ለየቅል ሆኖ እንዴት ይህንንም ያንንም ትክክል ይላሉ ?"	"When a certain man said to him, ""How does that balance the account?"
በፓርቲው ድርጅታዊ ደንብ መሰረት የድርጅቱ የበላይ አካል ጠቅላላ ጉብዬው ነው።	The whole process is monitored by governing body as per the rule.
እህቱ የገባት ትመስላለች።	Her sister is coming in.
የአቤቱታ ነጥቦቹ በሙሉ የራሴ መሆናቸውን አረጋግጣለሁ።	I hereby state that all rights of the film are belong to myself.
እኛ ችግረኞች ናቸው	We Are The Helpless
ps: bobono እሱ ሁሉንም ሰው መጥቀስ አይችልም .	Prof. Adewole: it is not impossible to cover everybody.
""" እንዴት ታድያ አላየውሽም """	"How do I haven't seen you?"""
በትምህርት ቤቱ ውስጥ የቤተሰብ ተሳትፎን ያበረታቱ።	He hopes to encourage family involvement in the school.
ምዝገባ ያስፈልጋል ፣ እና ቦታ ውስን ነው ።	Registration is required and places are limited.
በጸሎት ፅሙድ ሁነው እግዚአብሔር አምላካቸው ከክፉ ነገር እንዲሰውራቸው	God's grace shall keep them safe from the evil of
Ethiopia: በሀዘን ላይ ሀዘን!	Zambia: Down with the State of Emergency!
በዓለም ዙሪያ ያሉ ወንድሞች ስለ እኔ እንደሚጸልዩ አውቃለሁ።	Know that people all over the world are praying for you.
በመግደል ለውጥ ቢመጣ ኖሮ የህወሓት አገዛዝ ይቆይ ነበር።	If that decision had gone the other way, pro-life speech would have been regulated.
ም የብሔራዊ አደጋ ስጋት ሥራ አመራር ኮሚሽነር ምትኩ ካሳ እንደገለጹት፤ ባለፉት ሦስት ቀናት በአፋር በኩል ወደ ትግራይ ክልል በመጓጓዝ ላይ የነበሩ ምግብና ምግብነክ ያልሆኑ የሰብዓዊ እርዳታ የጫኑ 189 ከባድ ተሽከርካሪዎች እንዳይንቀሳቀሱ ለማድረግ የሽብር ጥቃት በመፈጸም የእርዳታ መስመር ዘግቷል።	In the past three days, TPLF committed terrorist attacks, blocking the road on 189 trucks carrying food and non-food aid to Tigray via Afar where the vehicles are forced to stop, he said.
{0} ይህን {1} አርትዕ አድርገዋል	They've developed this
እንደውም መንግስት ለጉዳዩ በሰጠው ትኩረት ልክ ህብረተሰቡ አልተረዳም።	While looking to tackle the crisis, the EU failed to understand the social implications of the same.
ሆኖም ናጋኖኑ ምናልባት በሆሊውድ ውስጥ ለራሱ ትልቅ ስም ያተርፍ ይሆናል ።	However Salisu might make a bigger name for himself in the Premier League.
እንጀምር ፣ እንዴት እንደምንጀምር: መጀመሪያ ላይ ።	Let's first start with, how to.
ከፍተኛው መቀያየርን የአሁኑ	The arrival of Christianity during the fifth century AD began a process of change in Ireland.
የተደናገጠ ፣ የተናደደና የተረበሸ ህዝብ ምን ሊፈጥር ይችላል ብሎ ማሰብ ተገቢ ነው።	You can see how easily it would be to fool uninformed, angry, and frightened people.
በመስክ ጉብኝቷ ማጠናቀቂያ.	on the last lap of her journey.
አሁንም ቢሆን ንሰሀ መግባት ጌታን መማፀን ማልቀስ ይጠበቅብናል።	We have to respond by crying out to the Lord.
በቀጣይ ደግሞ 250ሺ ሰዎች ተሳታፊ ይሆናሉ ብለን እንጠብቃለን።	in which 250,000 people will take part.
ቀደም ብሎ በዚህ መስክ ውስጥ አሁንም ነው, ነገር ግን እዚህ ላይ የእኔ ተወዳጅ ምሳሌዎች ሁለት ናቸው.	I am in the process of thinking for this but here are my first two ideas.
በዚሁ መሰረት በግንባታ ዘርፍ የተሰማራችሁ፣	which you installed the game).
ይህን ያህል ዓመት ስትቆይ አትክልት ለመግዛት ገበያ ወጥታ አታውቅም።	For years, you got the milk while having no intention of ever buying the cow.
ኤርምያስ 22:10 - Correct Me ከእንግዲህ ወዲህ አይመለስምና፥ የተወለደባትንም አገር አያይምና ለሚወጣ እጅግ አልቅሱ እንጂ ለሞተ አታልቅሱ አትዘኑለትም።	"Jeremiah 22:10, NIV: ""Do not weep for the dead king or mourn his loss; rather, weep bitterly for him who is exiled, because he will never return nor see his native land again."""
አመለከተ 4በፍጥነት ላከ	As a consolation, the four-speed transmission made a very decent impression.
የብር ማጠናቀቂያ ፓይ .	Remnants of silver finish.
ልጆች በአንዱ ወይም ከዚያ በላይ በሆኑ አካባቢዎች ችግሮች ሊያጋጥሟቸው ይችላሉ-	Children may experience difficulties in one or more of these areas:
ብዙውን ጊዜ እነዚህ አማራጮች ናቸው-	These are often the cheapest option -
ጀብደኛም ብቻ ሳይሆን ባለጌም ነው!	It's not only unsanitary but just plain gross!
ኢዮብ 26:9 - Correct Me የዙፋኑን ፊት ይከድናል፥ ደመናውንም ይዘረጋበታል።	Job 26:9 He holds back the face of his throne, and spreads his cloud on it.
"""አሁን የነገርናችሁን ተግባራዊ ካደረጋችሁ በአምስት ዓመት ውስጥ ለውጥ ታመጣላችሁ"" አሏቸው።"	"But if you'll make a new decision right now, in five years you'll be in a new place."""
ሰላማዊ ትግል የራሱ መደላድል አለው።	The related war in Syria has its own twists.
እኛ ደግሞ ወደ ሌሎች አውሮፓ እና ወደተቀረው ዓለም ወደ ሌሎች አገሮች መላክ እንሰጣለን ።	We also deliver to parts of Europe and the rest of the world.
በዚያው ልክ ዱባይንም እንዲያዩ ማድረግ እፈልጋለሁ።	I want to throw up when I see the face of Dubya.
አውዳመት የኛን ያህል የሚደምቅለት አለ ግን?	Is there any of your mission that overlaps with ours?
ማህበራዊ ሰራተኛ ጓደኛ መለያ ይስጡ.	The association of social groups employ to make a solid presentation.
እያሱ መሳፍንቲ ሩት 1ይ ሳሙኤል 2ይ ሳሙኤል	Joshua, Judges, Ruth, some of 1 Samuel
የሙከራው ውጤት በጣም ደስ የሚል ነበር.	The results of the experiment were pleasing.
ልጆችሽም እኛ እንነሣለን፥ ስናመሰግንሽ እንዲህ እንላለን።	Your children will thank you for it when they grow up.
♫ አዳዲስ የልደት መዝሙር ስብስቦች New	A compilation of new love songs
ግን ዛሬም ርቀት እና ጭርታ ጋርደውት ፍዝዝ ብሏል።	But as of today, it's out with thigh gap and in with the booty.
የሚለያዩት በስሙ ነው።	Are separate from your name.
፡ ጠሪዎቿም በጣም ሀብታሞች እንደሆኑ ነው የተናገረችው።	There were her ostentatious displays of wealth.
26 ስለዚህ ጐበዛዝትዋ በአደባባይዋ ላይ ይወድቃሉ፥ በዚያም ቀን ሰልፈኞች ሁሉ ይጠፋሉ፥ ይላል የሠራዊት ጌታ እግዚአብሔር።	"Therefore her young men shall fall in her streets, and all the men of war shall be cut off in that day, saith the LORD of hosts."""
ድህነቱ እየጠና ሲሄድ ሕይወት ከባድ ትሆንባቸው ጀመር።	But as the hot summer continued, life became incredibly difficult.
"""ስምህን ለወንድሞቼ እነግራቸዋለሁኝ።"	"""I will proclaim your name to my brothers and sisters."
ገንዘቡን ያውጡ ፣ ሙያዊ ይመስሉ ፣ የበለጠ ትኩረት ያገኛሉ - ቃል እገባለሁ ።	I know the skirt is going to be a firm favourite, you'll be seeing more of it, I guarantee..
የብሉይ ኪዳን ትንቢቶች ከአንድ በላይ የሆነን ነገር የሚያመለክቱበት ጊዜያት አሉ።	In addition, there are prophecies in the Old Testament that have more than one fulfillment.
{0} መቅረብ አለበት	That's got to be near
ይሁንና ከአራት ዓመት በኋላ ከባለሀብቶቹ መካከል የተወሰኑት ቃል የገቡትን ገንዘብ ሙሉ በሙሉ አላስገቡም ሲሉ ምንጮች ገልጸዋል።	But four years on, much of Beijing's promised investments have not materialised.
የንግዱ እንቅስቃሴ ለመደገፍ በቂ የስራ ካፒታል አለ ጊዜ ስር-አቢይ የሚከሰተው.	Under-capitalisation occurs when there is inadequate working capital to sustain the activities of the business.
"""ከመረዳት ችሎታ ሁሉ በላይ የሆነው የአምላክ ሰላም"""	"""The peace of God transcends all understanding."""
በአሜሪካ ደግሞ ኢኮኖሚው በፖለቲካው ላይ ሥልጣን አለው።	In the United States, the Federal Reserve is in charge of monetary policy.
የሰማያዊ ፓርቲ ሊቀመንበር ኢንጂነር ይልቃል ጌትነት ከዚህ የተለየ አመለካከት ነው ያላቸው።	In this case, the institution of Human Rights Ombudsperson takes on an entirely different appearance.
ይህ በሰፊው በር መቆጣጠሪያ ላይ ውሏል, ጊዜ ቀጂ, የእውነተኛ ጊዜ እየተዘዋወሩ እና የመኪና ማቆሚያ ወዘተ, ትልቅ ተስማሚ, መካከለኛ እና አነስተኛ ኩባንያዎች, ፋብሪካዎች, ትምህርት ቤቶች, አፓርትመንቶች, የመኖሪያ አካባቢዎች, ወዘተ.	It is widely used in door controller, time recorder, real-time patrol and parking lot etc, suitable for large, medium and small companies, factories, schools, apartments, residential areas, etc.
የምንፈልገው መልካም ነገር የማይፈጸመውስ ለምንድን ነው?	Why are we so easily tempted to avoid the inevitable of what needs to be done regardless of any deadline?
7 - ለመራመድ አትፍራ።	6 - Never be afraid to walk away.
የተስፋን ፡ ቃል ፡ የሰጣችሁ ፡ የታመነ ፡ ነውና	He is faithful to give you what He has promised.
ገጽ 4/5: ርዕስ ለ፡- በፕሮግራሙ ውስጥ የመጀመሪያው መልመጃ	Chapter 4 (v.1) - first order of business
በዚህ ምስል ላይ ትንሽ ማየት እንችላለን-	You can see it a little better in this picture...
አሁን ከቤተሰቤ ጋር ጥሩ ጊዜ ማሳለፍ እፈልጋለሁ።	I want to spend good time with family.
- ዮሐ 1ዐ ፡ 38 አብ በእኔ እንደ ሆነ እኔም በአብ እንደ ሆንሁ ታውቁና ታስተውሉ ዘንድ	"John 10:38 believe the miracles, that you may know and understand that the Father is in me, and I in the Father."""
የእኛ አካባቢዎች:	in the area of our towns:
ለ) በጣም ብዙ ውሃ	C. A lot of waters
እንዲሁም የእኛን ምርት በመጠቀም ሁሉም ተጫዋቾችን ማስከፈት ይችላል.	could collaborate with others to jointly benefit from the use of our products.
የሚገነባው መንገድ ርዝማኔ በኪ.	Divide by the length of the building to get slope.
አንተ rebuy ይችላሉ 5 ጊዜ.	You can change it 5 times.
77% የሚሆኑት ፈጠራዎች የፈጠራ ግምገማ እና የማፅደቅ ሂደት አስጨናቂ እንደሆነ ይስማማሉ	78% agree that digesting, analyzing and interpreting the volume of data is a challenge
በቅርብ ጊዜ ያልተነበበ መልእክት አሳይ እኔ ሰው ነኝ	I'm a former athlete recently diagnosed
በትዳር አርባ ስምንት ዓመት ኾኖናል።	They have been married forty-eight years .
ይህ ሁሉ አንድ ላይ ነው?	Do have it all together?
"31እነርሱ ግን፣ ""ታዲያ፤ እኅታችንን እንደ ዝሙት አዳሪ ይድፈራት?"	"31But they retorted, ""Should our sister have been treated like a harlot?"""
እናም ከቤት ዋሉ።	So they run away from home.
ሰላም አይደለም እንዴ?	Peaceful isn't?
ተከፍተው ባየ ጊዜ፥ እስረኞቹ ያመለጡ መስሎት ራሱን	When he saw the doors open, he supposed that all the prisoners
በመኪና ስፍራዎች የሚሸጡ መኪና	"""The private cars of elite cadres are North Korea's emergency vehicles"""
ዛሬ እየገመገም ያለነው ካርድ በአም.	The card that came for us today is Moving On.
"""የውጭ ምንዛሪ ችግር በእድሜዬም ይፈታል ብዬ አስቤም አላውቅም።"	"""I did not think that problems with potency would appear at a young age."
እና በእምነት ውስጥ ቁሙ.	Stand fast in the faith.
ኑ እና ጣቢያዬን ያነጋግሩ ።	Come on over and talk my site.
የምርጫ ሰሞን ወከባን ለማስቀረት ብልሃቱ ዝግጅት ብቻ ነው!	And of course it is timed to come in BEFORE the next Election - it will be only one of their pre-election bribes to try and win votes!
አንተ ኖርዊይ ለማለት.	to The Norwegian.
ስብሰባዎቹ ላይ የተለየ ሃሳብ ያንፀባረቀ ብዙ ችግር ይደርስበታል።	Litigating disputes in these cases presents a number of special challenges.
ሦስቱም ቡድኖች ከእኛ የተሻሉ ናቸው።	All five teams are better than us.
መሰናክሎች ሁሉ ቢኖሩም ይህ ጥራት አስፈላጊ የሆነውን ኃይል ይሰጠናል ።	They still exist all over the world, give the courage we need.
ስለዚህ የሪቻርድ ፓንክረስትን ብቻ ዋቢ ማድረግ በቂ ነው ብየ አላስብም።	As I understand it, it is not sufficient to simply ignoring the rthdr0 headers.
1 በ% ዶላር ማከማቸት.	fractions of 1% of price.
የአንድን ሰው ቀን የበለጠ ብሩህ ለማድረግ ቀላል መንገድ >	It's so easy to make someone's day brighter.
በውስጡ ማክ ስሪት ሊወርዱ መስመር ላይ ነው እና በነጻ ነው.	iTunes Radio will be launched in the fall and will be free.
ሙሉ በሙሉ ረድቷል ።	totally helped.
ለማመልከት ማህበራዊ የዋስትና ቁጥር አያስፈልግዎትም።	They do not require social security number.
ስእል 8 የአሁኑን የተገለጠውን አጽናፈ ሰማያችንን ምልክቶች ያሳያል።	Figure 8 shows the photographs of the fabricated antenna.
ደስ ይበለን ደስ ይበላችሁ ነው የጭፈራው መልእክት።	We were very pleased to receive a letter of appreciation, which articulates a strong message of hope.
ጠቅላይ ሚኒስትሩ የሁለት ቀናት ጉብኝታቸውን አጠናቀው ወደ ሃገራቸው በዛሬው እለት ተመልሰዋል።	The trainers are finished the two-month-long tour and head back to Brisbane today.
የጳውሎስ ጌታቸው ተመሳሳይ ድህረ ጨዋታ አስተያየት	served a similar gesture of fair play from his fellow
ሲ ፕሬዝዳንት ከአንድ ወር እስራት በኋላ ከእስር ተፈተዋል ።	The chief engineer was sentenced to one month in jail.
በዚህ ደረጃ የሚጠሉት ደመኞች ነበሩት እንዴ?	Wasn't he someone who hated this kind of things?
እሱ ራሱ ክሪስ ሃምስዎርዝ አይደለም ማለት ይፈልጋሉ?	Isn't he half-Jewish himself?
የምታቀርቡት ቅሬታ ምንም መሰረት የሌለው ነው።	His complaint isn't baseless.
የተቋረጠው የሶሪያ የሰላም ንግግር	Thus, the religious overtones of the Syrian Civil War has perpetuated the conflict
በእያንዳንዳችን ልብ.	in the heart of each of us.
ከዚህም የከፋ ችግር ደርሶብን ሊሆን ይችላል።	We might have a bigger problem.
ከእነዚህ ‹የብሎግ አሰልጣኞች› መካከል የተወሰኑት የድሮውን የእባብ ዘይት ሻጮች ያስታውሱኛል ።	"Some of these ""agents"" remind me of ambulance chasers."
""" ባለፉት አራት እና አምስት አመታት ከተለያዩ ክለቦች ጋር አልፌያለው።"	In the last four or five years, I've met a lot of influencers.
የእርስዎ የኩላሊት ጤናማ አይደለም ከሆነ ወዲያውኑ እነዚህን ኪሚካሎች ሆነው ይቆዩ.	If you're having drainage problems, don't immediately reach for chemicals.
የእኔ ተወዳጅ ስፖርት...	my favourite game...
ለዚህም ማሳያው ብዙ የማያውቅሽ ሰው ሲያምንሽ ታያለሽ።	You will have to believe on a person who is completely unknown to you.
ያዉ የተመረጠዉ ሰው እግዚኣብሔር የላከዉ ሰው ብቻ ነው እና ኣሁን	they are the chosen people of the only one true God and that He
ይህ ካልሆነ በስተቀር አገሪቱ ከፍተኛ አደጋ ውስጥ እየገባች መሆኗ ነው የሚታየኝ።	If that is the case, the country appears to me to be in serious trouble.
የዚግዛግ ሰርvo አስተላላፊ ማሽን በሚገርም አመጋገብ ውስጥ አስገራሚ ምርታማነትን ይሰጣል ።	Mozart's Magic Flute in a charming children's version.
አቶ ኮሚሽን ስብሰባ ያያዘ በእያንዳንዱ ወር ግን ሊቀመንበር መብት አለው ስብሰባዎች እዳም	elected president, he would hold a press conference every month to communicate with the
ሁሌ መለመን ግን ህመም ነው።	The problem of choice is always painful.
መጪው ዘመን እኮ የእናንተ ነው።	Future will be yours.
ቀጥሎ ያለው ሕይወት የጉስቁልና ሆነ።	truth of the next life becomes a true comfort.
11ኛው ሰዓት ደርሷል!	The 11th hour has come.
ከንፈራችንን ሊፕስቲክ ተቀብተን ለረጅም ጊዜ እንዲቆይ.	Primer lets the lipstick stay on for a long time.
77% የሚሆኑት ነጋዴዎች አሁን የይዘት ግብይትን ይጠቀማሉ እና 69% የሚሆኑት ምርቶች ከአንድ ዓመት በፊት ከነበረው የበለጠ ይዘት ይፈጥራሉ ።	More than 75% of B2C marketers are using content marketing, while 69% are creating more content now than they did a year ago.
ወርኀ ዘር㗹 ነው ቢለው።	If what he alleges is a mere cavil, make him see that it is a cavil.
ፈተናውን ለመጋፈጥ አትፍሩ!	Do not be afraid of temptation.
አሁን አየ አይኔ፣ አሁን አየ አይኔ.	Now I open my eyes, and now I see.
አክስቱ አስቀያሚ አይደለም ።	But the Aunt isn't pregnant.
ማንኛውም ማናቸውም ተክል የእራሱ ባህሪያት እና ፍላጎቶች ያለው ህይወት ያለው ፍጥረት ነው.	Each book seems to be its own creature, with its own demands and needs.
እዚህ ሁሉም አንጓዎች የድንበር አንጓዎች ናቸው ።	All the houses here are log chalets.
እነሱ ቀቅለው እንደሚበሏት ሲነገራት የኖረው ትውስ ቢላት ልትሸሻት ሞከረች።	She says that after initially attempting to strangle her, he pursued her when she tried to flee.
በደላችሁ በደላችን ነው።	Your faults ARE your faults.
የመሬት ላይ ምልክቶች.	Signs on land.
ከዚህም በላይ እነሱ ቀድሞውኑ ናቸው።	And in fact, already have been.
ከጊዜ በኋላ በሰዎች የፀጉር መርገም ላይ በሰውነት ውስጥ ወደ ሌሎች የሰውነት ክፍሎች ተሰራጭተዋል.	Due to that at some point in age men get reduced in blood flows to the different organs of the body.
ወደ አሜሪካ ለመጓዝ የሚያስፈልገዎን የቪዛ አይነት ይወስኑ።	Determine the type of visa required to travel to the United States.
አሁን ይህን ጊዜ ፣ በጣም ሳትደክሙ፣	This time you don't get so easily,
መቼ ነው ወደ ሜክሲኮ የሚደርሱት	by the time it reaches Mexico
"ካብ ጋ አትጠጋ እላይህ ላይ ይፈርሳል አምላክን የምለምነው ሦስት ነገሮችን እንዲሰጠኝ ነው:- """	When it comes to surrendering to Him, I believe there are 3 things we need to surrender to God:
ጠቅላይ ሚኒስትሩ በአገር ውስጥ ከህዝቡ ጋር ተቀራርበው ሃሳብ መቀበላቸው ስኬታማ እያደረጋቸው ነው።	However, with the Swedes at the front was accompanied by his success.
በሞዴል መልክ የቀረጽነው መተዳደሪያ ደንብ ዝቅተኛ ማሟላት ያለባቸውንን ነው።	We ought to be supported to the medieval models in certain constraints.
ይህ ሥነ ምግባር የጎደለው የንግድ ግብይቶች እንዳይከሰቱ ያቆማል።	prevent them from adopting unethical business practices.
በሄድንባቸው ቦታዎች ሁሉ ያጋጠመን ማራኪ ነገር ብል ማጋነን አይሆንብኝም።	I'm not surprised as there are nature spirits around wherever we go.
- ለውጥ ምክንያቶች ተለይተው ይታወቃሉ	are known to be the cause of mutations
በብርሃኑ ጨረር ዓይኖቹን እያጥበረበረ ‹‹እኔ እንደዚህ ዓይነት ነገር መፃፍ ቀርቶ አስቤም አላውቅም››በማለት የክሕደት ቃሉን ገፋበት።	"He sat down with Sports Illustrated and discussed his historic career: ""I never thought it would be like this."""
አሠሪው ደግሞ ለሚከፈለው ክፍያ አገልግሎት ያገኛል።	That's why the employer is willing to pay for the labor services.
የህዝብ ልጆች ።	Child of the people.
"የምርጫ አስፈጻሚዎቹ ""የድምጽ አሰጣጥ ሥነ ሥርዓቱን ጠንቅቀው የማያውቁ ናቸው"" በማለትም ተችቷል።"	"He claimed that those who voted to leave did so unaware, ""the people voted without knowledge of the true terms of Brexit."
ይህ ገጽታ ያለዉ ግለሰብ እንደአስፈላጊነቱ ወደ አደላዉ ክፍል የሚገለባበጥ በሁለት ተቃራኒ ጎራ ተመቻችቶ ለመቀመጥ የሚያስችላቸዉ መላ እየዘየደ የሚኖር ግለሰብ ነዉ።	This is a White House full of unreliable narrators with people leaking information to sort of stab in the back someone else who is in a different faction.
የግሪን ሃውስ ስርዓት በ 1 ዋና ርዕስ ስር ቁጥጥር ይደረግበታል።	The national champion jersey is regulated in articles 1.
ዜናውን ሲቋጭ ደግሞ ሃቁን አስቀምጧል።	Before fake news, she captured the truth.
ከኩባንያው ዕዳ እና የብድር መጠን ጋር ይዛመዳል ።	This will affect your credit and debt to income ratio.
ዝገቱ የጉድጓድዎ ትልቁ ጠላት መሆኑን ማወቅ አለብዎት።	You need to understand that the greatest blocker is your own willpower.
እኔ ራሴ ቃል እገባለሁ	And so I pledge myself to it,
ለኛዎቹ ተቃዋሚዎች ይህ የጋምቢያ ፈተና የ1997 ዓ.	The findings with regards to the positive selection of our sample of asylum seekers is consistent with Chiswick's (1999, p.
በዚህ ወሳኝ ተግባር ላይ የሃገሪቱ ምሁራን ተሳትፎ አጽንዖት ሊሰጠው ይገባል።	The state's excellent universities should be heavily involved in this process.
ወሲብ ትዕይንት- ስለጀመሩ	"elizabeth says: ""Could not put it down"""
የአካዳሚክ ማመልከቻዎች ረቡዕ ጃንዋሪ 13 ናቸው ።	Pacific Awards Night is on Wednesday 13 June.
ይህ ብልሹነት መቆም አለበት!	This lack of transparency has to stop!
ዘይሄይስ እምኔሃ ወቦቱ ንቀርቦ ለእግዚአብሔር	In his commitment to protecting the innocent, he has transcended to near godhood.
በዚህም አዲስ ተደራጅተው በመጡ ሰዎች ስር እንድንሰራ ሆኗል።	At the same time, we have adjusted to life under new owners.
Teemu Pukki እስከዛሬ ድረስ ያቆየው በጣም አስፈላጊው የልጅነት ትውስታ ከዚህ በታች ካለው ፎቶ ተብራርቷል።	The important dates of Chhath Puja 2013 have been mentioned below.
ይኽቺ ሴት በዘመኑ እግዚአብሔርን እጅግ የምትፈራና የምታመልክ ሕጉንም የምታከብር ናት።	I want to be the wise woman who fears the Lord and honors Him daily in her life.
ሕልሜ እውን እየሆነ ነው.	My dream is coming into reality.
ከታላቅ አክብሮት ጋር፣	With great humility,
25 _Lucas 21:25_ በፀሐይና በጨረቃም በከዋክብትም ምልክት ይሆናል፤ በምድር ላይም አሕዛብ ከባሕሩና ከሞገዱም ድምፅ የተነሣ እያመነቱ ይጨነቃሉ፤	Luke 21:25-27 And there shall be signs in the sun, and in the moon, and in the stars; and upon the earth distress of nations, with perplexity; the sea and the waves roaring; [26] Men's hearts failing them for fear, and for looking after those things which are coming on the earth: for the powers of heaven shall be shaken.
ግን ለምን ለአንዳንዶች እንጂ ለሌሎቹ አይሰራም?	So why does it work for some, and not for others?
አገርና ህዝብ እግር ከወርች ታሰሩ።	Since the Fall, the earth and its people have been on a downward trajectory of decay.
ሰው ሳይነግረው ቀርቶ ነው?	Was he trying to send a message to a witness?
ወይስ የባሕርን ዓሣ ሁሉ ያጠግባቸው ዘንድ ይሰበሰብላቸዋልን?	"Or shall all the fish of the sea be gathered for them to provide enough for them?"""
ሰኞ፣ ታኅሣሥ 24	Monday, December 24,
ለሁለት ቀናት የሚደረገው ይህ...	- This occurs for two days...
በአምላኪዎቹ ይሳማል።	of his worshipers.
ደህና ፣ በመረቡ ላይ እንኳን:	Welcome to your on-line login...
እንዲሁም በፀሐይ ላይ በእግር መጓዝ ይችላሉ!	We could walk in the sun!
አይኤችጂጂ አውስትራሊያ ፣ ኒውዚላንድ እና ደቡብ ፓስፊክ ኃላፊ .	Servicing Australia, New Zealand and the South Pacific Regions.
ይህ ያነበብኩት ትልቁ ሞኝነት ነው ።	This is the stupidest thing I ever read.
ይህን ያህል በእብሪት የተወጠረበትስ ምክናያት ምንድን ነው?	What are the basis of such serious accusations?
ወደ ፡ ቀድሞው ፡ ሕይወት ፡ ለክብር ፡ መለሰው	(Mighty & Majestic) has granted him the praiseworthy station in the Hereafter.
የራሳችሁን ችሎታስ በደንብ አውቃችኋል ?	Do you know all the abilities of yourself?
17 ባዩትም ጊዜ ሰገዱለት፤ የተጠራጠሩ ግን ነበሩ።	17 When they saw him, they worshiped,[d] but some doubted.
እኔ በመጀመሪያ ከ IRS ጋር ፓራ-ህጋዊ ነበርኩ ።	I was at first a para-legal with the IRS.
ሁለቱ ስቴቶች እንዴት ይተሳሰራሉ?	How are the two strophes enacted?
እና ሳልቶ ከሁሉም በላይ የበይነመረብ አገልግሎት ስለሆነ .	The last, but certainly one of the most crucial marketing services, is Web Traffic Optimization (WTO).
ቀላል ደረጃ #1: ሁሌ ፈገግ በል	My number one rule: keep smiling.
ይሁን እንጂ በቀረበልን...	We're getting closer though..
የበዓል ወቅት በእኛ ላይ በመጣ ቁጥር ብዙ ሰዎች ለረጅም ጊዜ ከቤት ይርቃሉ ።	Be with our families as many of us are away from home during the week.
ውስጧ ለምንም ያልነገረችው ማንም ያላዳማጣት ብዙ እውነት አለ።	the big question is, why didn't she tell anyone about it? apparently no one corroborated her story.
እነዚህ ሠራተኞች የዳኝነቱ አካል ናቸው።	These soldiers are part of security.
በእግዚአብሔርና በሥራው ብቻ ተደነቅ።	God bless him and his workers.
ለራሳቸውም የጥጃ ሐውልት* ሠርተዋል፤ ለእሱም እየሰገዱና መሥዋዕት እያቀረቡ 'እስራኤል ሆይ፣ ከግብፅ ምድር መርቶ ያወጣህ አምላክህ ይህ ነው' እያሉ ነው።	They made for themselves a calf and did obeisance to it and offered sacrifices to it, and they said, 9 'These are your gods, Israel, who brought you up from the land of Egypt.'
ScoreNEET ጋር ፈተና ውጤት እንዲል.	Console will show the progress of Test case.
የቦታ ማስያዣ መስኮት አሁን እስከ ታህሳስ 31 ቀን 2021 ድረስ ነው።	Booking window is now through December 31, 2021.
ቢያንስ ከመጀመሪያው ።	At least, from the start.
በየውድድሩ መሻሻል እየታየ ሲሆን፤ ይህም በተለያዩ መንገዶች ይረጋገጣል።	points on the Earth's surface, and this is accomplished in a number of ways.
እንደ አገርም የስብሰባ ማዕከል ናት ማለት ይቻላል።	It's like the meeting ground of the world.
"""ዕጣ ፈንታ እንዲህ ዓይነት አጋጣሚዎች ስለሰጠኝ ከመጠን በላይ ዕድለኛ ነኝ"" አለኝ."	"I am thrilled beyond words to have this opportunity."""
A: አዎ ይህ አዲስ መተግበሪያ ለሞባይል ምቹ እና በብዙ አሳሾች ላይ ይገኛል ።	A) Yes, this app is available for download from both popular mobile platforms.
ወደ ቅዱስ ጊዮርጊስ ትመለሳለህ?	Would you go back to the mormon church?
- ወይም መደበኛ ስሪት ፣ ግን በኮምፒተርዎ ኃይል ላይ በመመርኮዝ በ FPS ላይ ከፍተኛ ተጽዕኖ ሊያሳድር ይችላል።	- Or a normal version, but can have a considerable impact on FPS, depending on the power of your computer.
ለግል የሥራ ጉዳይ እየሄድኩ ነው።	I am selling due to personal issues.
በእርግጥ ግምት ውስጥ የሚገባ ኢኮኖሚም አለ ።	There is an economic reality to consider.
ይህ በሚከተሉት ደረጃዎች ውስጥ ከመተው ይልቅ የሚከተሉትን አስተያየቶች በራስ ሰር ይቀበላቸዋል እና ያጸናቸዋል.	This is so that we can automatically recognize and approve the following comments instead of keeping them in the moderation queue.
ነገር ግን እያንዳንዱ ጉድጓድ መሞላት የለበትም.	Not all shelves must be filled.
ወይስ የማደርጋቸው ውሳኔዎችና ቅድሚያ የምሰጣቸው ነገሮች መጨረሻው በቅርቡ ይመጣል ብዬ እንደማልጠብቅ ይባስ ብሎም መጨረሻው መምጣቱን እንደምጠራጠር ያሳያሉ?	Or maybe my priorities and criteria are misplaced, and we're not supposed to have an impact on the world at large?
ተታኩሰን ወደ ጫካ ወጣን።	We took off into the woods.
vMix 18 በይፋ ተለቋል	the knob 18 will be turned to the desired temperature
አንደኛ የነጻነት ጉዳይ ነው።	Second, it is about freedom.
በ2014 አብዛኛው የአሜሪካ ዜጋ አቅማቸውን ያመጣጠነ የጤና ዋስትና ይኖራቸዋል።	In 2014, most Americans would be required to carry health insurance.
የእነሱ ልጆች አይደላችሁም!	"""They're not your children!"""
ለዚህ ዝርዝር እናመሰግናለን ፣ ዲ.	Thank you for this list, CF.
በጣም ወጪ የሚያስወጣውን ካላሰብን አንድ ነገር ትርፋማ ነው ማለት እንዴት እንችላለን?	How can we be charged an over-limit fee when we hadn't been approved to charge any money?
በመሰረቱ ከእነሱ ጋር መነፃፀሩም ያንን ያህል ተገቢ አይደለም።	In theory at least, these aims are not incompatible.
ለሚቀጥለው ዓመት የቀረበ ሀሳብ?	Plans for the upcoming year?
ይህ ድጋፍ እናንተ ይምረጡ ማግኘት እና ቀኝ እንዳደረገ ስራዎች ለማግኘት ተገቢ መሣሪያዎችን መጠቀም ይረዳል.	This article has been compiled to help you choose the right adverts and to help ensure they're delivered right.
እንግዲህ የምትበሉ ወይም የምትጠጡ ብትሆኑ ወይም ማናቸውን ነገር ብታደርጉ ሁሉን ለእግዚአብሔር ክብር አድርጉት።	"""So whether you eat or drink or whatever you do, do it all for the glory of God"" (NIV)."
"እንደኾናችሁ (መልሱልኝ) "" በላቸው።"	"Tell them, ""Well, [pause] if that's your kind of thing."""
እርሱ መንግሥቱን ሊያቆም እስኪመጣ ጦርነቶቹ ይካሄዳሉ።	He will be there until He comes back to establish His Kingdom.
ተማሪ መረጠውም አልመረጠውም ማለት ነው።	The gelernt does not elected.
በስህተት የ SD ካርድ የተመሰጠረ ነው.	The setting error of SD card is corrected.
ዘማሪዋ በማወቅም ይሁን የገጣሚውን ማንነት ካለመረዳት የመጣ የዋህነት የተጠቀሱትን ስንኞች ዘምራለች።	Whether it's a rendition of a well-known song or a traditional melody, you cannot help but think of romantic vibes when hearing these soft sounds.
ለማድረግ ባለመቻሉ ያዝናል, ተመሳሳይ በማውረድ አይገኝም.	In fact they will feel sorry at their inability to perform the same acts.
በመጀመሪያ ደረጃ ላይ አንዲት እርጉዝ ማርባት እንድትችል ዋና ዋና ምክንያቶች ምንድን ናቸው?	What is one of the main reasons you may choose to use an incubator?
እርሱም ወደ ውስጠኛው መቅደስ በሮች የተቀረጸው, ያውና, ቅድስተ ቅዱሳን ስለ.	And he engraved the doors of the inner temple, ಎಂದು, for the Holy of Holies.
አንድ ነው ፍቅር።	It is One Love.
ተጫራቾች የጨረታ ማስከበሪያ ቢድ ቦንድ 10% በባንክ በተረጋገጠ የክፍያ ትዕዛዝ ሲ.	The Finnish operator will retain a 10 percent minority stake in Vertu, which makes gold-plated devices.
እዚህ ካነሳሁት የመነሻ ሀሳብ የበለጠ ሀሳብ ያላቸው ሰዎች እንዳሉም አውቃለሁ።	I'm sure there are people with more creative ideas than me.
ልጅዎ ታሞ ከሆነ ለተወሰነ ቀናት እቤት እንዲቆይ ማድረግ	Man dies after being tied up in his home for several days
ጥሩ, እዚህ ላይ ነው ዕድል!	the good luck is here!
ይህ ተጽዕኖ ለማስፋት ጥሩ አጋጣሚ ነው.	This is a perfect opportunity to expand.
"አንድሩ ""ሀብታም ችሎታ ያለው ባለሙያ ነው"" ብሏል።"	"""He's a tremendous skater with tremendous skill,"" says Ron Anderson."
እንዲህ በማድረጋቸውም አድናቆት ሊቸራቸው ይገባል።	For doing so, they are to be commended.
መስቀሉን እንደያዘ ወደ ምድር ተደፋ።	poured out his vial upon the earth.
READ ኢትዮጵያን ለመጉዳት በአሜሪካ ኮንግረስ አባላት የተጠነሰሱ ሁለት ረቂቅ የውሳኔ ሐሳቦች መከኑ ተባለ	Learn to describe two pieces of legislation introduced in the US Congress to support health promotion.
ለምሳሌ ፣ አንዳንድ ስካነሮችን ብቻ የሙሉ መጠን ከፊል-ሊስተካከል የሚችል አርቲፊተሮችን በቀላሉ መቃኘት ይችላሉ።	For instance, the Rom cartridges may only render a certain quantity of textures which restricted the overall graphics capabilities of the system.
org - አሁን መቼ ይሁን?	- ESG - if not now, when?
የምንኖረው በመጨረሻዎቹ ቀናት ውስጥ ነው?	Are We Living in the Last Days.
5 _Atos 3:5_ እርሱም አንድ ነገር ከእነርሱ እንዲቀበል ሲጠብቅ ወደ እነርሱ ተመለከተ።	Acts 3:5 - And he looked on them, expecting to receive something from them.
28 ወደ ቤትም በገባ ጊዜ ዕውሮቹ ወደ እርሱ ቀረቡ፥ ኢየሱስም።	28 When He entered the house, the blind men came up to Him, and Jesus *said to
መ/ቤቱ የድጋፍ ሠራተኞች ደንብ ልብስ ግዥ በግልጽ ጨረታ አወዳድሮ መስጠት ይፈልጋል	The Ministry of Finance proposed the abolition of mandatory indexation of salaries of civil servants
የሰውን ልጅ ወደ ራስ የሚያደርሰው መንገድንቁ ዘላለማዊነት በሁሉም ሰው መጓዝ አይችልም።	The Way which leads the human to Self-conscious immortality cannot be traveled by everyone.
የሶኖማ ሐይቅ ክፍት ነው?	How's the fishing right now?....Is the lake open?
እርስዎ የጎራ ስም ጠቃሚ ነው ብለው ላይሆን ይችላል, ነገር ግን ይህ ነው.	You may not think jewelry is important, but it is.
ገንዘብ ሃይል ነው።	Money is a power.
ዛሬ ሁሉም ሰው ሞባይል አለው ።	Today's everyone has a mobile phone.
ሂደቱ በሳምንቱ መጨረሻ ላይ መከናወን አለበት.	Work must be finished by the end of the week.
ቤተክርስቲያን ናት ክርስቲያኖች ስለ አምላክ ቃል የበለጠ ለማወቅና እርስ በርስ ለመበረታታት የሚሰበሰቡበት ቦታ.	I believe Church is where people gather to hear the word of God and communicate with one another.
ስለዚህም ከደቡብ በኩል ያለዉን አዲስ ሃይል ኦህዴድን ጨምሮ empower ማድረግ ነዉ ዋናዉ የሱ ስራ።	There is, in other words, capacity for doubling Acela service south of New York, where the highest demand is.
የህትመት Fest ን ይክፈቱ.	In Korea, the Deluxe Edition came with a poster.
ከሁለት ጓደኞችዋ ጋር ቤት ተከራይታ በጋራ መኖር ጀመረች።	She met her partner through mutual friends and they soon started living together at his mother's house.
Apple ስለ ቀኑ ጊዜ አትናገሩ ።	Don't talk about the weather.
የውድድሩ ኮከቦች (ሁሉም ዋንጫ ተሸልመዋል)	Children of the Damned Cover (All Guitars)
እኛ ይሄን በቃለ ጉባኤ ይዘን ኮሚቴ አቋቁመን የንብረት ቆጠራ አካሂደን፣ ጉዳዩን ለፖሊስ አመለከትን።	We ran a program on racial profiling, and we involved the police to discuss that with the young people at the centre.
በጥሩ ሁኔታ ግብይት እና በማስታወቂያ ስልቶች ላይ ከመጀመሪያው ጀምሮ ኢን investስት እንዲያደርጉ እንመክርዎታለን።	Our experience provides you with the comfort of having the right advice and investment strategy from the beginning.
ይህ ይሆንላቸው ዘንድም ድርድሩን ወደ አሜሪካ ወሰዱት።	I wish that they'd bring the bundle to America.
ይህ ባነር በየ መንግስታዊ ተቋሙ ተሰቅሎ ይገኛል።	This man has now been emboldened by the government.
የግሉ ዘርፍ ማሳተፍ እና በዚህ ገበያ ላይ መዋዕለ ንዋይ ማፍሰስ በረጅም ጊዜ ውስጥ አቅም የመጠበቅ አቅሙን ይቀንሳል.	Corrosion caused by humidity and salt in the air can reduce the performance of plants in the long term.
በስልክዎ ላይ የሲቲኤ አውቶቡስ እና ባቡር ጊዜ.	Its handy for bus and train station.
እንግዲህ የምዕራባውያን ድንጋጤ የሚጀምረው እዚሁ ጋር ነው።	This is where the real Wild West begins.
የሚል አገርና ዜግነት አልነበረም አሁንም የለም።	But still not Nationality.
አያ ጅቦም ሌሎቹ እንደጠየቋት ጠየቃት።	She asked if she could help him to which Groves demanded her driver's license.
በዲፕሎም የተመረቅሁት የአካውንቲንግ	My team's project, of which I was the main developer, was selected by the client and was used as the foundation of democracity.ca.
እናላችሁ... ተማሪዎቹን ስለ ውሸት ሊያስተምራቸው ይፈልጋል።	He's a ... Get the pupils to point to the correct people.
ወይንስ አይፈልጉም።	They won't import cattle.
"እነሱም በጣም ፈሩ "" (Lk 2,9) ።"	"They were terrified..."" Luke 2:9 (NLT)"
24:15 በዚህ ምክንያት, ትምህርት ውስጥ ጌታን ያመስግን: በጌታ ስም, የእስራኤል አምላክ እግዚአብሔር, በባሕር ደሴቶች ላይ.	24:15 Therefore glorify ye the Lord in instruction: the name of the Lord God of Israel in the islands of the sea.
ዜጎች፣በሚሉዮን የሚቆጠሩ በየባእዴ አገሩ ተሰዯው የሚኖሩና የግፍ ክንዴ	of life in the oceans, and of the hundreds of millions of people who lived from traditional fishing
የምስረታ በዓሉን ያከብራል።	He is the culmination of the celebration.
ስለዚህ እንደነሱ መሆን የለብዎትም ።	We must not become like them.
ብዙ ጊዜ ለአንተ በቀላሉ የማይታዩ ነገሮችን ያያሉ።	They're often able to see things that are difficult for you to see.
ከፍርድ ቤቶች በስተቀር ሦስቱም የሕግ አስፈጻሚው አካል ናቸው።	The three men on the right are also judges.
እነዚህን ሰዎች ቅዱስ ጳውሎስ በመልእክቱ ላይ ‹‹የሰላምን መንገድ አያውቋትም።	"As the Apostle Paul wrote, ""The way of peace they have not known."
ትኩረት እና ተጽዕኖዎችን ያክሉ ይችላሉ.	Yet it may be able to draw attention and energy.
አቶ ገብሩ፡- መድረክ የሚለው እነዚህ ሁለት ነገሮች አይጣረሱም ነው።	Apple, hopefully will not ignore these two points.
የኢትዮጵያ ኦርቶዶክስ ተዋሕዶ ቤተክርስቲያን መዝሙር - በምን.	the Serbian Orthodox Church opposes ecumenism; and through whom and in what
የመሬት መሸርሸሩ ካልተስተካከለ የሸረቀ ብሩሾችን እና ማረሻዎችን መጠቀም አስፈላጊ ነው.	It is imperative that trees and shrubs be watered on a regular basis if rainfall is not adequate.
👉 አማናል ከጀርመን ብሔራዊ ቲቪ ጋር ያደረገው ቃለ መጠይቅ ትርጉሞች፦	During an interview with the german TV station RTL:
መሣሪያው አሁን በ Microsoft Store ውስጥ ለሽያጭ ይገኛል።	The Designer is now in the Microsoft Store.
እንዲሁም የሩስያ ጭብጥ በጣም ያነሳሳውን የኢራንግል ካርታ የሚለግሰውን ያንን ቀላል ያልሆነ አየርን መረዳት ይችላሉ ።	There must also be an obligatory mention of Russia's harsh winter climate, which makes using a car much more appealing.
እኔ አምሀርም ጋላም ንኝ እንደእኔም ብዙዎች አሉ ታዲያ የት ነው የምንሄደው?	Nicholson, Campbell and I decide to go on a journey, but hey! where are we all going?
የ Instagram መገለጫዎን ማን እንደሚጎበኝ ለማየት	After a close look at the roster, the place where they could use some additional help would be at right wing.
ራሳችን ለራሳችን እናለቅሳለን።	Let's weep for ourselves.
የፀጋዬ መርዶና ቀብሩ የልፋቱን ያህል ደምቆና ከብዶ አለመታየቱ የ.	Being queen of the rock and roll scene isn't as easy as her highness makes it look bu.
ረዘም ያለ የክፍያ ወቅቶች ተባዙ;	and prolonged drought periods.
የፈረንጅ ስራ ስለመሰለን ይሆን?	How do you believe we experience a work of art?
ዳንኤል አብሮን ይጓዛል።	Daniel went with us.
እያንዳንዱ ሴት ያስሱ እና ይኑርህ አለበት ይህ የውበት ሚስጥር	Every woman should know this man's secret
ይሄን መገንዘብ ጥሩነው፤ አዲስ ነገርም መፍጠርም አለብን።	That's when we realized; we need to build something new.
""" በማለት ነው በምሬት የጠየቀው።"	He was accustomed to ask his subconscious to give him a good.
መለስ ብየ ሳየው አመጣጤን ሁሉ;	""" Until it come to Thee, in vain I look around;"
ይህ አባባል ብቻም አይደለም፤ እምነት ነው።	This is not just a statement, it is a belief.
የሌሊቱ ደግሞ ሌላ ጣጣ ነው።	The night is a separate attraction.
ትግሉ ተሸናፊዎች ወደሚገቡበት አዳራሽ ለመግባት ማንም በማንም ላይ በሩን እንዳይዘጋ ለማድረግ መሆን አለበት።	You decide not to let any townspeople into the bar so that no one fights.
21 ሆሚኒድስ - ወንድ በደብልዩ 71 Rubbit ጉበት	Miss Marchmont - The Way of a Man with A Maid 171 MB
ኢንጂነር ይልቃል፡- ያ ቢሆን ኖሮ ሁለት ዓይነት ምርጫ ይኖረን ነበር።	It used to be a trucker would have two choices, if any.
የtት ታሪክ እዚህ ላይ ሊያበቃ ይችላል ፣ እና እሱ ታላቅ ታሪክ ይሆናል።	The story could end here and it would be a fantastic story.
ዘዳግም 21:22 - Correct Me ማንም ሰው ለሞት የሚያበቃውን ኃጢአት ቢሠራ፥ እንዲሞትም ቢፈረድበት፥ በእንጨትም ላይ ብትሰቅለው፥	Deuteronomy 21:22; And if a man have committed a sin worthy of death, and he be to be put to death, and thou hang him on a tree:
ለምን እንደሚታሰሩ ለጠየቅናቸው ጥያቄ ‹‹ሰላማዊ ሰልፍ ለማድረግ አቅዳችኋል›› በሚል ሰበብ እንደሆነ ተናግረዋል።	"When he asked why he was in prison, he said, the answer was, ""We keep you for security reasons."""
ማድረግ አለብን መጀመሪያ የዩቲዩብ ድረ-ገጽን ይድረሱ (ከዚህ ማድረግ ይችላሉይሄአገናኝ) ።	You need to enable Java Web-Start to run it (which is usually enabled).
ክርስቶስን መልበሳችን ማለት ለእኔ ይሄ ነው ።	"""This is what Christ's birth means to us."
የገና በአልን ምክንያት በማድረግ በመዲናዋ ለበአሉ የሚያስፈልጉ ግብአቶች ግብይት እየተከናወነ ነው	gifts are taken to the Center in preparation for the Christmas party held for the
አጥሮ ለማስረዘም አሊያም ረዝም ለማሳጠር የምንሞክረው ትርጉም፤ በእኛ ልክ የተሰፋ አይደለም።	They get tainted with the dust and odors; it's not appealing to those around us.
ሁለቱም ቀጥተኛ እና ያልተወሳሰበ ናቸው, ይህም ለአጠቃቀም ቀላል ያደርገዋል.	They are both honest and uncomplicated, which makes them easy to apply.
ከአመጋገብ እና እንቅልፍ መተግበሪያዎች ጋር ውህደት።	with the skins of animals for bed and bedding.
ታዲያ በውኃ መጥረግ ነዋ።	And then they made her go under water.
እነሱን መከተል አቁም።	She wouldn't stop following them.
ለፓርቲው መዋጮ ላይከፍል ይችላል።	May not offer shares to the public.
ላልሰጠከኝ ላመስግንህ!	"Thank you for not letting me give up!"""
እንዲሁ ፡ አልተውከኝም ፡ በፍቅርህ ፡ አዳንከኝ	Your benevolence towards me will not be forgotten.
ጥቁርም ነጭም ልብስ ልብስ ነው።	Black dress is a fashion clothing.
መተግበሪያውን ያውርዱ እና ስለ ራስህ መሠረታዊ ጥያቄዎች መልስ.	You need to first download the app and answer basic questions about yourself.
50 ኛ ዓመት.	The fiftieth year.
እንግዲህ አሁን ሂድ፥ እኔም ከአፍህ ጋር እሆናለሁ፥ የምትናገረውንም አስተምርሃለሁ አለው።	Now go, and I will be with your mouth and teach you what you are to speak.
1ቆሮ 6:2 ቅዱሳን በዓለም ላይ እንደሚፈርዱ አታውቁም?	1 Corinthians 6:2: Do you not know that the saints will judge the world?
እነርሱም እጃቸውን በእርሱ ላይ ጭነው ያዙት።	They laid hands on Him, and seized Him.
የእነዚህ ክዋኔዎች ውጤት በመለኪያ የምስክር ወረቀት ውስጥ ተገል is ል።	The results of these tests are recorded on the Certificates of Analysis.
በተመሳሳይ የመከላከያና የደህንነት ተቋማት ቀደም ብሎ የአንድ ፓርቲ መጠቀሚያ ነበሩ።	The Health and Safety Executive has been added as an interested party.
የመፍታት እና የማስተዳደር ተግባር እና ኃላፊነት ተሰጥቶት ሲሰራ ቆይቷል።	The suitable delegation of power and responsibility has been implemented.
መድረሻ የሌለው ጥግ አልባ የህይወት ህልቆ መሳፍርት።	A slice of a previously unseen side to life.
ይህ ምርጫ በጣም ውድ ነው ፣ እና እርስዎ ባዶ እጃቸውን ላለመውጣት እርስዎ የሚመርጧቸው ብዙ ነገሮች ይኖራሉ።	Paper is expensive, and even though there are a few things which you'll require a good deal of, you always have the option to go without.
እኔም ዝግጁ ነኝ፣ወደ ቤትህ መሄድ ትፈልጋለህ?	I sure do, do you want to come to my house?
የወደፊት የሰው እና የማሽን ውህደት በተመለከተ ፣ ስለእነዚህ ዕድሎች እንኳን ብሩህ ተስፋ አለኝ ።	As for the future of man and machine integration, I'm even optimistic about those opportunities.
እንዲሁም ተመሳሳይ ማስታወቂያ በተከታታይ እንዳይታዩ እና ማስታወቂያዎች በትክክል እንዲታዩ የማድረግ እና በአንዳንድ ሁኔታዎች በእርስዎ ፍላጎቶች ላይ የተመሰረቱ ማስታወቂያዎችን የመምረጥ ተግባራትን ያከናውናል።	They also perform functions like preventing the same ad from continuously reappearing, ensuring that ads are properly displayed for advertisers, and in some cases selecting advertisements that are based on your interests.
ወደፊት መክፈልዎን እና ሁሉንም መልካም ነገሮች ማጋራትዎን እንደሚቀጥሉ ተስፋ አደርጋለሁ ።	And I hope you continue to pay it forward and share all the good.
የተለያዩ አዋጆች እየተሻሻሉና እየተጠኑ ሲሆን፣ ይህ መቶ ቀን ሳያልቅ በአጭር ጊዜ ውስጥም ይጠናቀቃሉ ተብሎ ይጠበቃል።	New, more concentrated formulations were proposed and checked to allow a minimum stability of 28 days.
ምርጥ የወንጀል ጨዋታ ትፈልጋለህ?	Do you want to stay up to date with the best Violetta events that are the best ticketing service in.
- ቤተመቅደሱ ከምንሄድበት መንገድ ቅርብ ነው፣ማየት ትፈልጋለህ ?	The end of the road is in sight would you say?
እንደ ሃላፊው ገለጻ ብዙዎቹን መመሪያዎች የማስተካከል ስራ ነው የሰራነው አንዳንዶቹን አጠናቀናል ።	A great collaborator, we have rewritten many of the business rules.
ራሱን አያውቀውም ማለት ነው።	that he did not know himself.
ሁሉም ከመሬት በታች .	wholly beneath the earth.
ይህ ምርት ማበጀትን አይደግፍም ።	And this one doesn't do flattening of the output.
በርሷም ላይ አሥራ ዘጠኝ (ዘበኞች) አሉባት።	Nineteen are self-sufficient.
ይህ ሁኔታ የሚፈጸመው የ አይጥ ቁልፍ መቆጣጠሪያ ሲለቅ ነው	It occurs when the keyboard key is released.
ስለዚህ አልረዳህም።	So I will not help you.
ደንበኞቻችንም በዚህ ደስተኞች ስለሆኑ የሚሰጡን አስተያየት ጥሩና ለበለጠ ሥራ የሚያነሳሳ ነው።	Our client's satisfaction is the revenue for us which motivates us to do better and better.
በዚህም መላውን የቅዱስ ጊዮርጊስ ደጋፊ አመሰግናለሁ።	Hello I would like to extend our thanks to entire staff of the St. George.
ሴሉሲኒ ዘመናዊ ከተማ ሆነች።	Lhasa has now become a modern city.
ለዚህ ፕሮጀክት ፍጹም አጋር ነበር ።	He was the perfect model for this project.
በዚህ ጦርነት ምክንያት በከፍተኛ ስጋት ውስጥ ነን።	"""We're really nervous because of this war."
የቢሊ አሻንጉሊቶች በገበያው ውስጥ እንደሌሎች አሻንጉሊቶች አይደሉም ።	The Naboso insole isn't like other insoles on the market.
Lisovy, ፍልስፍና መምህር, ተቋሙ ውስጥ ላይ እየሰራ ነበር 1962-1966, እሱ አርትዖት ይህም የእርሱ ንግግሮች እና የመጀመሪያ ኢንስቲትዩት የግድግዳ ላይ እዳ 1960 መካከል ተማሪዎች በ ትዝ ነው.	V.S. Lisovy , the philosophy teacher , who was working at the institute in 1962-1966, is remembered by the students of the 1960s owing to his lectures and original institute wallpapers which he edited .
በሮኬትTheme ላይ ካሉት በርካታ ማራዘሚያዎች ውስጥ አንዱ ያ ብቻ ነው ።	This is just one of the many steamers from Rowenta.
ወይም ከዚያ 2 የኤሌክትሪክ መኪናዎች ያስፈልጉ!	You don't need a car here! 2 electric panels.
ስለ አስደናቂ ዝርዝሮች አትርሳ.	Don't forget about the amazing shows.
በፌስቡክ በኩል ጥቅም ላይ የሚውል መረጃ በፌስቡክ የግል መብት ፖሊሲ ሁኔታ ይወሰናል።	The processing of the data by Facebook takes place within the framework of Facebook's data usage policy.
ባለሙያዎቹም በመኝታ ሰዓት የሰውነት ሙቀታቸው ቀዝቃዛ የሆኑ ሰዎች ለእንቅልፍ መቆራረጥ እንደማይዳረጉ ይገልጻሉ።	Researchers say that because of hormonal changes that occur in adolescence, teens' bodies are not ready to go to sleep earlier at night.
ነቢዩም የአሞጽ ልጅ ኢሳይያስ ወደ እርሱ መጥቶ።	"And the prophet Isaiah the son of Amoz came to him, and said..."""
ግን ያሰነበተኝ ለካንስ ስለዚህ ነበር።	It's the one that clinched it for me to try with Jake.
ሆኖም መተማመን በአንድ ጀምበር የሚመጣ ነገር አይደለም።	Trust is not gained overnight.
ምን ማድረግ እንዳለብዎት ይነግርዎታል, ምን ማድረግ እንዳለብዎ ከሚነግርዎት የስሜት ሕዋሳትዎ ይልቅ.	Instead of making your audience feel confused, tell them what they need to do.
እናንተን ካላካተተ የኢትዮጵያ ሃብት መሆን አይችልም።	Your data can't be stolen if it isn't with you.
(ለመንግስት ለተፈቀደለት ግብዣ እባክዎን አማራጭን 2.	(Eliminate the Banned 2nd person.
እኛ ብቻ በጣም አስፈላጊ ተግባራት ላይ ያተኮረ ነው.	Therefore, we only focus on the most important things.
እብሪት በደጁ ሲሰለፍ	In response to a tap at the door of his
እነዚህ ፣ ለገንቢዎች በማንኛውም መሣሪያ ላይ እንዲጫኑ የታሰቡ አይደሉም ፣ ሆኖም ግን የተወሰነ መረጃ ሊሰጡን ይችላሉ ።	These desks aren't assigned to any individual worker, but might be shared.
በየመን የሚደረጉ ሰብዓዊ ድጋፎች ሊቆሙ ነው	The corollary on the part of ordinary people is the attitude that emergency preparedness should be left to the experts.
ለእነርሱ የሚሆን ሥራ የለም።	There isn't any jobs for them.
እኛ አናደርግም ምክንያቱም ብዙውን ጊዜ በቦታው ላይ የመስመር ላይ መገኘታቸው ሌሎች መሠረቶች እንደሌላቸው እናገኛለን ።	We don't because we often find that they don't have the other foundations of their online presence in place.
ለምሳሌ l ስንጫን ል ይጻፋል።	However, for example when she describes herself while volunteering at an AIDS clinic.
ነፃ ሪፖርቶች ምርምራቸውን በዚህ ድህረ-ገጽ ላይ እንዲመርጡ.	Members of the survey team will discuss their findings in this free webinar.
አንድ ሰው እና አንድ ውሻ	A Husband and a Dog
ለእኔ ፈፅሞ የማይታሰብና ረብ የለሽ ነው።	To me it seemed irrational and unsympathetic.
እኔም ፡ አምነዋለሁ (፬x)	I believe you (4x)
ከ 2012 ፣ 2013 ወይም 2014 ትሮች ላይ የ RTE መረጃን እንወስዳለን እና በ B5 ወይም B6 ውስጥ በሚባዛው ተባዝቶ እንባዛለን ።	For the columns from F to J, we take the RTE data from the 2012, 2013 or 2014 tabs and we multiply by the multiplying coefficient in B5 or B6.
ሆቴል እንዳይሆን ስላቸው.	Trying to not send them to a shelter.
በህይወቴ ሁሉ እመኘው ነበር።	I've wished it all my life.
ልባቸው የተሰበረውን።	your broken hearts.
ምክንያቱም በእጆችዎ ላይ ሊሆኑ የሚችሉትን ቫይረሶችን ይገድላሉ ።	It kills viruses that may be on your hands.
አንጎልህ ዕድሜ ይወቁ.	They know your body language.
ለሁሉም የሚሆን የገንዘብ ጨዋታዎች የተለያዩ አሉ.	There are variety of cash games for everybody.
ሲደረግ (ሲሆን) ማን ሰማ ?	"""Who are you to be listened to?"
እውነት ከሆነ ግን ኢህአዴግን እንደተለመደው እታዘበዋለሁ ማለት ነው።	If that were the case, then I would suspect YFZ was targeted in some way.
16፤ የቍርባኑም መሥዋዕት የስእለት ወይም የፈቃድ ቢሆን፥ መሥዋዕቱ በሚቀርብበት ቀን ይብሉት፤ ከእርሱም የቀረውን በነጋው ይብሉት፤	7:16 But if the sacrifice of his offering be a vow, or a freewill-offering, it shall be eaten on the day that he offers his sacrifice; and on the next day that which remains of it shall be eaten:
28_59_ጌታህም ከተሞችን በዋናዋ (ከተማ) ውስጥ አንቀጾቻችንን በእነሱ ላይ የሚያነብ	Your works of our Lord,Jesus are abundant in the blessings to be seen by the people of the !villages.
እስከረፋዱ ድረስ ስፅፍ ቆየሁ።	I postponed until the Bth.
የ DoubleClick ኩኪዎች በግል ሊለይ የሚችል መረጃ የላቸውም ።	Double Click cookies contain no personally identifiable information.
እርስ በርሳችን እንተዋወቃለን።	Ourselves knowing each other.
9የኖኅ ታሪክ እንደሚከተለው ነው፤ ኖኅ በዘመኑ ከነበሩት ሰዎች ሁሉ ይልቅ ጻድቅና ከበደል የራቀ ሰው ነበር፤ አካሄዱንም ከእግዚአብሔር (ኤሎሂም) ጋር አደረገ።	9 This is the story of Noah: Noah was a good man, an upright man among his contemporaries, and he walked with God.
ክርክሩ የተነሳው በ ህገ መንግስት ውስጥ ፈጽሞ ባልተካተተ ጉዳይ ላይ ከሆነስ መፍትሄ የሚሰጠው ማነው?	When the solution is so effective that the problem never existed, who will need to think of a solution?
የሰብዓዊ መብት ድርጅቶች ምን አሉ?	What are the international human rights organisations doing?
እኔ እንዳንቺ ያጠናሁት የለም››	"I'm not somebody who has studied it."""
በእውነቱ ፣ ለእንዲህ ዓይነቶቹ የመጫኛ ዘዴዎች ጉግል Google ሊቀጣዎት የሚችልበት ዕድል አለ ።	So, there is a fair possibility that Google may share some breadcrumbs of its new generation technology piece.
ችግሩ የት እንዳለ አላየሁም....	I don't see where the problem is...
አሁን አሁን 6 ወር እርጉዝ ነኝ.	I'm now nearly 6 months.
ትምህርት በመስጠትና በየጊዜው ምርምራ በማድረግ ላይ የተመሠረተው በመከላከል ላይ ያተኮረ የጥርስ ሕክምና የጥርስ ሕመምንና የጥርስ መውለቅን ለማስወገድ የሚረዳ ወሳኝ መንገድ ነው።	Muscular endurance training that is designed specifically for dental professionals is critical for preventing neck and back pain.
ምንም መሳሳት የለብኝም፤ግን እኔ ከዓለማት ጌታ መልክተኛ ነኝ።	I am an apostle from the Lord of the Worlds,
ጥያቄ የብየዳውን ተሽከርካሪ መጠን እና ክብደት ምንድነው?	Question: What are the airlines' rules about the number and size of carry-on bags?
ከአልኮል ነፃ ፀረ-ተባይ መጥረጊያ	As a teenager I battled with body image issues and by the age of 17 I had been admitted to an eating disorder hospital.
የተማሪዎቻችን፣ የሰራተኞቻችን እና የቤተሰቦቻችን ጤና እና ደህንነት እጅግ አስፈላጊ መሆኑን እባክዎ ልብ ይበሉ።	Please be reassured that the health, safety and welfare of our students and staff are of utmost importance to us.
አዲስ ግምገማ አላስቀመጠም።	He didn't cite a new estimate.
ሁሉን የሚገዛበት ቀን	The day when all the
የስራ ባልደረቦቼም መጠባበቅ ትተው እየሰሩ ነው።	And a lot of migrant workers also stuck and waiting for help from the government.
እግዚአብሔር እንደፈጠረው በአምሳሉ እና በአምሳሉ ነው ።	God created her in His image and likeness.
ያላዩት ፡ አገር ፡ አይናፍቅም ፡ እንደሚሉት ፡ ሰዎች	They do not consider themselves as owners of the land, but as caretakers.
ኦዴፓ አስኳል ጉዳይን የቤት ሥራውን ለማን እንደሰጠው አያታወቅም።	The ICRC has no idea who kidnapped their employees.
"ቢቸግረው ጣሊያን አለ ፎርሳ ፎርሳ"""	"To the extent, however, that French law is silent, the Vienna Convention would fill the gaps."""
በህዳሴ ግድብ አስተዳደር ላይ ይታዩ የነበሩ ችግሮች በቀድሞ ሚኒስትር ዕይታ	Participants, especially the experienced trial attorneys, tended to give less weight to predictions made by others, and in the process, failed to benefit from the aggregation.
ይህ ልምምድ ለአምስት ደቂቃ ያህል መደረግ አለበት, every few hours.	This exercise ought to be done with regard to five minutes, every few hours.
ሆኖም ፣ ቤተክርስቲያን እንደ ትልቅ ጉባኤ ተግባሮ congregationን መውሰድ የለባትም ።	The church is no bigger than a congregation.
የተቀረው ገንዘብ 21.	21 me the money.
ይህን ለማድረግ የሚከተለውን ቅደም ተከተል ይጠቀሙ።	To do this, use the following command line.
ለመማርም ስድስት ወራት ነው የፈጀባት።	It took six days to learn.
ረቡዕ: የተጎናጸፈውን ሚስጥራት	Chapter 6: Wednesday Is Spiraling Out of Control
"msgstr ""ይመልከቱ እና ይዳብሱ"""	"The Byrds - ""Wait and See"" lyrics"
በተረፈ አስርቱን ትእዛዛት በአግባቡ ነወ የምጠብቀው።	I should obey the Ten Commandments.
የመኪናውን ቁልፍ አሹሎ፣ አንዲከተሉት በእጁ እየጋበዘ ፡-	He pulled out the keys to the car and spun them around his finger.
1 - የሚቀመጥ መሆን	9 - Staying On-Site
ጊዜ እንደ እናንተ እንዲሁም ለእኛ ዋነኛ አስፈላጊ ነው.	Time is crucial to you and us as well.
አንተ ውስጥ አለ ወይም በግድ ይኑር አላልኩም።	I don't fit in nor belong in your society.
ሆኖም በወቅቱ ብዙዎቹ አይሁዳውያን የአምላክን ስም መጥራት ተገቢ አይደለም የሚል አጉል እምነት ስለነበራቸው ሌሎች ምትክ ስያሜዎችን ይጠቀሙ ነበር።	The apostles did not fully comprehend many of the prophecies that related to Jesus to prove that he was the Messiah.
ተመልሰው ይምጡ: ፀሐይ:	Return from the Sun:
በአማካኝ አንድ ወር ፴ ቀን ይሆ.	an average month is 30 days.
አዲስ ድረ ገጽ በስራ ላይ ዋለ	There is a new website in development
"ይህም ""እኔ የሽሪ ክርሽና አገልጋይ ነኝ።"	"He thought, ""I am a servant of Christ."
አሁንም ቢሆን ችግር ፈጣሪ አለብኝ, የሚያስተላልፉት የ 8000 ማጣቀሻዎች ሲኖሩ ምን ማድረግ እንዳለብኝ .	Now that the relationship is broken, how can I deal with the 280000 I want to get back?
"""ባላዋቂ ቤት እንግዳ ናኘበት"" የሚለው አባባል በኛ ላይ መፈጸሙ ያብቃ እስኪ!"	"The cottages offer a ""home away from home"" feel, We can't say enough good things!"
ተጨማሪ ገንዘብ ለማግኘት አዳዲስ ተመልካቾችን ይሳቡ!	Recruit new consultants to earn more money.
ያም ሆኖ ወጣትነት የራሱን መልክ ይዞ ብቅ ሲል ሕይወት በምትሰጠን ምርጫ ራሳችንን እናስጉዛለን።	Furthermore, we, as spectator, are challenged to use our own creativity and thus contribute to the creation of the final image.
ፍቅርን ለማጋራት እዚህ በቀላሉ ፈገግ ያለ ጎብitor (	inviting with smiles because it is a lover.[81]
ብዬ የወተወትኩህ	The way I left you
ምን ላይ እንዳነበብኩት ለጊዜው ትዝ አይለኝም።	I remember nothing of what I've read.
"""ዓለም ላይ ማንም በዚያ መልኩ መኖር አይፈልግም።"	"Nobody wants to alive in that world."""
ሕክምናውን አጠናቅቅ	Alas my hardware wasn't quite up to the task.
አስመላሽ አሳየኸኝ (ወዲ ምህረት) የተደረገውን ያውቃል።	He has already shown me what he is made of.
ዲም ትምህርቱ እንዲሰጥ ቅድመ ሁኔታዎች በመመቻቸት ላይ ናቸው።	The S bit enables the setting of the conditions in the particular instruction.
ያን ስታወግዝ በውግዘቱ ውስጥ ያንኑ አንተ የምትፈጽመው ከሆንክ እኩል ለኩል ነው።	What that comes down to, if you are at a one, you are equal to others that do the same thing in your industry, in terms of loss ratios.
ጨዋታ ርዕሶች እንዲህ ዓይነት በጣም በመላው ዓለም ግለሰቦች መካከል ታዋቂ ናቸው.	These types of games are very popular all over the world.
ስልጣን ወደ እምነት ይመራል - መተማመን እያንዳንዱ የቢ 2 ቢ ገዢ ውሳኔውን የሚወስንበት መሠረት ነው ።	Trustworthiness The correct answer is B. Each of the other choices depends on the perceptions of others.
እነዚህ ደግሞ ዝግጅት ማድረግ ከባድ ነው.	These are difficult to prepare.
በብዙ ነገር ከልቡ አዝኖብሃል።	caused a lot of guilt in your heart.
ህልሜን አምላኬ የነገረኝ እኔነቴን ሰሞኑን እንደተዘጋጀሁበት ረጋ አብዬ አወራዋቸው .	Maybe because I have that feeling ingrained in me by my mother to clean up before having people over, and by the mission my Lord has given me, I do plan on having people over.
የቡርና የማያቋርጥ ባቡር ፕሮጀክት ለፖለቲከኞች ብቻ...	simple non programable line follower project for all engineering students.........
ከምድር ለሰማይ ቀረብን።	"We, the ones who from heaven to earth came."""
ሆኖም የ PS4 ባለቤት ከሆኑ አንድ ሳንቲም ማውጣት አያስፈልግዎትም።	With the way PS4's are selling, they have no need to whip up a money-saving bundle.
ወደ ከለዳውያን በኰበለሉት በአይሁድ እጅ አሳልፈው ይሰጡኛል እነርሱም ያፌዙብኛል ብዬ እፈራለሁ አለው።	People ridicule fetishists behind their backs, and I'm afraid of being lumped in with them.
"እነርሱንም ""Big Three"" ይሏቸዋል።"	"We call the them ""the big three."""
አምላካችን ትክክለኛ አምላክ ነው ።	Our God is the God of rightness.
ሦስት ሺ ሁለት መቶ ስምንት አስር አንድ	Initially, there were two hundred officers involved in the foot search though that number was reduced to 150 within the first few days.
እርስዎ መተግበሪያው ላይ ማድረግ ትችላለህ ሌሎች ነገሮች:	I think you can go another layer in on the app.
ዳርሊን በፍጥነት ሮጣ ላይ እስክመለስ ድረስ እግሮቼን ለመንከባከብ እስኪያግዙ ድረስ አንድም ጡንቻ አይንቀሳቀስም.	Nothing is left of the avalanche of crumbs by the time it reaches my feet.
ዳግመኛም አስተውሉ 'እንግዲህ' ብሎ መጀመሩን።	"Then they started again and she started ""assuming the position."""
ይህንን ስናገር በሃሳቤ ያለው ታላቁ የነፃነት ታጋይ ማርከስ ጋርቬይ ነው።	On the offense, the most important returning player in my eyes has to be Mark Walton.
ተባብረን ወያኔን እናስወግድ!	Hats Off on the consistency of the team !
እንዲህ ያለውን አሳፋሪ ድርጊት አትፈጽሙ።	Don't do this disgraceful deed!
""" ስለው አፈር ብሎ ""ምክሬን እንጂ አድራጎቴን አትከተል አላልኩህም?"	"He nodded and said: ""Were you following me?"""
00 ሰዓታት ውስጥ ማሳያው ላይ ሊደረግ.	Preview from 00:00:00 in the timeline.
""" ""እንግዲህ አሜሪካን እዚህ አመሳስሎ መጀመር አለብን ባይ ነኝ!"	"""Now let's find out if I'm pointing this rocket launcher the right way!"""
እኔ ድጋፍ አደርግለታለው፡፤የቡድን ጓደኞቹም እንዲሁ ከሱ ጋር ናቸው።	I'm his friend, and friends support each other.
"""ጥፋቴ ምን ላይ እንደሆነ አልገባኝም ጌቶች!"	"""I don't understand what's wrong with my bosses!"
ያልተስተካከሉ ነገሮችን በማስተካከል የጎደሉ ነገሮችን በማሟላት ያልተመቹ ነገሮችን በማመቻቸት ይህን ዓመት የውጤት ዓመት እናድርገው።	Let's make this year a success in preventing the number of eating disorders, raising
ገንቢ: ጎርኩğ ዩላ	local short form: Côte d'Ivoire
እኛ ደግሞ ገቢዎ እርስዎ እንዲፀድቁ ወይም ገቢዎን ለመጨመር እቅድ ለማውጣት የማይችል ከሆነ እነግርዎታለን ።	If we decide not to make direct payments to you, or to recover an overpayment from you, you can appeal.
ሌላ ልብ ልትይው የሚገባሽ ክብደትሽን ነው።	Your body weight is another aspect you need to take into consideration.
ተስፋ ፡ ቢስ ፡ ሆኜ ፡ አልቀረሁም ፡ አከብርሃለሁ	"""If I lose, though, Voldemort will be against you."""
የደሞዝ ጭማሪ የሚጠይቅ ዘመቻ።	a request for advance in wages.
"አንድ ቀን ጧት ወደ ትምህርት ቤት እየሄድኩ ሳለ ""ፍስሃ"" የሚል ጥሪ ሰማሁና ዘወር አልኩ።"	"Yesterday morning, as I left for school on what was the last day, I turned on the radio and heard the song, ""I am Redeemed."""
እንዲሁም ኩባ በትምህርትና በሳይንስ እንዲሁም በእርሻ ለአገራችን ምጣኔ ሃብት የበኩሏን ደርሻ ልትወጣ ትችላለች።	He said Zimbabwe could also learn a lot from the former Spanish colony in the areas of science and research, agriculture and tourism.
"""በቀን ውስጥ ምን ያክል ሰአት ትተኛለህ?"	How long you sleep in the day time?
ግን ይህንን ማጣራት እና እውነት መሆኑን እና አለመሆኑን መለየት አለብን።	However, we have to wait and see whether this turns out to be true or not.
""" ያ ሰብነውም፤ ያለመነውም፤ ቀልባችንም፤ መንፈሳችንም ተስፋችንም እንዲያርፍ ከለመነው ቦታ ፈጣሪ ቀብቶልናል።"	He came to cure the sick and poor in spirit and to heal our souls and restore our relationship with God.
እሺ ጊዜ ይሰጥ ግን ስንት ገለው ይብቃቸው፣ ኮታቸው ስንት ነው  ስርዓቱ እያለ  መግደል አያቆሙምና ደግሞ እሳቸው ስንት እስኪገሉ እንያቸው  ነው ያለው ገጣሚው።	Certain factors such as the number of battles, the number of times they've killed the player, and the number of times they've cheated death are major influences, however.
ህዝቡ ሲሸሽ እንደገና ቤት ለማፍረስ ሲሄዱ ህዝቡ ተመልሶ በድጋሜ ተቃውሞውን ገልጿል።	When these were publicised the police went to the house again and issued threats.
እርጉዝ ሴቶች ይህንን የምርመራ ዘዴ መጠቀም የለባቸውም።	Pregnant women should not use this ointment.
አርባ ሶስት በመቶ ያህሉ ደግሞ ለፍጆታ የሚውሉ የወተት ተዋፅኦዎችን ለማምረት ውሏል።	Forty-three percent of the chains offered high-fat milk.
ማስታወሻ: ውይይቱ መጀመሪያ በወሰነው ጠባብ መዋቅር ውስጥ ሙሉ በሙሉ ማምለጥ መቻሌን በደስታ እገነዘባለሁ ክሪስቶፍ!	BETH LAST: I am so honored to be deplorable enough to receive a personal invitation from president Trump!
ፎቶ ልልክልዎታለሁ!	i'll put up a photo of him!
ሁሉም ሰው እንዲሞክራት ሀሳብ አቀርባለሁ እናም የእሷ ትንበያ በጣም ትክክለኛ ነው ።	I've tried everything and I think your suggestions are the best.
ከአሥር ልጆች አልሻልልሽምን ወደ እኔ አልበልጥብሽምን?	"Am I not more than ten sons to you?"""
አንዳንድ ጊዜ የቤተሰብ ወይም ጓደኞች ጋር የተወሰኑ ነገሮች ማውራት ዓይነት ከባድ ነው እናውቃለን.	Sometimes you may find it difficult to talk to family and friends about certain issues.
አንዳንድ ጊዜ ደግሞ የደም ስሮች በመጥበባቸው ምክንያት ሊሆን ይችላል።	Sometimes it can be because of bad blood circulation.
በእውነቱ ማስነሳት ነው ፣ ግን ስርዓቱ አስቀድሞ የሚሰራ መሆን አለበት .	So there has to be function, the function has to be predictable
አንድነት ምርጥ ማህበረሰብ ነው።	Unity has the largest community.
ከተሳፋሪዎች አንድ ሦስተኛ በላይ የሚሆኑት (36%) በሚጓዙበት ጊዜ የባዮሜትሪክ መረጃ አጠቃቀም አጋጥሟቸዋል።	Just over a third of passengers (36 percent) have experienced the use of biometric data when traveling.
"""አባቴ እኔን እንደ ላከኝ እኔም እናንተን እልካችኋለሁ"" በማለት ይናገራል።"	"He said: ""As the Father sent me, so I am sending you."""
ለጊዜው የተሳካላቸው ይመስላቸው ይሆናል።	It may seem successful for a time.
በወቅቱ መወሰድ የሚገባቸውን እርምጃዎች ለምን አልወሰደም?	Why did they not fulfill their responsibilities at that time?
የሚኖሩት ከ10 አመት ልቻቸው ጋር ነው።	They're all in her 10-year-old heart.
መሠክራለሁ ለአለም ሁሉ፣	I'm gonna testify all over the world
ሰው በፈለገው ጊዜ መተኛት አይችልም።	They can't sleep when they want to.
ዛሬ የገጠመን አደገኛና ህልውናችንን፥ እንደ ህዝብና ሀገር የሚፈታተን ሁኔታ መሆኑን ጠንቅቀን መገንዘብ አለብን።	Still, we should remember that our health and well-being depend on us as individuals and communities.
በተጨማሪም, ማንኛውም ከልክ ያለፈ ቁጣ አንዳንድ ሆርሞኖችን በማምረት የሚታይ ጭማሪ ያስከትላል.	Otherwise, any excess of anger causes a visible increase in the production of certain hormones.
እንዳሉት እንዲሆን ምኞቴ ነው፣ ግን ስምዎን ማን ልበል?	i would like to, but who is Oliver? should i know him?
በሰኔ 2015 መጨረሻም ላይ ባንኩ ብር 1.	By the end of June 2015, 1.
አሁን አንድ ሰው ይህን ያልገባው ጉለሌ ኦሮሞ ነው ቢል ይሳዝናል ።	Any Urhobo man who fails to see it from that perspective is an enemy of Urhobo.
በ 2012 ውስጥ, ዳኒ በቃላት በማይነጣጠሉ ሰርቢያውያን የዘረኝነት አቀንቃኞች የተቀበለበትን አሰቃቂ ስሜት ገልጸዋል, ይህ በሚከተለው ላይ በመግለጽ አስጸያፊ ነው.	In 2012, Dan Cathy made his opposition to same-sex marriage known publically, and this caused a national uproar.
ስለ ሕይወትዎ ዝርዝር ጉዳዮችን ያውቁ ይሆናል።	You will know some details about their life.
እንዴት ነው 8% (ለምሳሌ) ድጋፍ ያለው ቡድን ሃገርን መቆጣጠር የሚችለው?	How is it that a relatively small group of oppressors (the famed 1%) can control a large group of oppressed?
ስህተት እንሠራለን ብለን አንፈራም ።	We're not afraid to make mistakes.
ይህ ለአንተ ምን ማለት ነው, እንግዲህ, ከእናንተ እያንዳንዱ እንኳ ጣሪያ ላይ ወጣ መሆኑን?	What does it mean to you, then, that each of you have even climbed to the rooftops?
ስለዚህ አዲስ ትግበራ ምን ያስባሉ?	So, what is the Alliance for a New Humanity?
""" አለ ዋርካ ፍርሃት እያራደው።"	"He said, ""Grab him!"""
"አንተ ረዳቴና አዳኜ ነህ"" በማለት ዘምሯል።"	"You are my help and deliverer."""
ቴስቶስትሮን ኤንታንት በበኩሉ ውጤቱ ከሱስታኖን የበለጠ ፈጣን ቢሆንም በአጫጭር ኢስቴሮች ምክንያት በየሳምንቱ መሰጠት ይጠበቅበታል ።	Testosterone Enanthate, on the other hand, is required to be administered every week due to shorter esters though its effects are quicker than Sustanon.
ከ 1000 ሰዓታት ያህል ብቻ ይነዳ።	burn for more than 1,000 hours.
ይሄ ከሌሎች ክልሎች ጋር ሲነፃፀር ቁጥሩ ከፍተኛ ነው።	This level is exceptionally high compared with other provinces.
ወንዙ ለሦስት ወራት ብቻ ነው ከዚህ ቀደም ይፈስ የነበረው፣ አሁን ግን ዓመቱን ሙሉ ይፈሳል።	Although Spring is officially only 3 months each year, it can last all year.
ኤስኤስአርአይ ወይም ቤንዞዲያዛፔን በሚጠቀሙበት ጊዜ አልኮል መጠጣት አይመከርም ።	It is not recommended to drink alcohol while using opioids.
2ኛ ዜና መዋዕል 32:13 - Correct Me እኔና አባቶቼ በምድር አሕዛብ ሁሉ ያደረግነውን አላወቃችሁምን?	2 Chronicles 32:13 (NRS) Do you not know what I and my ancestors have done to all the peoples of other lands?
ዲ ተከታታይ የኤሌክትሪክ አግድም ድርብ መምጠጥ የእሳት ማጥፊያ ፓምፕ ስብስብ በእኛ የገቢያ ፍላጎት መሠረት በእኛ ኩባንያ የተሠራ ምርት ነው።	Our EBP60 Trailer-Mounted Concrete Pump is produced in high quality according to the needs of the Concrete Machinery sector.
ሃምሳ ዐመታት የኋሊት	Five hundred years after the historic
እሱ ከትውልድ አገሩ ርቆ በሚገኝ አንድ ትልቅ ስራ ላይ ለመሳተፍ ቤተሰቡን ለበርካታ ዓመታት አሳልፏል.	He left his family for years at a time to fight in a far away land.
ዝም ብሎ በመገፋፋት ወይም በሌሎች ቦታዎች ላይ እንዲወድቅ ከማድረግ ይልቅ ያንን አቧራ ይይዛል ።	It is designed to stand up instead of lying down or rolling on top of the other pieces.
ይህ የተለመደ ነገር ግን ተስፋ አስቆራጭ ጉዳይ ነው.	That is normal but nonetheless disappointing.
ለነገሩ ሁላችንም የአንድ አካል ብልቶች ከሆንን፥ ከሌሎች ብልቶች ጋር የሚኖረን ግንኙነት በመጨረሻ እኛንም በግል ይነካናል።	Because after all, when we're struggling to maintain connections with others, the last thing we want is to lose touch with ourselves.
አንዴ ከደፈርህ ደግሞ ብዙ የኖርክበት ነገር ነውና ተመልሰህ አትፈራም።	Then, once you do get to the top position, you will live in fear because you have so much to lose.
ፍጅትን የሚያስከትል ስሕተት በዚህ መልክ ይፈፀማል።	The language allows error handling that way.
የመጀመሪያው የሽግግር መንግስት ለማለት የሕግ መሠረት የለንም።	There is no dispute as to the first statutory predicate.
ወጣቱም እንደታዘዘው ባደረገ ጊዜ ከሰይጣናት አንዱ መጥቶ ወደ አለቃቸው አደረሰውና ያችንም የክህደት ደብዳቤም ከእጁ ወሰዳት።	The man smirked as he pulled out a scroll from one of his pockets, and motioned them to walk over to him.
እነዚህ ሐሙስ ሰኔ 25 ቀን 2020 አሸናፊ ለህይወት ዕድሎች ናቸው ።	These are the Monday, July 27, 2020 winning numbers for Lucky For Life.
እስኪቀዘቅዝ ድረስ ነጭ ቸኮሌት ተዘጋጅቷል ፣ 10 ደቂቃ ያህል።	Cook in chicken broth until tender, about 10 minutes.
በጣም ያስገርማል ዛሬ ማታ።	That's pretty amazing in this day.
ኢትዮጵያ አባይ የተፋሰሱ አገራት የጋራ ሃብት ነው።	Now the liquidated gypsies are a respectable fraction of the Soviet Union.
10|33|እንደዚሁ የጌታህ ቃል በእነዚያ ባመጹት ላይ እነርሱ የማያምኑ መሆናቸው ተረጋገጠች።	10:33 Thus the word of your Lord is fulfilled concerning the transgressors that they shall not believe.
እኚህ ሰው አራት ኪሎ ከሚገኙ የመንግስት መስሪያ ቤት በአንዱ ለበርካታ ዓመታት የሰሩ ናቸው።	There the lady served for about four years in two presidential Administrations.
አርማንዶ ሳልቫዶርመልዕክት.	Aerial view of Salvador.
ለንስሓ አብቃኝ አቤቱ ጌታዬ	Have mercy on me, O good Lord,
ዳቦ ይቀድማል ብሎ ነገር ትክክል አይደለም ባይ ናቸው።	beg for bread are therefore not true.
እኔ ሜክሲኮአዊ እንጂ ጥቁር አይደለሁም!	"I'm a Mexican, not a Mexican't!"""
የላከኝ አባቴንም እንቢ ማለቱ ነው።	but the will of my father who has sent me.
የሚያግደው ፡ እስኪ ፡ ማነው	Tell me who (who), can stand it (who)
ሁለት መጠናቸው ዜሮ ያልሆኑ ቬክተሮች a እና b ትይዩ የሚሆኑት a × b = 0 ከሆነና ከሆነ ብቻ ነው።	Two nonzero vectors a and b are perpendicular if and only if ab = 0.
ሴቶችን አታማርር!	Don't mess with females!
ኑሮውንም እዚያው አደረገ።	and finished his life there.
በእውነቱ የበይነመረብ ጣቢያን ግልፅ ያድርጉ ፣ ለዚህ ጽሑፍ እናመሰግናለን።	Rattling clean website, thank you for this post.
ግን በመጀመሪያ ወደ ምርጫው መሄድ አለብኝ ።	But I have to run the race first.
‹‹አቶ ሪርደንይህ አካሄድ ራስህን የመከላከል መብትህን ያጣበዋል››	"""Mr. Rudolf, you need to control your righteous indignation."""
ተቃውሞውን በመፍራት ይመስላል የአካባቢው ተወላጆች እየተባረሩ የጉልበት ሰራተኞች ከአንድ አካባቢ ብቻ እንዲመጡ እየተደረገ መሆኑን ሰራተኞች ይገልጻሉ።	People in the region are afraid that the groups have plans to pretend they are fighting each other, in order to displace the local peasant farmers.
"13 ደግሞም ""እኔ እምነቴን በእሱ ላይ እጥላለሁ"" ይላል።"	"13 And again, ""I will put my trust upon Him."""
መጽሐፉ አምስት ታሪኮችን ይዟል።	The book contains five tales.
25 እነዚህንም ይህንም የሚመስለውን ሥራ የሠሩትን ሰብስቦ እንዲህ አላቸው።	He brought them forward as much as he could and admired the work that Reid had done on them.
የአቶ ንጉሤ የክርና የቀለም የሥዕል ሥራዎች በአራት ምድብ የተከፈሉ ናቸው።	Warren Neidlich's black-and-white photographs are arranged in four parts.
ለሁሉም ዓይነት እህል ተመሳይ ሙቀጫ የምናቀርበው የኛ እንጂ።	We have our own Poly hose to produce seedlings of all kinds.
አንተ የእግዚአብሔር ነጎድጓድ ፣ በቤተሰቤ ውስጥ የጥንቆላ ዙፋን አግኝ እና አፈርስ ፣ በኢየሱስ ስም ።	Let the thunder of God locate and destroy the throne of witchcraft in my household, in the name of Jesus.
ውስጣችን ከእኛ የበለጠ አዋቂ ነው ።	you know our innermost being better than we know ourselves.
›› መባባል አዲስ አይደለም።	"Face ""Baking"" is not new."
ራሱ ሊያደርግ ያለውን ያውቅ ነበርና ዮሐንስ 6፥6	"prove him: for he himself knew what he would do"" (John 6:6)."
ይህ ደግሞ አንድ ለተወሰነ ዙሪያ ቆይቷል አንድ የላይኛው ክፍል VPN አገልግሎት ነው.	It remained a highly rated VPN service for quite some time.
FOEN Ground Screw ለመሬት መወጣጫ ስርዓት አዲሱ የመሠረት መሠረት ነው።	An object-based file system is the foundation of the New Wave environment.
የገዳማቱና አድባራቱስ?	What about Satanism and the use of magic?
እርስ በርሳችን በመነቃቀፍና በመለያየት ማን ይመስለናል?	Who wants to see us divided and fighting with each other?
ከ 2003 ጀምሮ እራሴን አስተናግጃለሁ እና አልጸጸትም ።	I have been staying here since 2003 and have never had occasion to regret.
ገጽ ለማውረድ አሁን ተከናውኗል	Meanwhile, expeditions were sent out under the auspices of various governments.
ልዩ ደብዳቤዎች ።	special letters (such as Ƿ Þ Ð Æ Ø W IJ).
ብለው የዘፈኑትን ያስታውሱዋል።	those who stay remembered.
ሰው ብቻ ናቸው።	It's only Men.
እግዚአብሔርን መፍራት ወደ ሕይወት ያዘነብላል: ያለውም ይረካል; በክፉ አይጎበኘውም (ምሳሌ 19:23)	"The fear of the Lord tendeth to life, and he that hath it shall abide satisfied; he shall not be visited with evil"" (Proverbs 19:3,23)."
ይህ አስጠያፊ በደልና ታላቅ ወንጀል ነው።	All of this is a great pity and a great crime.
በፍትህ ሲጨቆኑ እና እግዚአብሔር እንዲያጸናዎት ሲፈልጉ ።	They are expressing God's wrath and preaching Justice.
እንኳንም አደጋው ቀላል ሆነ ....	Indeed, the game turned out to be simple...
የእሳት ወደ አስመራ ጉዞ	A minute of maximum sustained winds to the region of around 185 km is brought by Typhoon Parma.
መህዲ ሁሴን በ MSNBC ቲቪ ስራውን በመስራት ላይ እያለ ።	Television journalist who hosted his own show on MSNBC.
በቅርቡ ይወያዩ ፣ XXXXX።	Come to think of it, X20.
አንዳንዱ የጻፈውን እንኳን ማስረዳት አይችልም።	One can't even make sense of what's written.
- ተለከፈ {ተነጀሰ፥ ተለከፈ፥ ተነቼ፤	"""I have been exalted and cast down and confounded."""
በተለይ የእኔ ልጅ አሁን ከእኛ ጋር ሆናም ጎመን እያመረተች ነው።	My brother-in-law currently lives with us.
እርሱንም በዝንጉ ሕዝብ ላይ እልካለሁ፥ ምርኮውንና ብዝበዛውንም ይወስድ ዘንድ እንደ አደባባይም ጭቃ የተረገጡ ያደርጋቸው ዘንድ በምቈጣቸው ሰዎች ላይ አዝዘዋለሁ።	And then I saw that people would pop into existence all over the plain, and some would see the city and the gates and the hideous angel and rush towards it.
መልካም የጸሎት ጊዜ።	It is a beautiful time of prayer.
በእርግጥም ጦርነቶቹ በተወሰነ አድክመውን አልፈዋል።	In times of war they have of course fallen to a minimum.
በዚህና በመሰል ጉዳዮች ፖሊሲው መታየት አለበት።	This and other issues must be addressed in the policy.
በሰው ፡ አቆጣጠር ፡ ቢመስል ፡ የዘገየ	was for a man to be quick-witted, if he would excel as a beggar.
ከዚያ የበለጠ መማር እንደሚያስፈልገኝ ገምቻለሁ ።	I seem to needy to learn more.
ቃለ ጽቅ ግን ሐሣቡን በሐሳብ መተቸት ሲገባህ አቅም በማጣትህ ማነህ ወደሚል ተራ ነገር ውስጥ ገባህ።	But when stress is in the picture, it speeds up the aging process in your digestive system and you develop issues that are common in older people.
በስተቀር ማንንም ማየት አልፈለገም ።	He didn't want anybody to see her except for him.
በአንዳንዶች ዘንድ አጥንትና ደም እንዲሁም ስጋ ከሐይማኖትም በላይ እየተመለኩ መጥተዋል ።	And in some people's opinions, SUPERIOR to flesh and blood human beings.
በጀቱ በ2 ዓመት ውስጥ ከ50 በመቶ በላይ እድገት አሳይቷል።	supply jumped more than 50 percent in two years.
በጋራ ትብብር ማህበረሰባችሁን ለማሻሻል የበኩላችሁን አበርክቱ።	Partnering together to improve our community.
7 የሚገርም የባሕር ዕይታዎች እርስዎ የማልታ አያምኑም	Staggering Images of the California Drought - You Won't Believe Your Eyes
በዚህ ርዕሰ ጉዳይ ዙርያ መሸፈን ያለብኝ የተሳሳተ መረጃ አለን?	Do I have enough information to disclose on this topic?
"አንድ አስተያየት ሰጪ "" ."	"One View."""
ይህም በአጭር ጊዜ ውስጥ ክብደታችንን ለመቀነስ ይረዳናል።	This helps us lose weight in a short period of time.
በህይወትህ ከፍተኛ ተፅዕኖ ያሳደረብህ ሰው ማን ነው?	Who has had the biggest impact on you in your life?
ከአንድ ጋር የሚዛመድ የ dbx ፋይልን ለማግኘት ሦስት ዘዴዎች አሉ Outlook Express የመልዕክት አቃፊ እንደሚከተለው	There are three methods to find the dbx file corresponding to an Outlook Express mail folder, as follows:
ሕልምን እንዴት መተርጎም እንደሚቻል	It is a dream that depends on your feelings to find the correct interpretation.
"""በጉልበት ልትነግስ?"	"""What do you say about a King?"
የእውነት ጌጡ ጊዜ ነው።	It is their moment of truth.
3 እነዚህ ሁሉ በሲዲም ሸለቆ ተሰብስበው ተባበሩ፤ ይኸውም የጨው ባሕር ነው።	3 All these ioyned together in the vale of Siddim, which is the salt Sea.
የተባበሩት መንግስታት የጸጥታ ምክር ቤት መፍትሄዎች 1267/1989/2253 ISIL (Da'esh) እና የአልቃይዳ ማእቀቦች ኮሚቴ በየካቲት 2016 በማእቀቦቹ ዝርዝር ውስጥ ጨምሮታል።	The United States has welcomed the decision of the United Nations Security Council's 1267 al-Qa'ida and ISIL (Da'esh) Sanctions Committee on February 23, 2020.
ከ 40 በላይ ደረጃዎች!	More than 400 steps.
"ጥራዙን) ትንሣኤን አስታኮ የሚለቅበት ምክንያት ""ትንሣኤ!"	"He said, ""What time is it, back there?"""
የአራቱ ዋና ዋና ድርጅቶችስ ሚና እንዴት ይታያል?	What's the main challenge facing the four organizations?
ወገኖችህ እስራኤል እንዲህ በፈቃዳቸው በመጥፋታቸው አዘንህን ?	Do you recall the UN resolutions condemning Israel that were blocked by his administration?
"በዚህም ምክንያት ኢየሱስ አድማጮቹን ""ሁላችሁም ስሙኝ፤ የምናገረውንም አስተውሉ"" ብሏቸው ነበር።"	"At another time, Jesus called out, ""Listen to Me, all of you, and understand."""
በእውነቱ ፣ ስለአሁኑ አሠሪዬ የምናገረው ከመልካም ነገር በቀር ሌላ የለኝም ።	I have nothing but good things to say about my dealer.
13፤ ሕዝቡም ሁሉ ሰምቶ ይፈራል፥ ከዚያም ወዲያ አይኰራም።	13 And all the people shall hear and fear, and not be presumptuous any more.
በጨለማ ፡ ቦታ ፡ ብሄድ	If I never walk in darkness,
ማሳየት ወይም ባለሙያ መሣሪያዎች አሞሌ ለመደበቅ ባለሙያ ትእዛዝ ይጠቀሙ.	Login or use an immunohistochemistry to print a monkey.
አንድ ጥሩ የምስል ማያያዣ ስርዓት ካገኘሁ ለነፋስ አንድ እሆናለሁ።	If i get good enough grades, i'll be able to go to anime expo.
ጤና ካለህ ሁሉም ነገር ሊመጣ ይችላልና	When your health is good, you have it all.
የዚህች ዓለም ችግሮች እጅግ ከባድ ናቸው።	The problems of this world are very real.
ስለዚህ ፣ ምንም የ 10 ሴ.	Certainly not a 10k.
የ Windows 2000 በማስኬድ (ወይም ከዚያ በላይ) ወይም ቢሮ 2000 (ወይም ከዚያ በላይ) የተጫነ ነው.	Conference-CD is a Windows (2000 or later) application.
ለምንስ ነው የምንፈራው ነገር የማይደርስ የሚመስለን?	Why would anyone fear something that is not going to happen?
"""መንፈስም የእግዚአብሔርን ጥልቅ ነገር እንኳ ሳይቀር ሁሉን ይመረምራልና ለእኛ እግዚአብሔር በመንፈሱ በኩል ገለጠው።"	The Spirit reaches the depths of everything, even the depths of God: these are the very things that God has revealed to us through the Spirit.
እርሱ የተወለደው በሀብታም ቤተሰብ ውስጥ አይደለም ።	He was born not in a poor family.
3 ቀናት ላይ ከሚወርድ በረዶ ጋር 33.	"35"" of rain in 33 days."
+ ደግሞም ይህ ኅብረታችን ከአብና ከልጁ ከኢየሱስ ክርስቶስ ጋር ነው።	And this fellowship is also with the Father and his Son, Jesus Christ.
የሸዋል ስድስቱን ቀናት ከዒድ አልፊጥር በኋላ አስከትሎ መፆሙ በላጭ ቢሆንም እስከ ወሩ መጨረሻ ድረስ መፆም እንደሚቻል በርካታ ዐሊሞች ይገልፃሉ።	Although skies will be calmer after the 18 May there should still be showers every few days until the month's end.
በጥቂቶች በስተቀር ቁጥሩ አሥራ ሁለት ተቆጠረ ።	And two of the three, only a few WR make them.
ሰላም፥ ጽድቅና እግዚአብሔርን የሚያስከብሩ ተግባራት የሚመነጩት ከዚህ ዓይነቱ ጥበብ ነው።	"Expediency is mat's wisdom: doing right is God's."""
በዚህ መሀል ሞቅታ ቢፈጠርና ስካር ቢኖር ደግሞ ማንንም መመከት እንደሚችሉ ለራሳቸው ይነግሩታል።	Something has caused these people to become monsters, and if the security recordings are to be believed, that something could be hiding inside any one of the survivors.
""" ሲል አንድ ወጣት 'እንዲያ በል አንተ!"	"One of the ministers replied: ""Young man, sit down!"
ሁሉንም ገንዘብዎን በሸቀጣሸቀጥ ዕቃዎች ላይ አይውሉ ።	Then don't put all your money into Equity Mutual Funds.
የሚነገረኝ ባገኝም ደስ ይለኛል።	At the risk of being a bore, I'd like to reiterate my point.
በኦሮሚያ ልዩ የፖሊስ አደረጃጀት አለመኖሩን የክልሉ ፖሊስ አስታወቀ	The police official denied there's a breakdown of law and order in Marawi.
በሁለተኛው ቀን ነበር .	On the 2nd day..
በአገሪቱ የዶላር እጥረት በከፍተኛ መከሰቱንም ጠቅሰዋል።	It also analyses the shortage of US Dollars in the financial crisis.
በነዚህ ሁለት አውራጃዎች የሚኖሩ ህዝቦች ናቸው ራዮች።	The people are different in those two empires.
በህይወት ውስጥ, እያንዳንዱ መጨረሻ አዲስ ጅምር ነው	But in life, every end is just a new beginning.
መግለጫውን ለማንበብ	to read the explanation.
ምክነያቱም ሕዝቡን በመንግስት ላይ ለማሳመጽ ሲባል ነው።	But the intention is to persuade the population to revolt against their own government.
ወይስ አደም እንደሚለው የገዛ ራሱን ለመበቀል ?	or someone who identifies himself as Brian?
Home አስረጅ ኒውተን	Home newton's second law
የኢካሪያ ደሴት - የረጅም-ጊዜ ደሴት	Ikaria, the island of long life
የመጀመሪያው የባቡር ቧንቧዎች በ 15 እንደሚደርሱ ይጠበቃል.	The next train is expected to arrive in 15 mins.
"አፋቸውን በነጠላ ሸፍነው ""አይ የሰው ነገር!"	"We invite them to sit in, and they say, ""Wow!"
"በዚህ ሳምንት በ ‹Xbox One› ላይ አዲስ የ ""AAA"" ልቀቶች የሉንም ፣ ግን እዚህ እና እዚያ ገና ጥቂት የሚያስደንቁ ነገሮች አሉ ።"	"Next week we have one new ""AAA"" release on Xbox One, but there are still a few surprises here and..."
ም ጀምሮ በኢንዱስትሪ ሚኒስቴር የተመረጡ 38 ፋብሪካዎች አሰራሩን ተግባራዊ አድርገዋል።	Since then there have been 38 Ministers for Works in 33 Governments.
ከ 60 ዎቹ ክፍሎች - ይህኛው ክበብ!	29th in the league, that stings!
ይሁን እንጂ በእርግጥ ልብና አእምሮ ውስጥ ምን እየሆነ ነው?	What is really going on inside your heart and mind?
ትኩረቴን መሰብሰብ የምችለው የት ብሆን ነው?	"""Where am I going to focus my energy?"
14 እርስዋ እንደ ነጋዴ መርከብ ናት፤ ከሩቅ አገር ምግብዋን ትሰበስባለች።	14She has been like a merchant's ship that brings its merchandise from far away.
3 መርሳት የሚኖርበት የት ግጥም ማለት ነው	D3 Where It'S At
እኛ እንደ ዴቢት ካርዶች እና የኤሌክትሮኒክ ገንዘብ ማስተላለፎች ያሉ እኛም የዱቤ ካርድ አለን።	We also provide products such as debit cards, mobile banking and internet banking services.
መ: ቲ / ቲ እና Paypal ተቀባይነት አላቸው ።	A: T/T and Paypal is acceptable.
በዚህ መንገድ በአጠቃላይ መደበኛነት በቴሌቪዥኑ ላይ እነሱን መጠቀም ይቻላል.	This media can then be played on users' televisions through the Wii.
አዝማሪውም ይያዛል።	The garter is tossed by the groom.
በያዕቆብ ቤትም ላይ ለዘላለም ይነግሳል፤ ለመንግሥቱም መጨረሻ የለውም።	"And He will reign over the house of Jacob forever, and of His kingdom there will be no end."""""
በዚህ ጊዜም ለሰራተኞቹ ማስተናገጃ ድግስ ይሰናዳል።	Now after his coronation, there is an atmosphere of celebration among the workers.
"ኢየሱስ ""በዝሙት ምክንያት ካልሆነ በስተቀር ሚስቱን ፈቶ ሌላ የሚያገባ ሁሉ ምንዝር ይፈጽማል"" ብሏል።"	"Jesus said: ""Whoever divorces his wife, except for sexual immorality, and marries another woman commits adultery."""
ይህ ነበር 1973 እኛ ዩኒቨርሲቲ ውስጥ ለመጀመሪያ አቀፍ ተማሪዎች አቀባበል ጊዜ.	It was in 1973 when we welcomed the first international students in our university.
""" እንዲኹም ደግሞ በአጸደ ሥጋ ኾነ በአጸደ ነፍስ ብንኾን እንኳ፦ ""በሕይወት ሆነን ብንኖር ለጌታ እንኖራለንና፥ ብንሞትም ለጌታ እንሞታለን።"	For whether we live, we live unto the Lord; and whether we die, we die unto the Lord; whether we live therefore or die,we are the Lord's.
ለአሁኑ ዘመን ደግሞ ማርከሻው ከእዛው ከመዲናዋ አለላቸው።	In actuality, the Spurs are already kind of moving on from him.
ጣሊያን እውነተኛ የግዢ መንግሥት ተብሎ ሊጠራ ይችላል ።	It will be called true democratic government.
በረጅም ጊዜ የካፒታል ግኝቶች ላይ ከፍተኛው የታክስ መጠን - ማለትም የአክሲዮን ሽያጭ ወይም ሌሎች ኢንቨስትመንቶች ከ 20% ወደ 39.	The top tax rate on long-term capital gains -- that is, returns on the sale of stocks or other investments -- would increase to 39.6% from 20%.
መንግሥትስ ቢሆን የአረቄ ወይም የአልኮል መሸጫና መጠጫ ሰዓት ሥርዓት ለምን አያበጅም?	And why aren't you saving Ukrainians from drug addiction and alcoholism?
እኛ ተሳክቶልን ስንሰራው አንድ ቀን መቼም አይቀርም!	I'm sure that one day I'll succeed!
በጥቅምት ወር 2015 በጣም መጥፎውን የቡንደስ ሊጋ የግብ ጠባቂነት ብልሹነት ባሳየበት በዚህ በጣም መጥፎ ቀን ምን እንደደረሰበት ማንም አያውቅም ።	Till nowadays nobody knows what happened in the basement of this luxurious palace in December 1916.
በ ‹ሆሄ› ስር መሆን አይችሉም ።	"They cannot speak in ""his"" voice."
4'ዘርህን ለዘላለም እተክላለሁ፤	I will establish thy seed forever....
በዚህ ጊዜ ግን በሩ ወለል ብሎ ተከፈተላቸው!	And finally, its doors were open for them!
በየምሽቱ ከእርሷ ጋር ይተኛ ነበር ።	He would sleep with it every night.
በመቀጠል የመጨረሻውን መነቃቃትን በ 2014 ውስጥ አብረን ሠራን ።	We started this adventure together in 2014.
ከእነርሱም ጋር ሌላ አራተኛ ሰው ይታይ ነበር።	And with them, there was a fourth man.
አሁን ለሴቶች እና እናቶች እና ለልጆች ተጨማሪ ክፍሎች አሉ ።	Now there are additional units for women and mothers and children.
Pokkaloh: መተግበሪያዎች ዛሬ!	NANAKO: We'll keep the kittens for today!
እኔ መጀመሪያ ከጃማይካ ደሴት ነኝ ።	But I'm originally from Jamaica.
እኛም እንኳን በጸሎታች ወገን ለይተን አንተውም ።	We shall be in prayer for you.
እርሱም ያያሉ ሁሉ ከእርሱ እናሳውቃለን ይስማ.	We see Him and hear from Him and record what He reveals.
የጠየቁትን ሁሉ ማድረግም ተገቢ አይደለም›› ይላሉ።	"They don't always want what they say they want to do."""
አ 40 ወንድና 2 ሴት የአንድነት አባላት ታሰሩ (ስም ዝርዝራቸውን ይዘናል)	That is, 74 males and 29 females - (Time expired)
ይህ ከባለፈው ዐመት ተመሳሳይ ጊዜ ሲወዳደር በ80% የቀነሰ ነው።	That is a decrease of 80% versus a year ago.
ሁሉም ነጻ መገለጫዎ ጋር ይገናኛሉ ነጻ ግምገማዎች.	their time together in face-to-face conversation free of distractions.
ካፒታሉ ግብር ከመጀመሪያው ክፍያ ጋር ሙሉ በሙሉ መከፈል አለበት ።	The participation fee has to be fully paid with the first payment.
እግዚአብሔርን ፡ መፍራት ፡ ጠፍቶ ፡ የለም ፡ ወይ	The fear of God is not terror or dread.
ግልሙትናዋንም ገለጠች ኅፍረተ ሥጋዋንም አሳየች፤ ነፍሴም ከእኅትዋ እንደ ተለየች እንዲሁ ነፍሴ ከእርስዋ ተለየች።	So she discovered her whoredoms, and discovered her nakedness: then my mind was alienated from her, like my mind was alienated from her sister.
ኤኤፍፒ የዜና ወኪል በጥቃቱ ቢያንስ 11 ሰዎች መገደላቸውን ከአካባቢው የተገኙ ምንጮቹን ጠቅሶ መዘገቡን ያስነበበው ቢቢሲ ነው።	The Human Rights Watch statement came as the Security Council was expected to meet for a fifth round of reporting on the resolution - and at least 11 people were killed by the bombs overnight.
ምን በጣም የጣት ጸናጽል ስለ አንድ ጥንድ ስለ ?	What is the Shona word for one-sidedness?
በሌሎች ደስታ ተደሰት!	Take delight in the happiness of others.
ይህስ 'የሰው ልጅ' ማን ነው?	"Who is this ""son of man""?'"
የተለያዩ የሴትና የወንድ ደንብ ልብሶች፣	women and men clothing,
ሊያድነን ያነሳኸውን ምህረት እናመሰግንሃለን.	Thank You for Your salvation that protects us.
ሁለተኛዎቹ ወገኖች የሚተኙት ለመተኛት የሆኑ ግለሰቦች ናቸው።	The other pattern is people who can not fall asleep.
ሐዋርያው ታዴዎስ ሐምሌ 2 12.	Tammuz, July 12.
- ሰዎች ይወዱኛል።	the people love me.
"""ተንደርበርድ ፍሪ ዳውንሎድ"" በሚለው አረንጓዴ አዝራር ላይ ጠቅ ያድርጉ።"	"Take the origins of Pence's reference to the ""lunar strategic high ground."""
እኔ የአንዲትን ሰው ተቃራኒ ንግግር አቀርባለሁ:	I'm allowed to argue against someone's opinion with my own.
አጠቃቀም በአንዳንድ.	practical use in some cases.
ሙስሊም በአካሉ፣ በአእምሮውና በመንፈሱ መካከል ይህን ሚዛናዊነት እንዴት ሊያረጋግጥ ይችላል?	How do you achieve balance between your mind, body, and spirit?
"ገንዘብ ሁሉን ነገር መግዛት ይችላል፤ ""ደስታንም"" ጭምር።"	"Money represents the power to buy the necessities, as well as the ""good things"" of life."
እኛ ያ እድል የለንም።	We have not that possibility.
"መቼ ቤተሰብ, ጓደኞች, አብያተ ወይም ክርስቲያን ድርጅቶች ያላቸውን የአዲስ ዓመት ምኞቶችን ላክ, እነሱ ሁልጊዜ የሚመስል ነገር ጻፍ: ""ይህ ዓመት ይሆናል..."	When acquaintances, friends, churches, or organisations send their New Year's wishes, they always write something...
ሚያ ለጥቂት ዓመታት በይፋ ማንንም አላወቀችም ።	He hasn't known anyone for a couple of years now.
ይኼ ሁላ በጥባጭ ትተህ ከመነኩሴ የሚያጣላ ምን ኣይነት ጋኔን ተይዘህ ይሆን ወዳጄ:-)	The long message should be a good idea if you want to dissuade people from leaving a msg. what is your phone number:-)
ከእነሱ ጋር ፍቅር።	Love with them.
ዛሬም ዘወትርም እግዚአብሔር ይባርክሽ!	God bless you today, and everyday!
"በነገራችን ላይ በዚህ ደረጃ በወንጀል የሚፈለግን የፍርድ ቤት ማዘዣ የወጣበትን ሰው መንግስታዊ ሹመት እየሰጡ ለወንጀለኛ ""ህጋዊ"" ምሽግ በመገንባት በአለም ብቸኛ አገር ኢትዮጵያ ብቻ ነች።"	"In addition, Massachusetts is the only ""Right to Shelter"" state in the country, which protects families in crisis who meet certain criteria."
ሥልጣኔና እንጉርጉሮው ; 12:49 .	My midwife and relation: 12:33.
ገመናዬ: ለምን ግድ ይለናል?	Now, I throw to you the same question: Why, do you think, we make the sign of the Cross?
እሷን፤ የእግዜር ፍቅር እንጂ፣ የሰው እሳቱም	and beautiful, and so he gave his life for her; but the love of Christ for the
የሁለቱም ደስታ ያለው በሁለቱ ውስጥ ነው።	It's obvious that there is joy in both of them.
አዝናኝ እና ለሁሉም ዕድሜ ፈታኝ!	joy and healing to all of life.
መጨረሻ የተጠቀመው 1 ደቂቃዎች በፊት	first half until the final one-minute mark
ልጅቷ በ 1935 ራስል በተጻፈው መጽሐፍ ላይ በመመርኮዝ መፍትሄው በቀን 4 ሰዓት መሥራት ነው ወደሚል ድምዳሜ ትመጣለች ።	In this essay, first published in 1932, Russell argues in favour of a four-hour working day.
እርሷ ታላቅ እህቱ ናት ፣ እርሷም በሦስት ዓመት ታልፋለች ።	He's her best friends brother who's been away for three year.
"ጉዳዩም ""እወርሳለሁ - አትወርስም"" የሚል ነበር።"	"The principle - ""do not steal - you will not live."""
ክፋት ግን እርሱን ሊቈጣጠረው አይችልም።	So wickedness can't rule them.
ምክንያቱም ተቃዋሚዎች ካለፈ ስህተታቸው ተምረው ምን ያልህ ሕዝቡን አደራጅተዋል?	What did you say that encouraged people to share their ideas?
በራስ አስተሳሰብ በራሱ እንዲበራ እና ወደ ርዕሰ ጉዳዩ እውቀት እንዲመራ በአእምሮ ውስጥ አእምሮን ለመቅጣት ያሰበው ሳይሆን አይቀርም።	It is more likely that he intended to discipline the mind in thinking, so that by one's own thinking he would be enlightened and led to knowledge of his subject.
የሚሉትን ያካተተ ነው።	he meant by these words.
11 ታላላቅ የምድር ነውጦች ይከሰታሉ፤ በተለያየ ስፍራም የምግብ እጥረትና ቸነፈር ይሆናል፤+ ደግሞም የሚያስፈሩ ነገሮች እንዲሁም ከሰማይ ታላላቅ ምልክቶች ይታያሉ።	11 There will be great earthquakes, famines, and pestilences in various places, and fearful events and great signs from heaven.
በተጨማሪም, አሉታዊ ስሜቶችን መፍራት እና እነሱን እንደ አስፈሪ ነገር መቁጠር የለባቸውም.	Also, one should not be afraid of negative emotions and consider them as something terrible.
★ O ኤ መሣሪያዎች ማፈን.	> input from I/O devices.
አምላክ ፡ ከእናንተ ፡ ዘንድ ፡ ይሁን ፡ ለዘለዓለም	God will be pleased with you; and you will live there forever.
ዋናው መተንፈስ ነው	it's the stretching it's the breathing
በዚህም ሳቢያ ስምምነቱ ሰላም ሳይሰፍን ዓመታት አልፈው አሁን ያለንበት ወቅት ላይ ደረስን።	Thus, so little time has been devoted to actual peace negotiations despite the passage of so many years.
ጒዞው ከገመትነው በላይ ጊዜ ሊፈጅ ይችላል።	The route may be longer than we expected.
ደረጃ በጣም ይህ ቦታ ቀደም ነው	That was in sharp contrast to thriving life recorded at the site in the years before.
ታላቅ የሳቅ ምሽት እንዳያመልጣችሁ !	Don't be left out of a great night of entertainment!
